STATE/UT,DISTRICT,YEAR,MURDER,ATTEMPT TO MURDER,CULPABLE HOMICIDE NOT AMOUNTING TO MURDER,MurderRelatedCrimes,RAPE,CUSTODIAL RAPE,OTHER RAPE,RapeRelatedCrimes,KIDNAPPING & ABDUCTION,KIDNAPPING AND ABDUCTION OF WOMEN AND GIRLS,KIDNAPPING AND ABDUCTION OF OTHERS,KidnapRelCrimes,DACOITY,PREPARATION AND ASSEMBLY FOR DACOITY,ROBBERY,BURGLARY,THEFT,AUTO THEFT,OTHER THEFT,TheftCrimes,RIOTS,CRIMINAL BREACH OF TRUST,CHEATING,COUNTERFIETING,ARSON,HURT/GREVIOUS HURT,OtherSeriousCrimes,DOWRY DEATHS,ASSAULT ON WOMEN WITH INTENT TO OUTRAGE HER MODESTY,INSULT TO MODESTY OF WOMEN,CRUELTY BY HUSBAND OR HIS RELATIVES,IMPORTATION OF GIRLS FROM FOREIGN COUNTRIES,CrimesonWomen,CAUSING DEATH BY NEGLIGENCE,OTHER IPC CRIMES,TOTAL IPC CRIMES
HIMACHAL PRADESH,BILASPUR,2002,11,15,1,27,9,0,9,18,8,3,5,16,0,0,1,59,56,11,45,172,119,12,7,0,32,74,293,0,36,1,22,0,59,49,705,1217
HIMACHAL PRADESH,CHAMBA,2002,15,2,0,17,16,0,16,32,14,10,4,28,0,0,1,127,25,3,22,178,13,5,6,0,8,64,140,2,21,1,12,0,36,44,301,677
HIMACHAL PRADESH,G.R.P.,2002,0,0,0,0,0,0,0,0,1,0,1,2,0,0,0,1,1,0,1,3,2,0,0,0,0,1,3,0,0,0,0,0,0,0,2,8
HIMACHAL PRADESH,HAMIRPUR,2002,8,6,1,15,3,0,3,6,14,14,0,28,0,0,1,18,28,6,22,75,36,7,11,0,6,194,290,0,17,1,24,0,42,36,440,851
HIMACHAL PRADESH,KANGRA,2002,28,22,1,51,14,0,14,28,20,17,3,40,0,0,2,90,86,26,60,264,95,4,30,0,24,287,444,2,50,1,32,0,85,4,1169,1961
HIMACHAL PRADESH,KINNAUR,2002,2,0,0,2,4,0,4,8,3,3,0,6,0,0,0,19,11,0,11,41,10,1,1,0,1,16,51,0,6,1,7,0,14,22,50,154
HIMACHAL PRADESH,KULLU,2002,8,2,1,11,14,0,14,28,11,11,0,22,0,0,0,30,29,8,21,88,23,5,10,0,4,42,124,0,20,0,11,0,31,40,493,743
HIMACHAL PRADESH,LAHAUL-SPITI,2002,2,0,0,2,0,0,0,0,0,0,0,0,0,0,1,5,5,0,5,16,0,2,0,0,0,2,12,0,2,0,0,0,2,8,41,68
HIMACHAL PRADESH,MANDI,2002,5,9,2,16,24,0,24,48,9,8,1,18,0,0,3,85,70,23,47,228,56,6,13,0,38,217,394,2,51,6,47,0,106,64,1068,1775
HIMACHAL PRADESH,SHIMLA,2002,15,10,0,25,27,0,27,54,22,18,4,44,0,0,2,120,119,26,93,360,115,13,26,0,10,78,311,0,49,0,22,0,71,69,1311,2008
HIMACHAL PRADESH,SIRMAUR,2002,9,9,0,18,11,0,11,22,10,10,0,20,0,1,1,44,24,5,19,94,74,6,11,0,10,61,215,0,34,0,15,0,49,53,339,712
HIMACHAL PRADESH,SOLAN,2002,7,6,0,13,9,0,9,18,18,16,2,36,0,0,2,63,62,16,46,189,60,8,7,0,2,317,430,0,28,1,31,0,60,36,609,1266
HIMACHAL PRADESH,UNA,2002,13,5,0,18,6,0,6,12,8,6,2,16,0,0,4,49,48,18,30,149,43,6,15,0,10,123,254,0,12,0,11,0,23,57,393,803
JAMMU & KASHMIR,ANANTNAG,2002,86,96,2,184,16,0,16,32,67,58,9,134,4,0,26,142,91,15,76,354,49,10,19,3,45,53,206,0,67,54,0,0,121,27,501,1358
JAMMU & KASHMIR,AWANTIPORA,2002,26,0,0,26,1,0,1,2,16,15,1,32,2,0,17,7,18,2,16,62,10,0,8,0,1,6,25,0,12,3,0,0,15,0,182,309
JAMMU & KASHMIR,BARAMULLA,2002,121,111,2,234,14,0,14,28,87,78,9,174,4,0,15,129,155,22,133,458,125,2,16,4,22,11,180,0,94,31,0,0,125,0,533,1476
JAMMU & KASHMIR,BORDER,2002,7,26,1,34,5,0,5,10,14,13,1,28,0,0,3,12,16,4,12,47,30,2,6,0,4,16,90,0,8,23,0,0,31,32,535,740
JAMMU & KASHMIR,BUDGAM,2002,46,23,2,71,12,0,12,24,40,33,7,80,2,0,3,47,109,16,93,270,87,2,13,0,18,2,144,0,80,13,0,0,93,22,310,831
JAMMU & KASHMIR,CRIME JAMMU,2002,1,0,0,1,0,0,0,0,0,0,0,0,0,0,0,0,0,0,0,0,0,1,44,0,0,0,45,0,0,0,0,0,0,0,2,48
JAMMU & KASHMIR,CRIME SRINAGAR,2002,1,0,0,1,0,0,0,0,0,0,0,0,0,0,0,0,0,0,0,0,0,1,61,0,0,0,62,0,0,0,0,0,0,0,0,63
JAMMU & KASHMIR,DODA,2002,105,118,0,223,15,0,15,30,19,19,0,38,1,0,2,30,21,0,21,75,17,6,3,2,29,12,93,0,6,4,0,0,10,24,312,726
JAMMU & KASHMIR,GANDERBAL,2002,22,5,1,28,7,0,7,14,39,39,0,78,0,0,2,39,53,21,32,147,71,2,6,1,8,5,104,0,61,6,0,0,67,11,180,519
JAMMU & KASHMIR,HANDWARA,2002,47,72,5,124,0,0,0,0,23,15,8,46,1,0,0,20,23,0,23,67,27,0,3,0,9,5,52,0,25,0,1,0,26,8,203,472
JAMMU & KASHMIR,JAMMU,2002,23,79,8,110,7,0,7,14,60,56,4,120,7,0,4,223,407,165,242,1048,74,16,48,1,9,40,282,10,20,74,17,0,121,94,2015,3236
JAMMU & KASHMIR,KARGIL,2002,0,1,0,1,1,0,1,2,2,2,0,4,0,0,0,2,5,1,4,12,4,0,1,0,1,0,6,0,0,0,0,0,0,0,54,71
JAMMU & KASHMIR,KATHUA,2002,15,25,1,41,11,0,11,22,13,13,0,26,0,0,1,47,47,11,36,142,44,1,12,0,7,30,173,3,11,13,4,0,31,79,604,968
JAMMU & KASHMIR,KULGAM,2002,41,4,1,46,7,0,7,14,45,39,6,90,0,0,17,33,43,5,38,136,57,8,8,4,17,10,123,0,10,4,0,0,14,19,257,585
JAMMU & KASHMIR,KUPWARA,2002,56,124,0,180,5,0,5,10,28,24,4,56,0,0,0,25,24,1,23,73,55,3,10,0,36,5,118,0,38,4,0,0,42,9,175,597
JAMMU & KASHMIR,LEH,2002,6,1,0,7,3,0,3,6,1,1,0,2,0,0,0,13,5,1,4,23,3,0,1,0,0,0,4,0,1,1,0,0,2,0,93,128
JAMMU & KASHMIR,POONCH,2002,84,140,0,224,9,0,9,18,14,7,7,28,0,0,0,11,46,0,46,103,7,1,13,0,27,40,96,0,4,0,0,0,4,8,221,625
JAMMU & KASHMIR,PULWAMA,2002,55,109,2,166,12,0,12,24,44,41,3,88,9,0,32,80,115,14,101,351,120,2,14,2,20,19,177,0,51,15,0,0,66,0,252,953
JAMMU & KASHMIR,RAILWAYS,2002,2,0,0,2,0,0,0,0,0,0,0,0,0,0,0,0,7,1,6,14,0,0,0,0,0,0,0,0,0,3,0,0,3,0,7,19
JAMMU & KASHMIR,RAJOURI,2002,97,104,0,201,13,0,13,26,13,13,0,26,2,0,2,22,38,2,36,102,4,4,12,0,25,24,71,1,11,5,9,0,26,2,712,1100
JAMMU & KASHMIR,RAMBAN,2002,62,69,0,131,7,0,7,14,6,6,0,12,0,0,0,25,27,0,27,79,6,3,2,1,24,9,46,0,3,3,0,0,6,1,318,566
JAMMU & KASHMIR,REASI,2002,45,62,2,109,8,0,8,16,16,11,5,32,3,0,3,7,28,0,28,69,4,2,0,0,32,7,45,0,3,1,2,0,6,0,152,377
JAMMU & KASHMIR,SRINAGAR,2002,86,50,4,140,24,0,24,48,117,106,11,234,6,0,33,335,639,376,263,1652,154,18,76,2,48,48,386,0,270,86,12,0,368,40,1056,3104
JAMMU & KASHMIR,UDHAMPUR,2002,14,21,0,35,15,0,15,30,10,7,3,20,1,0,3,72,103,7,96,282,48,7,6,0,4,24,93,4,10,25,9,0,48,4,716,1096
JHARKHAND,BOKARO,2002,58,108,2,168,48,0,48,96,40,26,14,80,40,5,64,132,445,95,350,1131,180,28,24,2,10,432,794,29,32,0,16,0,77,118,381,2194
JHARKHAND,CHAIBASA,2002,134,42,38,214,37,0,37,74,19,9,10,38,7,0,14,34,98,5,93,251,34,15,2,0,9,17,78,0,17,0,8,0,25,1,204,730
JHARKHAND,CHATRA,2002,31,4,0,35,18,0,18,36,4,1,3,8,31,0,19,19,83,24,59,235,123,0,3,0,3,2,131,15,0,0,4,0,19,0,481,840
JHARKHAND,DEOGHAR,2002,36,34,4,74,37,0,37,74,5,2,3,10,13,2,25,53,98,20,78,289,145,0,0,0,7,18,172,16,7,0,17,0,40,2,764,1283
JHARKHAND,DHANBAD,2002,88,42,13,143,38,0,38,76,72,25,47,144,69,14,64,149,493,31,462,1282,237,40,61,1,9,135,487,36,53,3,19,0,111,4,1561,3201
JHARKHAND,DHANBAD RLY.,2002,5,0,0,5,2,0,2,4,2,1,1,4,21,0,32,8,240,0,240,541,11,0,4,0,0,1,19,0,2,0,0,0,2,3,77,408
JHARKHAND,DUMKA,2002,67,149,4,220,50,0,50,100,15,3,12,30,7,1,13,54,88,0,88,251,99,45,10,0,7,57,264,8,31,0,37,0,76,46,220,1008
JHARKHAND,GARHWA,2002,39,17,3,59,32,0,32,64,9,2,7,18,17,2,20,29,68,0,68,204,107,9,10,0,9,225,367,14,2,0,19,2,37,7,229,869
JHARKHAND,GIRIDIH,2002,72,27,4,103,39,0,39,78,23,8,15,46,49,2,42,91,128,2,126,440,108,6,27,0,22,73,334,52,48,0,36,0,136,98,1008,1955
JHARKHAND,GODDA,2002,31,36,0,67,86,0,86,172,21,6,15,42,9,0,10,46,128,0,128,321,125,7,17,0,0,314,466,4,0,0,56,0,60,3,1310,2203
JHARKHAND,GUMLA,2002,108,32,8,148,31,0,31,62,9,8,1,18,23,2,41,37,58,7,51,219,32,10,6,0,0,2,56,1,4,0,14,0,19,6,265,689
JHARKHAND,HAZARIBAGH,2002,86,59,11,156,71,0,71,142,33,18,15,66,60,9,66,103,537,44,493,1312,198,16,73,0,14,102,403,31,27,0,90,0,148,0,1035,2621
JHARKHAND,JAMSHEDPUR,2002,81,180,9,270,76,0,76,152,50,18,32,100,8,1,29,156,539,135,404,1272,114,60,64,0,19,93,353,12,40,0,72,0,124,3,1149,2755
JHARKHAND,JAMSHEDPUR RLY.,2002,2,0,0,2,1,0,1,2,1,1,0,2,5,0,6,6,114,4,110,245,3,0,1,0,0,0,5,0,5,0,0,0,5,1,56,201
JHARKHAND,JAMTARA,2002,18,33,2,53,25,0,25,50,13,2,11,26,4,0,6,30,69,4,65,178,39,0,5,1,2,116,164,3,14,0,18,0,35,1,135,534
JHARKHAND,KODERMA,2002,30,25,0,55,6,0,6,12,13,4,9,26,39,0,24,13,50,6,44,176,103,8,15,0,4,187,355,7,8,0,37,0,52,38,178,785
JHARKHAND,LATEHAR,2002,43,14,2,59,12,0,12,24,8,2,6,16,27,4,13,12,33,0,33,122,20,1,4,0,5,39,105,3,4,0,3,0,10,36,173,456
JHARKHAND,LOHARDAGGA,2002,44,9,1,54,14,0,14,28,2,1,1,4,3,0,22,16,29,1,28,99,23,6,4,2,3,8,46,0,4,0,12,0,16,0,230,432
JHARKHAND,PAKUR,2002,37,7,4,48,37,0,37,74,6,1,5,12,5,1,13,16,32,2,30,99,44,2,11,0,3,6,67,2,3,0,5,0,10,1,349,584
JHARKHAND,PALAMU,2002,69,48,3,120,14,0,14,28,16,8,8,32,31,0,40,111,99,4,95,380,167,4,4,0,27,327,532,24,11,0,18,34,87,3,499,1549
JHARKHAND,RANCHI,2002,270,161,0,431,55,0,55,110,67,22,45,134,85,9,181,222,729,159,570,1955,263,64,51,0,7,2,391,9,73,0,62,0,144,4,1992,4306
JHARKHAND,SAHEBGANJ,2002,45,58,2,105,26,0,26,52,22,5,17,44,5,0,17,21,98,6,92,239,65,4,19,0,4,28,148,5,22,0,19,0,46,28,242,730
JHARKHAND,SARAIKELA,2002,51,36,2,89,26,0,26,52,16,4,12,32,12,3,7,45,115,8,107,297,31,8,16,0,0,109,171,3,4,0,25,0,32,7,308,824
JHARKHAND,SIMDEGA,2002,43,22,3,68,16,0,16,32,2,1,1,4,10,0,12,16,3,3,0,44,10,0,10,0,3,1,30,1,0,0,1,0,2,6,123,282
KARNATAKA,BAGALKOT,2002,51,38,2,91,4,0,4,8,17,7,10,34,2,0,1,74,147,35,112,371,209,11,28,1,6,363,618,2,53,1,63,0,119,0,842,1915
KARNATAKA,BANGALORE COMMR.,2002,201,311,4,516,32,0,32,64,159,58,101,318,27,47,365,2084,7081,2754,4327,16685,284,180,1788,107,1,4029,6434,33,237,62,242,0,574,45,11801,29120
KARNATAKA,BANGALORE RURAL,2002,153,114,7,274,22,0,22,44,38,0,38,76,23,1,54,498,767,129,638,2110,480,37,63,1,41,1274,1896,35,114,0,129,0,278,0,3459,7310
KARNATAKA,BELGAUM,2002,113,60,1,174,6,0,6,12,26,16,10,52,12,0,48,203,272,107,165,807,370,18,137,10,19,806,1379,7,55,0,102,0,164,19,2442,4726
KARNATAKA,BELLARY,2002,62,58,0,120,11,0,11,22,13,8,5,26,2,3,18,189,265,65,200,742,271,6,29,5,15,643,973,8,68,0,52,0,128,4,1366,3088
KARNATAKA,BIDAR,2002,49,62,0,111,8,0,8,16,23,13,10,46,6,5,29,222,208,42,166,678,166,4,31,0,29,1020,1250,10,85,2,64,0,161,0,2394,4417
KARNATAKA,BIJAPUR,2002,62,53,2,117,3,0,3,6,30,24,6,60,12,0,22,138,117,32,85,406,326,4,23,0,27,645,1025,5,71,0,90,0,166,0,1132,2762
KARNATAKA,CHAMARAJNAGAR,2002,29,24,0,53,4,0,4,8,6,3,3,12,4,0,6,46,99,11,88,254,222,2,2,2,22,375,625,1,26,0,13,0,40,0,444,1327
KARNATAKA,CHICKMAGALUR,2002,36,64,2,102,18,0,18,36,12,9,3,24,1,0,11,159,237,45,192,645,166,7,12,0,7,852,1053,3,62,6,64,0,135,9,1068,2796
KARNATAKA,CHITRADURGA,2002,37,18,1,56,12,0,12,24,7,4,3,14,3,0,15,113,165,37,128,461,319,16,18,0,6,733,1093,7,46,0,32,0,85,1,1437,2986
KARNATAKA,DAKSHIN KANNADA,2002,26,27,0,53,9,0,9,18,6,0,6,12,3,0,9,173,208,103,105,601,141,11,49,11,17,502,735,0,22,5,28,0,55,4,2178,3429
KARNATAKA,DAVANAGERE,2002,57,26,7,90,14,0,14,28,18,15,3,36,8,0,43,176,279,75,204,785,276,13,39,2,2,589,938,8,74,2,73,0,157,17,1383,3106
KARNATAKA,DHARWAD COMMR.,2002,17,36,0,53,1,0,1,2,16,7,9,32,7,0,38,105,269,123,146,688,122,13,61,2,9,221,434,5,14,4,24,0,47,6,1051,2021
KARNATAKA,DHARWAD RURAL,2002,35,13,0,48,0,0,0,0,7,0,7,14,2,0,4,42,34,2,32,116,89,1,9,0,2,133,234,4,26,0,17,0,47,0,487,905
KARNATAKA,GADAG,2002,15,22,0,37,3,0,3,6,4,3,1,8,3,1,4,49,72,29,43,201,133,8,20,3,2,173,339,3,12,0,12,0,27,0,389,928
KARNATAKA,GULBARGA,2002,79,76,7,162,24,0,24,48,43,32,11,86,3,4,46,173,258,56,202,742,368,6,47,1,19,1163,1604,4,119,6,73,0,202,0,1484,4003
KARNATAKA,HASSAN,2002,74,65,1,140,11,0,11,22,26,0,26,52,3,1,22,195,287,70,217,795,242,19,13,2,91,1362,1729,7,64,0,62,0,133,0,1553,4100
KARNATAKA,HAVERI,2002,18,19,2,39,2,0,2,4,10,7,3,20,5,0,8,69,107,25,82,296,276,10,23,2,0,300,611,4,27,0,18,0,49,0,1055,1955
KARNATAKA,K.G.F.,2002,14,16,0,30,6,0,6,12,3,0,3,6,0,0,7,94,255,34,221,611,79,1,16,1,0,250,348,3,6,0,21,0,30,1,281,1054
KARNATAKA,KODAGU,2002,35,29,2,66,4,0,4,8,6,1,5,12,0,0,4,145,76,16,60,301,74,2,15,1,3,445,541,2,27,0,18,0,47,1,476,1365
KARNATAKA,KOLAR,2002,73,71,1,145,18,0,18,36,36,12,24,72,6,0,29,141,362,69,293,900,367,10,25,2,0,649,1053,16,34,0,46,0,96,0,1667,3553
KARNATAKA,KOPPAL,2002,19,37,0,56,6,0,6,12,26,26,0,52,7,0,10,90,82,10,72,271,126,8,25,4,7,243,413,3,29,0,49,0,81,0,622,1393
KARNATAKA,MANDYA,2002,61,56,0,117,30,0,30,60,18,0,18,36,4,0,30,249,274,58,216,831,266,7,14,0,0,1339,1626,14,45,0,102,0,161,0,2236,4745
KARNATAKA,MYSORE COMMR.,2002,22,38,1,61,7,0,7,14,10,5,5,20,1,0,31,97,279,128,151,687,48,22,38,1,0,350,459,10,17,0,58,0,85,0,732,1762
KARNATAKA,MYSORE RURAL,2002,62,45,1,108,5,0,5,10,16,7,9,32,3,0,5,149,217,27,190,591,231,9,12,0,0,936,1188,5,63,0,73,0,141,0,966,2798
KARNATAKA,RAICHUR,2002,59,67,7,133,6,0,6,12,25,16,9,50,9,0,9,142,138,36,102,436,256,14,112,4,19,580,999,10,72,6,56,0,144,14,917,2522
KARNATAKA,RAILWAYS,2002,14,1,0,15,0,0,0,0,0,0,0,0,4,0,15,5,380,6,374,784,118,0,2,2,1,26,149,1,2,0,1,0,4,0,152,724
KARNATAKA,SHIMOGA,2002,53,47,2,102,11,0,11,22,14,12,2,28,3,4,42,209,349,87,262,956,247,11,42,4,21,1133,1458,4,59,1,159,0,223,0,1750,4165
KARNATAKA,TUMKUR,2002,58,49,4,111,9,0,9,18,19,10,9,38,13,0,29,242,371,103,268,1026,255,22,38,0,66,990,1396,16,60,0,30,0,106,25,1884,4180
KARNATAKA,UDUPI,2002,15,22,0,37,1,0,1,2,9,4,5,18,2,0,11,127,80,38,42,300,188,11,15,2,1,315,538,2,21,0,22,0,45,6,1359,2209
KARNATAKA,UTTAR KANNADA,2002,28,12,1,41,5,0,5,10,2,1,1,4,0,0,7,82,83,24,59,255,123,2,18,5,4,385,537,1,38,5,33,0,77,0,1501,2335
KERALA,ALAPUZHA,2002,18,30,1,49,13,0,13,26,14,5,9,28,5,0,19,234,244,128,116,746,548,19,129,5,38,1335,2074,2,149,2,165,0,318,0,4608,7578
KERALA,CBCID,2002,15,8,2,25,0,0,0,0,1,0,1,2,3,0,3,10,4,0,4,24,22,13,26,46,2,3,112,0,0,0,2,0,2,0,80,240
KERALA,ERNAKULAM,2002,36,80,18,134,27,0,27,54,12,9,3,24,27,0,119,649,1159,316,843,3113,686,35,321,6,24,1753,2830,1,170,6,179,0,356,5,10360,15673
KERALA,IDUKKI,2002,32,18,2,52,26,0,26,52,0,0,0,0,6,0,9,185,215,33,182,630,323,19,60,0,19,1457,1880,0,120,10,108,0,238,2,2035,4646
KERALA,KANNUR,2002,28,63,7,98,21,0,21,42,14,8,6,28,4,0,17,242,197,88,109,657,567,3,123,8,3,1007,1711,0,89,7,203,0,299,0,2421,5024
KERALA,KASARGOD,2002,20,22,6,48,25,0,25,50,13,7,6,26,0,0,11,145,146,94,52,448,407,5,69,4,0,637,1123,0,0,0,87,0,87,1,1172,2770
KERALA,KOLLAM,2002,41,49,59,149,60,0,60,120,20,12,8,40,12,0,42,403,319,153,166,1095,778,8,158,13,66,2411,3436,2,307,1,312,0,622,2,4814,9877
KERALA,KOTTAYAM,2002,20,22,7,49,28,0,28,56,15,7,8,30,6,0,65,337,379,103,276,1166,439,40,275,7,19,1719,2499,0,156,19,132,0,307,0,3631,7316
KERALA,KOZHIKODE,2002,21,39,18,78,53,0,53,106,5,1,4,10,3,0,27,479,569,230,339,1647,973,42,383,9,67,1149,2629,0,135,12,343,0,490,6,4413,8746
KERALA,MALAPPURAM,2002,26,28,14,68,70,0,70,140,11,4,7,22,4,0,12,216,319,150,169,870,597,19,273,3,27,839,1758,3,90,5,431,0,529,0,3545,6532
KERALA,PALAKKAD,2002,51,42,10,103,48,0,48,96,10,7,3,20,17,2,39,352,311,112,199,1032,609,53,138,6,64,1450,2329,0,122,5,196,0,323,9,2601,6135
KERALA,PATHANAMTHITTA,2002,28,24,15,67,12,0,12,24,0,0,0,0,1,0,19,195,186,80,106,587,295,11,61,2,22,960,1351,0,139,4,116,0,259,0,2378,4468
KERALA,RAILWAYS,2002,0,0,0,0,0,0,0,0,0,0,0,0,0,0,0,3,302,2,300,607,16,0,1,0,0,9,26,0,1,0,0,0,1,0,55,387
KERALA,THRISSUR,2002,52,59,42,153,30,0,30,60,11,7,4,22,15,0,78,361,405,176,229,1264,642,28,406,10,22,1304,2418,4,195,14,189,0,402,6,6176,10049
KERALA,TRIVANDRUM,2002,58,69,9,136,56,0,56,112,36,24,12,72,27,2,138,717,853,283,570,2590,964,48,397,15,67,2550,4041,2,404,16,314,0,736,0,5948,12690
KERALA,WAYANADU,2002,8,9,0,17,30,0,30,60,0,0,0,0,7,0,12,96,135,30,105,385,224,14,104,1,12,450,806,3,46,1,59,0,109,1,857,2069
MADHYA PRADESH,BALAGHAT,2002,69,41,3,113,87,0,87,174,9,8,1,18,4,3,23,244,236,42,194,746,30,5,8,0,22,390,505,5,186,14,78,0,283,50,1498,3005
MADHYA PRADESH,BARWANI,2002,37,34,0,71,30,0,30,60,4,4,0,8,2,5,6,48,108,24,84,277,36,1,16,0,12,307,453,3,71,9,15,0,98,81,962,1787
MADHYA PRADESH,BETUL,2002,65,50,0,115,115,0,115,230,22,20,2,44,0,1,17,158,169,28,141,514,11,6,21,1,15,544,659,13,152,11,50,0,226,61,1420,2902
MADHYA PRADESH,BHIND,2002,72,106,2,180,33,0,33,66,29,16,13,58,1,8,36,218,308,26,282,879,107,6,36,4,30,650,931,36,91,6,65,0,198,98,1723,3665
MADHYA PRADESH,BHOPAL,2002,62,92,0,154,98,0,98,196,41,21,20,82,1,6,103,908,1500,560,940,4018,79,26,110,4,10,489,864,16,244,51,131,0,442,146,10100,14217
MADHYA PRADESH,BHOPAL RLY.,2002,7,5,0,12,1,0,1,2,0,0,0,0,0,1,33,12,924,8,916,1894,8,0,6,0,1,2,19,0,18,2,0,0,20,2,293,1315
MADHYA PRADESH,CHHATARPUR,2002,70,66,1,137,76,0,76,152,25,14,11,50,4,0,34,261,171,0,171,641,76,5,31,1,19,502,708,20,188,16,58,0,282,74,1982,3680
MADHYA PRADESH,CHHINDWARA,2002,81,46,4,131,82,0,82,164,10,9,1,20,1,2,30,183,194,57,137,604,65,9,24,0,27,1096,1340,11,189,36,117,0,353,119,1508,3834
MADHYA PRADESH,DAMOH,2002,49,57,0,106,57,0,57,114,14,7,7,28,1,2,20,137,175,21,154,510,19,2,9,0,15,1064,1154,31,136,0,52,0,219,45,900,2785
MADHYA PRADESH,DATIYA,2002,54,63,0,117,22,0,22,44,12,3,9,24,4,3,21,93,128,19,109,377,19,1,11,0,15,401,504,14,53,0,16,0,83,57,888,1875
MADHYA PRADESH,DEWAS,2002,53,76,0,129,97,0,97,194,33,13,20,66,18,2,82,374,902,126,776,2280,145,15,53,0,43,399,753,14,191,54,135,0,394,98,3747,6531
MADHYA PRADESH,DHAR,2002,90,101,0,191,74,0,74,148,30,24,6,60,3,13,42,315,653,96,557,1679,69,33,17,0,32,577,728,53,220,51,91,0,415,0,2933,5397
MADHYA PRADESH,DINDORI,2002,26,7,0,33,26,0,26,52,2,1,1,4,0,0,0,53,22,5,17,97,21,0,5,0,8,102,160,1,57,4,15,0,77,24,492,865
MADHYA PRADESH,GUNA,2002,64,74,9,147,148,0,148,296,7,4,3,14,8,11,52,388,372,57,315,1203,167,11,19,1,38,1654,2045,12,339,35,99,0,485,155,2605,6268
MADHYA PRADESH,GWALIOR,2002,102,126,3,231,69,0,69,138,79,48,31,158,10,7,133,999,872,282,590,2893,154,41,89,3,30,1007,1521,18,150,12,133,0,313,197,3456,7690
MADHYA PRADESH,HARDA,2002,18,13,0,31,28,0,28,56,3,3,0,6,0,0,6,50,68,16,52,192,21,3,5,0,3,341,377,7,42,8,16,0,73,4,240,876
MADHYA PRADESH,HOSHANGABAD,2002,48,86,97,231,62,0,62,124,21,20,1,42,0,3,40,311,339,74,265,1032,29,4,39,2,12,423,509,9,122,13,45,0,189,0,1451,3156
MADHYA PRADESH,INDORE,2002,109,135,1,245,93,0,93,186,47,28,19,94,6,5,142,974,2896,1370,1526,6919,134,60,122,6,29,1114,1781,23,217,54,249,0,543,316,8202,14934
MADHYA PRADESH,INDORE RLY.,2002,3,4,0,7,1,0,1,2,1,1,0,2,0,0,6,1,164,2,162,335,3,0,0,0,0,7,10,0,7,0,0,0,7,0,81,278
MADHYA PRADESH,JABALPUR,2002,73,146,4,223,80,0,80,160,32,14,18,64,1,1,115,567,987,390,597,2658,65,4,78,6,29,2954,3335,49,250,64,125,0,488,199,3461,9290
MADHYA PRADESH,JABALPUR RLY.,2002,2,2,0,4,0,0,0,0,0,0,0,0,1,0,11,1,208,4,204,429,2,2,0,0,0,8,13,0,3,0,0,0,3,1,104,345
MADHYA PRADESH,JHABUA,2002,133,129,0,262,29,0,29,58,68,62,6,136,2,6,15,143,230,12,218,626,32,6,6,0,78,676,818,3,119,0,8,0,130,20,1401,3104
MADHYA PRADESH,KATNI,2002,40,37,2,79,37,0,37,74,3,2,1,6,1,3,31,185,210,61,149,640,25,2,17,5,16,868,1030,5,133,9,65,0,212,97,612,2403
MADHYA PRADESH,KHANDWA,2002,33,41,0,74,71,0,71,142,17,16,1,34,4,2,12,337,370,80,290,1095,60,17,31,0,16,89,272,11,214,14,59,0,298,59,2526,3983
MADHYA PRADESH,KHARGON,2002,37,39,43,119,50,0,50,100,27,27,0,54,7,6,16,201,472,38,434,1174,83,32,20,0,9,133,396,7,162,30,65,0,264,119,2138,3696
MADHYA PRADESH,MANDLA,2002,21,26,0,47,43,0,43,86,5,5,0,10,0,0,6,114,98,11,87,316,23,3,10,0,8,366,453,0,107,11,44,0,162,43,895,1823
MADHYA PRADESH,MANDSAUR,2002,34,38,0,72,45,0,45,90,17,10,7,34,0,3,14,185,406,102,304,1014,68,25,28,4,18,338,555,7,129,15,49,0,200,74,1315,2812
MADHYA PRADESH,MORENA,2002,62,116,3,181,46,0,46,92,27,17,10,54,10,2,79,366,533,79,454,1523,154,11,19,0,20,1274,1594,28,73,2,41,0,144,116,2167,5149
MADHYA PRADESH,NARSINGHPUR,2002,48,53,2,103,88,0,88,176,7,6,1,14,1,2,10,134,163,40,123,473,46,5,5,0,28,838,975,23,174,16,46,0,259,53,701,2443
MADHYA PRADESH,NEEMUCH,2002,19,23,2,44,26,0,26,52,13,9,4,26,1,0,28,158,310,77,233,807,45,21,18,1,4,308,449,3,75,23,90,0,191,52,1003,2223
MADHYA PRADESH,PANNA,2002,35,30,1,66,35,0,35,70,12,7,5,24,1,1,18,110,105,8,97,340,12,3,9,0,10,66,132,17,74,6,31,0,128,32,1109,1717
MADHYA PRADESH,RAISEN,2002,34,70,0,104,98,0,98,196,10,8,2,20,1,1,23,148,169,18,151,511,45,8,11,7,22,521,614,16,296,16,58,0,386,0,1526,3080
MADHYA PRADESH,RAJGARH,2002,36,57,0,93,80,0,80,160,11,8,3,22,2,1,27,149,290,44,246,759,186,3,14,0,56,323,708,4,179,27,68,0,278,126,2662,4301
MADHYA PRADESH,RATLAM,2002,36,47,1,84,67,0,67,134,10,6,4,20,0,6,39,222,403,95,308,1073,46,17,18,1,27,421,619,7,138,17,79,0,241,89,1641,3332
MADHYA PRADESH,REWA,2002,68,40,1,109,32,0,32,64,36,15,21,72,7,3,91,760,436,153,283,1733,87,2,18,1,27,537,809,26,95,3,54,0,178,137,2108,4569
MADHYA PRADESH,SAGAR,2002,81,120,0,201,136,0,136,272,30,24,6,60,0,0,39,414,501,75,426,1455,183,12,46,0,43,2343,2740,26,425,22,164,0,637,113,2605,7303
MADHYA PRADESH,SATNA,2002,62,72,0,134,66,0,66,132,29,5,24,58,4,4,47,437,356,121,235,1204,54,6,22,1,20,925,1174,37,173,3,47,0,260,146,1992,4503
MADHYA PRADESH,SEONI,2002,40,15,2,57,44,0,44,88,4,4,0,8,0,0,7,98,144,12,132,393,32,4,29,1,9,350,511,3,116,12,24,0,155,86,1018,2038
MADHYA PRADESH,SHAHDOL,2002,51,34,1,86,72,0,72,144,13,10,3,26,7,5,47,390,392,41,351,1233,38,7,25,1,20,402,493,11,259,24,133,0,427,0,2802,4734
MADHYA PRADESH,SHAJAPUR,2002,42,57,4,103,84,0,84,168,18,15,3,36,1,2,84,319,647,91,556,1700,126,19,25,2,39,666,936,9,144,18,84,0,255,59,1316,3765
MADHYA PRADESH,SHEOPUR,2002,20,36,0,56,28,0,28,56,20,5,15,40,4,0,13,100,93,9,84,303,41,6,4,0,3,333,407,5,68,2,21,0,96,20,522,1339
MADHYA PRADESH,SHIVPURI,2002,71,77,0,148,73,0,73,146,18,6,12,36,3,12,23,172,227,26,201,664,115,2,19,0,29,802,1087,6,180,0,41,0,227,120,2439,4429
MADHYA PRADESH,SIDHI,2002,48,25,3,76,46,0,46,92,17,16,1,34,3,2,21,296,345,29,316,1012,28,3,15,0,12,432,581,36,131,3,42,0,212,91,2007,3606
MADHYA PRADESH,SIHORE,2002,21,61,2,84,63,0,63,126,51,47,4,102,5,1,13,364,362,43,319,1107,37,12,39,0,20,448,665,5,115,13,49,0,182,109,2107,3897
MADHYA PRADESH,TIKAMGARH,2002,45,58,3,106,51,0,51,102,13,7,6,26,1,1,34,151,204,24,180,595,82,6,19,0,38,889,1086,20,161,5,40,0,226,52,1367,3240
MADHYA PRADESH,UJJAIN,2002,54,172,0,226,68,0,68,136,47,27,20,94,3,3,100,783,1528,288,1240,3945,164,30,51,2,50,715,1094,9,156,28,140,0,333,82,4240,8425
MADHYA PRADESH,UMARIYA,2002,28,7,0,35,20,0,20,40,1,1,0,2,0,2,25,87,83,9,74,280,20,3,5,0,6,132,173,7,65,5,31,0,108,7,738,1272
MADHYA PRADESH,VIDISHA,2002,42,54,0,96,114,0,114,228,19,16,3,38,3,1,15,226,286,52,234,817,86,8,18,0,35,729,926,8,231,19,54,0,312,50,1920,3918
MAHARASHTRA,AHMEDNAGAR,2002,82,45,6,133,45,0,45,90,27,20,7,54,19,11,97,352,841,239,602,2161,296,56,69,1,38,663,1568,8,75,0,280,0,363,445,1050,4506
MAHARASHTRA,AKOLA,2002,59,34,0,93,28,0,28,56,21,16,5,42,8,0,41,314,729,82,647,1821,120,19,37,9,40,801,1142,4,70,11,156,0,241,116,1269,3886
MAHARASHTRA,AMRAVATI COMMR.,2002,27,25,1,53,18,0,18,36,12,10,2,24,2,0,42,275,791,127,664,1901,50,18,52,2,16,475,678,4,35,32,68,0,139,65,655,2665
MAHARASHTRA,AMRAVATI RURAL,2002,58,36,3,97,66,0,66,132,22,21,1,44,15,1,47,392,1052,42,1010,2559,85,16,26,0,59,773,1101,5,130,19,95,0,249,142,880,3922
MAHARASHTRA,AURANGABAD COMMR.,2002,32,18,0,50,8,0,8,16,20,12,8,40,8,2,58,248,535,198,337,1386,124,12,96,1,12,408,761,7,30,13,110,0,160,108,590,2440
MAHARASHTRA,AURANGABAD RURAL,2002,50,29,0,79,12,0,12,24,11,8,3,22,13,2,32,131,291,41,250,760,158,10,26,1,53,792,1239,24,36,12,208,0,280,199,613,2703
MAHARASHTRA,BEED,2002,69,51,0,120,25,0,25,50,23,10,13,46,18,3,64,198,431,65,366,1145,313,31,43,0,38,884,1511,2,51,7,158,0,218,202,677,3288
MAHARASHTRA,BHANDARA,2002,36,13,2,51,32,0,32,64,16,15,1,32,1,1,14,228,340,37,303,924,66,14,25,0,43,403,664,3,57,37,70,0,167,113,744,2258
MAHARASHTRA,BULDHANA,2002,50,35,2,87,30,0,30,60,18,14,4,36,22,0,42,259,728,44,684,1779,169,21,43,4,87,749,1248,17,107,21,162,0,307,175,924,3665
MAHARASHTRA,CHANDRAPUR,2002,52,19,6,77,29,0,29,58,24,21,3,48,5,3,28,249,471,54,417,1227,128,31,50,5,42,538,981,3,89,9,116,0,217,187,886,2970
MAHARASHTRA,DHULE,2002,46,25,1,72,16,0,16,32,8,8,0,16,4,2,14,96,355,73,282,826,82,21,40,0,23,392,752,7,20,6,124,0,157,194,673,2149
MAHARASHTRA,GADCHIROLI,2002,51,33,4,88,22,0,22,44,9,8,1,18,12,0,11,113,113,7,106,362,33,17,17,0,42,285,456,0,59,15,65,0,139,62,440,1403
MAHARASHTRA,GONDIA,2002,44,16,0,60,25,0,25,50,21,20,1,42,5,0,14,217,318,42,276,872,23,15,24,10,8,370,541,4,74,15,70,0,163,91,595,1959
MAHARASHTRA,HINGOLI,2002,32,15,1,48,17,0,17,34,7,7,0,14,7,0,34,103,163,16,147,470,74,18,21,1,18,485,675,6,36,4,98,0,144,58,431,1629
MAHARASHTRA,JALGAON,2002,81,39,2,122,22,0,22,44,21,19,2,42,20,4,29,316,626,100,526,1621,184,46,55,8,13,790,1385,10,78,29,219,0,336,289,1421,4302
MAHARASHTRA,JALNA,2002,48,28,1,77,14,0,14,28,11,8,3,22,10,0,38,187,272,37,235,779,128,16,47,0,28,587,922,5,25,8,199,0,237,116,558,2326
MAHARASHTRA,KOLHAPUR,2002,65,42,3,110,17,0,17,34,15,7,8,30,16,1,17,220,472,162,310,1198,138,46,70,3,18,549,1108,20,46,8,70,0,144,284,870,2990
MAHARASHTRA,LATUR,2002,39,27,2,68,4,0,4,8,19,19,0,38,8,1,45,102,264,55,209,684,166,32,41,2,30,869,1287,5,53,5,125,0,188,147,846,2832
MAHARASHTRA,MUMBAI,2002,252,134,7,393,128,0,128,256,119,61,58,238,33,57,291,2597,10166,3101,7065,23310,143,342,1155,76,5,3542,6016,18,254,40,214,0,526,753,5950,26276
MAHARASHTRA,MUMBAI RLY.,2002,3,3,0,6,2,0,2,4,7,3,4,14,1,4,22,4,1694,2,1692,3419,8,12,35,3,0,34,94,0,4,2,0,0,6,2,102,1942
MAHARASHTRA,NAGPUR COMMR.,2002,98,54,0,152,49,0,49,98,50,41,9,100,12,62,146,1307,2511,845,1666,6549,254,50,235,14,23,916,1710,4,63,38,210,0,315,218,2408,8722
MAHARASHTRA,NAGPUR RLY.,2002,7,2,1,10,0,0,0,0,0,0,0,0,8,0,16,2,797,9,788,1620,8,5,2,7,1,25,50,0,2,1,0,0,3,2,166,1052
MAHARASHTRA,NAGPUR RURAL,2002,95,35,1,131,66,0,66,132,25,19,6,50,10,1,61,401,998,76,922,2469,132,24,38,1,90,915,1506,7,114,61,98,0,280,306,1574,5053
MAHARASHTRA,NANDED,2002,83,85,0,168,29,0,29,58,40,34,6,80,20,10,100,373,542,84,458,1587,191,21,110,1,72,1559,2091,24,83,6,241,0,354,137,2072,5799
MAHARASHTRA,NANDURBAR,2002,26,9,0,35,28,0,28,56,5,5,0,10,5,0,14,103,146,23,123,414,82,15,27,1,9,237,442,2,41,5,75,0,123,71,277,1178
MAHARASHTRA,NASIK COMMR.,2002,25,9,2,36,12,0,12,24,17,8,9,34,5,5,32,369,612,211,401,1635,131,23,98,0,4,272,671,3,20,11,136,0,170,143,592,2521
MAHARASHTRA,NASIK RURAL,2002,90,44,1,135,38,0,38,76,14,10,4,28,21,4,37,301,481,97,384,1325,365,40,53,0,45,1024,1959,8,101,57,375,0,541,432,1252,4783
MAHARASHTRA,NAVI MUMBAI,2002,48,21,1,70,24,0,24,48,18,9,9,36,14,15,50,333,890,320,570,2192,66,68,197,5,3,322,930,6,28,7,34,0,75,269,652,3071
MAHARASHTRA,OSMANABAD,2002,46,17,3,66,28,0,28,56,15,8,7,30,10,1,26,143,277,17,260,734,173,22,30,0,32,828,1251,0,53,10,115,0,178,166,661,2656
MAHARASHTRA,PARBHANI,2002,55,31,0,86,19,0,19,38,11,7,4,22,7,2,68,141,229,45,184,676,143,9,38,0,24,955,1260,5,55,4,137,0,201,91,342,2366
MAHARASHTRA,PUNE COMMR.,2002,95,42,0,137,51,0,51,102,36,22,14,72,8,6,80,836,2447,1197,1250,5824,702,72,346,0,13,1058,2523,5,59,97,131,0,292,332,2088,8504
MAHARASHTRA,PUNE RLY.,2002,1,3,0,4,2,1,1,4,1,1,0,2,0,0,7,0,321,0,321,649,1,3,5,0,0,2,11,0,0,0,0,0,0,0,63,409
MAHARASHTRA,PUNE RURAL,2002,141,37,7,185,42,0,42,84,16,9,7,32,16,9,61,296,706,251,455,1794,185,33,41,2,23,592,1633,4,60,14,175,0,253,757,1301,4518
MAHARASHTRA,RAIGAD,2002,43,21,0,64,29,0,29,58,12,10,2,24,24,3,38,169,278,49,229,790,144,19,54,1,17,277,795,13,40,11,54,0,118,283,619,2149
MAHARASHTRA,RATNAGIRI,2002,26,6,0,32,13,0,13,26,5,5,0,10,1,1,12,144,175,23,152,508,49,11,22,1,19,211,416,0,41,16,23,0,80,103,343,1222
MAHARASHTRA,SANGLI,2002,97,29,0,126,33,0,33,66,22,14,8,44,13,3,22,225,446,104,342,1155,107,25,90,0,29,411,951,4,38,8,63,0,113,289,734,2688
MAHARASHTRA,SATARA,2002,83,17,4,104,31,0,31,62,14,9,5,28,11,3,26,218,442,111,331,1142,97,41,72,1,20,490,1081,13,51,2,156,0,222,360,1189,3341
MAHARASHTRA,SINDHUDURG,2002,18,7,0,25,11,0,11,22,4,2,2,8,6,0,8,97,96,16,80,303,43,8,9,1,16,152,302,1,14,1,11,0,27,73,205,781
MAHARASHTRA,SOLAPUR COMMR.,2002,27,39,2,68,30,0,30,60,13,8,5,26,31,3,18,203,313,85,228,881,109,7,42,1,10,180,417,4,10,5,62,0,81,68,420,1597
MAHARASHTRA,SOLAPUR RURAL,2002,79,40,2,121,33,0,33,66,28,23,5,56,9,3,23,122,309,64,245,775,184,31,30,1,43,558,1210,1,34,0,74,0,109,363,868,2835
MAHARASHTRA,THANE COMMR.,2002,128,68,0,196,42,0,42,84,75,41,34,150,36,35,124,924,1615,636,979,4349,229,70,446,6,32,1010,2040,3,91,40,175,0,309,247,1023,6419
MAHARASHTRA,THANE RURAL,2002,122,41,21,184,51,0,51,102,35,0,35,70,42,10,81,485,588,195,393,1794,174,35,79,0,37,727,1616,16,100,26,81,0,223,564,695,4010
MAHARASHTRA,WARDHA,2002,49,31,5,85,37,0,37,74,21,19,2,42,2,2,42,257,601,51,550,1505,122,16,43,5,31,744,1088,2,110,30,79,0,221,127,1137,3493
MAHARASHTRA,WASHIM,2002,34,13,0,47,29,0,29,58,9,8,1,18,5,1,27,122,354,22,332,863,71,4,15,2,22,416,603,9,45,9,99,0,162,73,516,1875
MAHARASHTRA,YAVATMAL,2002,76,67,2,145,65,0,65,130,36,31,5,72,5,0,37,299,780,67,713,1901,110,23,51,0,41,980,1390,17,104,17,142,0,280,185,1272,4309
MANIPUR,BISHNUPUR,2002,24,23,0,47,2,0,2,4,20,7,13,40,1,0,0,5,9,0,9,24,5,4,8,1,2,66,87,0,9,0,1,0,10,1,112,293
MANIPUR,CHANDEL,2002,9,4,0,13,0,0,0,0,9,0,9,18,0,0,5,2,6,0,6,19,0,3,2,1,1,19,30,0,0,0,0,0,0,4,33,98
MANIPUR,CHURACHANDPUR,2002,30,11,0,41,0,0,0,0,19,1,18,38,0,0,0,4,4,0,4,12,2,0,0,1,2,6,11,0,1,0,0,0,1,0,28,108
MANIPUR,IMPHAL(EAST),2002,24,27,3,54,4,0,4,8,25,20,5,50,2,0,0,7,39,22,17,87,8,2,11,4,6,50,81,0,9,0,0,0,9,0,170,391
MANIPUR,IMPHAL(WEST),2002,32,51,0,83,3,0,3,6,44,36,8,88,0,0,0,20,162,92,70,344,26,13,29,5,28,128,229,0,31,0,5,0,36,0,433,1010
MANIPUR,SENAPATI,2002,13,11,0,24,0,0,0,0,1,0,1,2,0,0,0,2,6,0,6,14,2,2,2,0,0,0,6,0,0,0,0,0,0,0,91,130
MANIPUR,TAMENGLONG,2002,3,3,0,6,0,0,0,0,4,0,4,8,0,0,0,0,6,0,6,12,0,0,0,0,2,2,4,0,0,0,0,0,0,0,8,28
MANIPUR,THOUBAL,2002,27,29,0,56,4,0,4,8,34,18,16,68,0,8,0,3,18,1,17,47,21,3,20,0,6,102,172,0,8,0,4,0,12,20,181,488
MANIPUR,UKHRUL,2002,3,1,0,4,1,0,1,2,1,0,1,2,0,0,1,1,5,0,5,12,0,1,0,0,1,5,7,0,0,0,0,0,0,0,18,38
MEGHALAYA,GARO HILLS EAST,2002,10,13,0,23,1,0,1,2,5,0,5,10,5,1,5,10,25,0,25,71,2,1,2,2,0,8,15,0,2,0,0,0,2,0,18,110
MEGHALAYA,GARO HILLS SOUTH,2002,10,3,0,13,1,0,1,2,2,1,1,4,2,0,1,5,11,0,11,30,0,0,3,0,0,4,7,0,0,0,0,0,0,0,15,57
MEGHALAYA,GARO HILLS WEST,2002,17,6,0,23,5,0,5,10,12,0,12,24,2,0,2,23,45,0,45,117,4,1,4,0,1,21,31,0,8,0,0,0,8,0,45,196
MEGHALAYA,JAINTIA HILLS,2002,39,4,0,43,2,0,2,4,3,1,2,6,6,0,10,7,43,2,41,109,0,0,0,2,2,19,35,0,5,0,0,0,5,12,73,227
MEGHALAYA,KHASI HILLS EAST,2002,48,22,3,73,19,0,19,38,22,4,18,44,24,1,66,98,221,40,181,631,3,6,21,3,17,18,68,0,5,0,0,0,5,0,174,771
MEGHALAYA,KHASI HILLS WEST,2002,16,8,0,24,7,0,7,14,4,0,4,8,10,0,11,8,11,0,11,51,0,1,0,0,0,6,7,0,3,0,0,0,3,0,34,119
MEGHALAYA,RI-BHOI,2002,27,2,0,29,3,0,3,6,4,4,0,8,15,0,14,3,36,9,27,104,0,0,3,1,3,13,20,0,0,0,0,0,0,0,60,184
MIZORAM,AIZAWL,2002,5,18,0,23,36,0,36,72,4,0,4,8,0,0,2,228,542,17,525,1314,0,19,58,9,10,33,129,0,28,0,2,0,30,0,415,1409
MIZORAM,CHAMPHAI,2002,6,1,0,7,9,0,9,18,0,0,0,0,0,0,1,47,45,2,43,138,0,0,5,2,3,17,27,0,10,0,0,0,10,0,66,212
MIZORAM,KOLASIB,2002,4,1,1,6,5,0,5,10,1,0,1,2,2,0,3,28,87,3,84,207,1,4,6,1,5,12,39,0,6,0,1,0,7,10,62,240
MIZORAM,LAWNGTLAI,2002,3,0,0,3,2,0,2,4,0,0,0,0,0,0,0,14,22,0,22,58,0,0,0,0,0,7,7,0,4,0,0,0,4,0,110,162
MIZORAM,LUNGLEI,2002,2,2,0,4,11,0,11,22,0,0,0,0,0,0,0,71,173,4,169,417,0,3,10,3,5,13,34,0,11,0,0,0,11,0,32,336
MIZORAM,MAMIT,2002,1,0,0,1,4,0,4,8,0,0,0,0,1,0,0,16,18,0,18,53,0,0,3,1,1,6,14,0,0,0,0,0,0,3,8,62
MIZORAM,SAIHA,2002,2,4,3,9,7,0,7,14,1,1,0,2,1,0,1,19,88,3,85,197,0,0,2,0,2,19,23,0,14,0,0,0,14,0,163,326
MIZORAM,SERCHHIP,2002,6,0,1,7,2,0,2,4,1,1,0,2,1,0,0,23,24,1,23,72,0,0,1,0,1,5,7,0,0,0,0,0,0,0,8,73
NAGALAND,DIMAPUR,2002,32,7,1,40,3,0,3,6,19,2,17,38,9,0,91,58,128,52,76,414,1,6,3,1,2,27,52,0,1,0,0,0,1,12,66,467
NAGALAND,KIPHIRE,2002,1,0,0,1,1,0,1,2,1,1,0,2,0,0,1,2,3,0,3,9,0,0,0,0,0,0,0,0,0,0,0,0,0,0,2,11
NAGALAND,KOHIMA,2002,25,2,0,27,9,0,9,18,0,0,0,0,4,0,0,19,44,24,20,111,0,0,12,0,0,1,13,0,0,0,0,0,0,0,110,226
NAGALAND,MOKOKCHUNG,2002,11,1,1,13,0,0,0,0,1,0,1,2,1,0,5,8,7,2,5,28,0,0,0,0,3,2,10,0,0,0,0,0,0,5,19,64
NAGALAND,MON,2002,1,1,0,2,0,0,0,0,1,1,0,2,2,0,3,12,17,2,15,51,0,0,3,0,0,7,14,0,0,0,0,0,0,4,13,64
NAGALAND,PEREN,2002,4,9,0,13,0,0,0,0,0,0,0,0,0,0,0,2,5,0,5,12,0,0,1,0,1,1,3,0,0,0,0,0,0,0,8,31
NAGALAND,PHEK,2002,5,4,3,12,1,0,1,2,4,0,4,8,2,0,6,2,8,0,8,26,0,1,0,0,0,5,6,0,0,0,0,0,0,0,11,52
NAGALAND,TUENSANG,2002,6,5,0,11,1,0,1,2,1,0,1,2,0,0,4,6,2,0,2,14,3,2,0,2,0,0,7,0,0,0,0,0,0,0,13,45
NAGALAND,WOKHA,2002,6,3,0,9,1,0,1,2,0,0,0,0,3,0,0,11,36,0,36,86,1,1,0,0,0,10,15,0,0,0,0,0,0,3,24,99
NAGALAND,ZUNHEBOTO,2002,9,2,0,11,1,0,1,2,0,0,0,0,0,0,0,8,7,1,6,22,0,0,2,0,0,0,2,0,0,0,0,0,0,0,26,55
ODISHA,ANGUL,2002,40,43,2,85,25,0,25,50,15,15,0,30,7,0,27,69,127,10,117,357,105,3,19,0,16,43,319,8,53,4,49,0,114,133,826,1614
ODISHA,BALASORE,2002,23,6,0,29,47,0,47,94,35,31,4,70,12,4,33,148,178,32,146,553,73,10,27,2,27,170,309,28,81,26,86,0,221,0,1474,2490
ODISHA,BARAGARH,2002,22,36,2,60,12,0,12,24,4,4,0,8,16,0,19,61,119,17,102,334,91,8,15,0,17,76,314,3,50,4,29,0,86,107,568,1259
ODISHA,BERHAMPUR,2002,30,56,2,88,10,0,10,20,7,6,1,14,7,0,48,70,126,43,83,377,42,6,21,0,3,236,360,7,41,1,22,0,71,52,341,1128
ODISHA,BHADRAK,2002,26,36,5,67,27,0,27,54,18,18,0,36,4,0,16,60,56,10,46,192,76,2,15,0,10,14,179,12,35,9,12,0,68,62,916,1411
ODISHA,BOLANGIR,2002,33,52,14,99,15,0,15,30,16,12,4,32,1,0,23,58,98,5,93,278,60,15,83,1,13,316,488,4,74,15,17,0,110,0,531,1439
ODISHA,BOUDH,2002,12,15,0,27,2,0,2,4,3,2,1,6,0,0,4,17,28,0,28,77,18,3,1,0,16,47,95,1,21,3,5,0,30,10,197,403
ODISHA,CUTTACK,2002,47,140,0,187,32,0,32,64,38,31,7,76,23,5,135,287,719,242,477,1888,78,19,77,0,26,73,818,3,69,10,131,0,213,545,1823,4280
ODISHA,DEOGARH,2002,12,9,0,21,7,0,7,14,5,5,0,10,6,0,2,17,21,3,18,67,15,3,4,0,6,126,182,5,44,1,10,0,60,28,112,433
ODISHA,DHENKANAL,2002,28,35,1,64,12,0,12,24,21,17,4,42,3,0,26,56,96,9,87,277,100,8,12,0,18,108,324,5,69,6,30,0,110,78,593,1305
ODISHA,GAJAPATI,2002,6,10,0,16,8,0,8,16,4,3,1,8,1,0,3,17,36,1,35,93,31,4,8,0,3,36,119,0,18,1,7,0,26,37,195,425
ODISHA,GANJAM,2002,76,117,5,198,34,0,34,68,14,8,6,28,11,0,41,120,157,10,147,486,106,17,35,0,45,161,504,21,124,9,54,0,208,140,892,2179
ODISHA,JAGATSINGHPUR,2002,16,24,4,44,17,0,17,34,17,13,4,34,7,0,39,78,143,6,137,410,4,12,17,0,6,131,351,8,19,1,29,0,57,181,508,1261
ODISHA,JAJPUR,2002,22,21,0,43,18,0,18,36,23,22,1,46,2,0,23,97,144,19,125,410,20,6,15,0,12,267,418,18,18,3,66,0,105,98,814,1687
ODISHA,JHARSUGUDA,2002,17,17,1,35,11,0,11,22,4,3,1,8,1,1,11,32,64,19,45,173,14,3,15,0,3,47,209,0,27,0,13,0,40,127,302,710
ODISHA,KALAHANDI,2002,22,32,0,54,18,0,18,36,9,9,0,18,12,0,29,59,64,7,57,228,75,3,36,1,3,94,265,2,25,10,19,0,56,53,343,909
ODISHA,KANDHAMAL,2002,19,13,2,34,32,0,32,64,32,29,3,64,2,0,13,58,86,2,84,245,17,10,6,0,5,374,436,2,72,9,48,0,131,24,124,948
ODISHA,KENDRAPARA,2002,19,52,0,71,9,0,9,18,17,14,3,34,9,0,7,42,70,8,62,198,31,1,10,0,8,32,87,24,13,1,18,0,56,5,561,929
ODISHA,KEONJHAR,2002,74,38,4,116,42,0,42,84,23,23,0,46,7,0,38,106,150,10,140,451,96,5,22,0,29,118,467,4,157,19,25,0,205,197,893,2047
ODISHA,KHURDA,2002,63,92,0,155,52,0,52,104,53,44,9,106,21,9,145,489,907,367,540,2478,104,29,157,2,25,1257,1745,19,36,15,187,0,257,171,1403,5236
ODISHA,KORAPUT,2002,47,34,1,82,30,0,30,60,9,8,1,18,11,0,12,123,147,26,121,440,76,5,17,1,7,35,193,3,53,4,41,0,101,52,744,1452
ODISHA,MALKANGIR,2002,36,23,3,62,15,0,15,30,6,6,0,12,20,0,3,22,48,8,40,141,16,8,1,1,2,44,81,3,17,1,8,0,29,9,173,459
ODISHA,MAYURBHANJ,2002,83,40,2,125,68,0,68,136,29,24,5,58,7,0,34,113,158,15,143,470,42,10,29,0,17,20,227,26,125,0,106,0,257,109,1007,2025
ODISHA,NAYAGARH,2002,28,61,0,89,9,0,9,18,14,11,3,28,2,3,19,51,72,3,69,219,36,2,9,0,12,47,137,8,2,1,11,0,22,31,447,865
ODISHA,NOWRANGPUR,2002,25,16,3,44,17,0,17,34,18,16,2,36,10,0,16,70,82,10,72,260,39,4,15,1,11,53,123,0,34,3,11,0,48,0,336,764
ODISHA,NUAPADA,2002,15,9,0,24,5,0,5,10,9,5,4,18,2,0,7,17,45,1,44,116,27,7,2,0,3,27,86,2,26,5,17,0,50,20,246,491
ODISHA,PURI,2002,47,139,2,188,41,0,41,82,31,28,3,62,9,4,53,140,195,36,159,596,31,5,26,0,21,75,246,23,15,2,16,0,56,88,1598,2561
ODISHA,RAYAGADA,2002,18,33,0,51,15,0,15,30,12,0,12,24,8,0,1,44,65,6,59,183,64,6,16,0,3,27,171,0,56,2,24,0,82,55,510,959
ODISHA,ROURKELA,2002,28,24,3,55,18,0,18,36,10,8,2,20,3,2,17,79,218,36,182,537,9,8,24,2,9,47,131,0,44,3,18,0,65,32,628,1226
ODISHA,SAMBALPUR,2002,41,57,0,98,15,0,15,30,5,3,2,10,13,0,44,147,214,32,182,632,43,11,22,0,8,32,217,5,84,7,6,0,102,101,1049,1904
ODISHA,SONEPUR,2002,7,31,0,38,6,0,6,12,2,2,0,4,2,0,4,32,33,0,33,104,29,4,11,0,5,22,71,0,38,4,20,0,62,0,238,488
ODISHA,SRP(CUTTACK),2002,0,2,0,2,1,0,1,2,4,1,3,8,0,0,5,12,277,19,258,571,1,0,4,1,1,43,50,0,4,0,2,0,6,0,82,439
ODISHA,SRP(ROURKELA),2002,6,2,0,8,0,0,0,0,1,0,1,2,1,0,4,13,158,2,156,334,0,0,0,0,0,13,16,0,6,0,3,0,9,3,71,281
ODISHA,SUNDARGARH,2002,87,57,2,146,21,0,21,42,15,11,4,30,6,2,44,80,167,14,153,466,29,9,22,0,15,736,935,4,55,9,27,0,95,124,210,1721
PUNJAB,AMRITSAR,2002,51,24,4,79,5,0,5,10,32,23,9,64,4,7,5,94,132,71,61,374,0,24,153,4,3,170,429,9,14,0,74,0,97,75,436,1320
PUNJAB,BARNALA,2002,10,22,0,32,11,0,11,22,6,5,1,12,0,0,3,28,46,7,39,123,0,14,70,0,0,72,208,3,8,0,25,0,36,52,175,545
PUNJAB,BATALA,2002,30,34,4,68,14,0,14,28,14,8,6,28,0,0,2,18,49,18,31,118,0,13,72,0,0,147,271,7,5,0,32,0,44,39,160,640
PUNJAB,BHATINDA,2002,34,30,2,66,14,0,14,28,32,25,7,64,1,8,3,126,99,33,66,336,0,29,135,3,3,193,363,5,25,5,36,0,71,0,414,1197
PUNJAB,FARIDKOT,2002,12,12,1,25,6,0,6,12,11,8,3,22,2,1,3,43,42,18,24,133,0,2,72,0,0,145,219,5,6,0,23,0,34,0,118,504
PUNJAB,FATEHGARH SAHIB,2002,14,13,1,28,0,0,0,0,11,6,5,22,0,1,3,47,38,14,24,127,0,8,33,0,0,99,245,5,5,1,4,0,15,105,177,565
PUNJAB,FEROZEPUR,2002,39,63,4,106,27,0,27,54,24,16,8,48,1,1,1,99,168,58,110,438,0,16,138,2,6,542,786,9,15,0,41,0,65,82,254,1532
PUNJAB,G.R.P,2002,5,8,0,13,0,0,0,0,1,0,1,2,0,0,0,0,27,4,23,54,0,1,7,0,0,11,19,2,2,0,0,0,4,0,326,390
PUNJAB,GURDASPUR,2002,26,24,4,54,17,0,17,34,14,8,6,28,2,5,5,43,62,23,39,179,0,13,57,1,0,93,336,4,10,0,28,0,42,172,239,819
PUNJAB,HOSHIARPUR,2002,31,38,2,71,19,0,19,38,16,10,6,32,19,2,20,80,111,34,77,343,0,21,153,1,10,276,624,12,12,1,55,0,80,163,297,1339
PUNJAB,JAGRAON,2002,15,30,3,48,13,0,13,26,22,13,9,44,2,0,6,27,76,17,59,187,0,6,67,2,0,123,269,3,4,1,26,0,34,71,163,660
PUNJAB,JALANDHAR,2002,59,64,6,129,20,0,20,40,50,38,12,100,1,8,11,224,330,189,141,904,0,10,249,4,12,378,815,14,12,0,82,0,108,162,729,2425
PUNJAB,KAPURTHALA,2002,32,18,4,54,17,0,17,34,16,8,8,32,5,0,2,36,81,26,55,205,0,5,196,0,1,147,418,7,14,0,47,0,68,69,215,912
PUNJAB,KHANNA,2002,21,13,2,36,7,0,7,14,10,4,6,20,0,4,1,49,56,23,33,166,0,6,58,0,0,105,268,5,7,0,16,0,28,99,140,599
PUNJAB,LUDHIANA,2002,68,77,14,159,40,0,40,80,125,88,37,250,3,17,12,346,717,369,348,1812,0,57,405,5,18,328,1003,16,88,127,145,0,376,190,2850,5648
PUNJAB,MAJITHA,2002,28,34,9,71,9,0,9,18,14,9,5,28,0,0,2,28,48,9,39,126,0,3,55,1,4,188,335,5,6,0,25,0,36,84,200,743
PUNJAB,MANSA,2002,25,23,1,49,10,0,10,20,5,4,1,10,1,2,2,40,40,14,26,125,0,16,39,0,3,155,213,3,7,0,11,0,21,0,150,533
PUNJAB,MOGA,2002,27,35,4,66,4,0,4,8,14,7,7,28,0,7,5,39,70,31,39,191,1,29,93,4,2,159,355,7,7,0,14,0,28,67,116,704
PUNJAB,MUKTSAR,2002,18,28,1,47,8,0,8,16,8,1,7,16,1,0,3,49,38,11,27,129,1,16,46,2,0,121,222,8,3,0,13,0,24,36,66,466
PUNJAB,NAWAN SHAHR,2002,22,9,1,32,8,0,8,16,16,11,5,32,1,2,3,43,69,24,45,187,0,3,93,1,0,167,337,7,5,0,31,0,43,73,111,665
PUNJAB,PATIALA,2002,46,48,4,98,18,0,18,36,41,29,12,82,0,7,7,234,316,146,170,880,0,32,243,5,0,384,1054,14,45,0,119,0,178,390,1243,3196
PUNJAB,ROPAR,2002,27,13,3,43,6,0,6,12,29,6,23,58,0,3,1,85,135,67,68,359,0,16,112,1,2,117,447,6,17,6,25,0,54,199,567,1370
PUNJAB,SANGRUR,2002,42,37,0,79,14,0,14,28,23,17,6,46,6,8,7,116,169,48,121,475,0,25,133,2,4,221,498,6,19,4,52,0,81,113,401,1402
PUNJAB,TARN TARAN,2002,51,31,5,87,12,0,12,24,17,10,7,34,1,0,3,34,44,13,31,126,0,8,37,1,0,112,227,4,5,0,20,0,29,69,166,620
RAJASTHAN,AJMER,2002,48,63,3,114,27,0,27,54,124,124,0,248,5,0,42,457,737,293,444,1978,91,41,370,2,36,695,1509,23,65,0,285,0,373,274,3595,6983
RAJASTHAN,ALWAR,2002,82,96,0,178,44,0,44,88,121,89,32,242,0,4,43,226,964,342,622,2201,79,29,392,0,47,2364,3149,42,115,1,250,0,408,238,1677,6814
RAJASTHAN,BANSWARA,2002,40,26,1,67,74,0,74,148,55,50,5,110,2,3,23,117,126,32,94,397,235,2,42,1,62,1402,1813,10,92,1,85,0,188,69,747,3215
RAJASTHAN,BARAN,2002,30,89,0,119,51,0,51,102,89,88,1,178,0,1,13,188,466,67,399,1134,69,17,126,1,28,332,633,6,188,4,160,0,358,60,1786,3704
RAJASTHAN,BARMER,2002,18,28,0,46,24,0,24,48,25,16,9,50,1,0,12,94,182,34,148,471,36,6,92,0,23,766,1019,8,83,0,66,0,157,96,882,2442
RAJASTHAN,BHARATPUR,2002,87,81,4,172,59,0,59,118,109,79,30,218,0,2,48,148,709,147,562,1616,18,47,303,2,59,1116,1714,27,29,0,227,0,283,169,4060,7304
RAJASTHAN,BHILWARA,2002,30,46,4,80,46,0,46,92,196,164,32,392,0,0,48,361,752,281,471,1913,219,27,355,4,28,557,1386,4,134,6,339,0,483,196,3241,6593
RAJASTHAN,BIKANER,2002,40,90,0,130,24,0,24,48,21,21,0,42,0,0,6,122,367,77,290,862,9,24,169,1,20,646,911,13,34,0,142,0,189,42,1295,3065
RAJASTHAN,BUNDI,2002,21,95,9,125,38,0,38,76,109,83,26,218,2,0,24,216,389,72,317,1020,135,11,109,0,31,978,1361,7,151,3,225,0,386,97,1249,3899
RAJASTHAN,CHITTORGARH,2002,46,52,1,99,73,0,73,146,171,139,32,342,3,5,27,310,701,170,531,1747,357,25,235,1,60,2308,3117,7,121,1,330,0,459,131,1505,6470
RAJASTHAN,CHURU,2002,26,48,0,74,22,0,22,44,31,14,17,62,2,0,6,88,233,26,207,562,151,12,144,1,27,947,1342,8,50,0,163,0,221,60,836,2855
RAJASTHAN,DAUSA,2002,21,25,2,48,16,0,16,32,47,27,20,94,0,0,6,83,383,115,268,855,145,24,107,0,28,156,589,5,10,0,82,0,97,129,2377,3646
RAJASTHAN,DHOLPUR,2002,42,89,0,131,26,0,26,52,58,45,13,116,4,1,18,78,190,32,158,481,373,8,74,1,7,972,1507,25,43,0,78,0,146,72,652,2811
RAJASTHAN,DUNGARPUR,2002,24,16,1,41,21,0,21,42,43,40,3,86,0,0,13,88,80,19,61,261,204,12,27,0,40,142,507,4,58,1,42,0,105,82,1038,1936
RAJASTHAN,G.R.P.,2002,5,2,1,8,4,0,4,8,3,2,1,6,2,0,8,4,533,14,519,1080,4,4,5,0,0,7,22,2,20,0,0,0,22,2,245,851
RAJASTHAN,GANGANAGAR,2002,63,94,0,157,54,0,54,108,60,52,8,120,0,1,9,211,441,121,320,1103,8,80,435,0,14,1159,1841,19,100,1,391,0,511,145,2108,5393
RAJASTHAN,HANUMANGARH,2002,65,97,1,163,40,0,40,80,34,27,7,68,1,0,9,145,343,63,280,841,27,23,284,4,18,607,1051,19,95,1,227,0,342,88,1739,3867
RAJASTHAN,JAIPUR,2002,85,116,10,211,57,0,57,114,256,221,35,512,2,4,78,982,3000,1137,1863,7066,2699,233,1423,17,65,1482,6684,32,187,0,517,0,736,765,7653,19663
RAJASTHAN,JAISALMER,2002,7,0,0,7,3,0,3,6,5,4,1,10,0,0,6,61,157,11,146,381,25,3,22,1,10,1,99,5,13,0,17,0,35,37,544,917
RAJASTHAN,JALORE,2002,19,23,2,44,11,0,11,22,32,25,7,64,0,0,8,111,177,23,154,473,30,13,88,4,37,49,296,10,77,0,84,0,171,75,1737,2587
RAJASTHAN,JHALAWAR,2002,44,71,5,120,61,0,61,122,82,60,22,164,2,0,12,186,356,83,273,912,121,9,79,2,57,1065,1420,7,150,11,210,0,378,87,881,3498
RAJASTHAN,JHUNJHUNU,2002,44,25,0,69,12,0,12,24,49,31,18,98,5,0,9,138,313,59,254,778,252,15,142,2,45,146,730,15,65,0,122,0,202,128,2670,4197
RAJASTHAN,JODHPUR,2002,38,69,2,109,33,0,33,66,104,76,28,208,2,0,43,383,938,342,596,2304,140,66,430,3,46,2597,3523,17,157,5,267,0,446,241,1542,7123
RAJASTHAN,KARAULI,2002,19,17,1,37,21,0,21,42,58,31,27,116,1,0,14,38,260,40,220,573,90,10,79,0,25,17,284,15,57,0,55,0,127,63,2084,2924
RAJASTHAN,KOTA,2002,56,374,4,434,37,0,37,74,160,132,28,320,2,0,64,381,1058,426,632,2563,159,44,279,1,27,480,1168,6,154,3,319,0,482,178,2742,6528
RAJASTHAN,NAGAUR,2002,43,30,4,77,39,0,39,78,61,28,33,122,1,0,26,306,446,95,351,1225,42,16,219,0,28,345,769,14,78,0,153,0,245,119,2844,4814
RAJASTHAN,PALI,2002,32,74,2,108,25,0,25,50,74,59,15,148,0,0,34,216,332,81,251,914,88,28,244,5,44,48,658,14,116,3,205,0,338,201,3280,5065
RAJASTHAN,RAJSAMAND,2002,18,22,0,40,9,0,9,18,60,44,16,120,0,1,9,91,148,57,91,397,203,25,98,1,26,1226,1718,7,38,0,74,0,119,139,392,2587
RAJASTHAN,SAWAI MADHOPUR,2002,27,25,1,53,21,0,21,42,52,37,15,104,2,3,19,104,276,83,193,680,47,15,187,0,24,57,378,2,59,0,113,0,174,48,1922,3004
RAJASTHAN,SIKAR,2002,41,29,5,75,13,0,13,26,52,27,25,104,2,0,2,206,306,54,252,822,577,12,217,0,49,465,1475,10,42,0,116,0,168,155,1755,4054
RAJASTHAN,SIROHI,2002,28,26,0,54,9,0,9,18,44,37,7,88,4,0,14,171,147,23,124,483,46,18,107,6,33,478,799,3,33,0,83,0,119,111,952,2313
RAJASTHAN,TONK,2002,22,26,1,49,18,0,18,36,90,72,18,180,1,0,12,101,294,81,213,702,165,7,120,1,24,1320,1748,1,45,3,169,0,218,111,1207,3738
RAJASTHAN,UDAIPUR,2002,65,79,4,148,39,0,39,78,112,75,37,224,1,8,29,250,509,206,303,1306,334,32,283,2,62,1589,2564,12,71,0,95,0,178,262,2550,6388
SIKKIM,EAST,2002,6,1,1,8,3,0,3,6,5,2,3,10,0,0,4,44,52,4,48,152,9,1,28,0,1,28,71,0,9,0,2,0,11,4,85,283
SIKKIM,NORTH,2002,1,0,1,2,0,0,0,0,1,0,1,2,0,0,0,6,4,0,4,14,1,0,5,0,0,5,11,0,2,0,0,0,2,0,20,46
SIKKIM,SOUTH,2002,2,2,0,4,1,0,1,2,1,0,1,2,0,0,0,8,3,1,2,14,3,1,10,0,1,12,28,0,3,0,1,0,4,1,40,89
SIKKIM,WEST,2002,4,2,0,6,2,0,2,4,2,0,2,4,0,0,1,8,5,0,5,19,2,1,5,0,0,5,15,0,3,0,0,0,3,2,25,67
TAMIL NADU,CHENGAI,2002,67,157,0,224,27,0,27,54,31,30,1,62,10,10,55,582,1207,329,878,3071,129,23,170,6,25,1011,1914,28,69,24,90,0,211,550,8616,12887
TAMIL NADU,CHENNAI,2002,90,294,5,389,26,0,26,52,44,21,23,88,14,0,97,570,2791,444,2347,6263,52,13,644,2,0,812,2008,20,61,941,106,0,1128,485,1459,8526
TAMIL NADU,CHENNAI RLY.,2002,10,0,0,10,0,0,0,0,0,0,0,0,0,0,22,2,309,2,307,642,10,0,12,3,0,40,69,0,3,0,0,0,3,4,144,559
TAMIL NADU,COIMBATORE RURAL,2002,83,54,1,138,25,0,25,50,30,30,0,60,11,1,36,284,1030,382,648,2392,476,19,79,10,5,1106,2407,21,79,25,74,0,199,712,4701,8862
TAMIL NADU,COIMBATORE URBAN,2002,16,22,0,38,2,0,2,4,10,4,6,20,2,0,12,161,1067,390,677,2309,93,13,61,4,4,127,487,7,14,16,28,0,65,185,1382,3226
TAMIL NADU,CUDDALORE,2002,65,119,8,192,27,0,27,54,42,36,6,84,2,0,35,173,585,183,402,1380,165,3,23,2,46,814,1439,10,110,21,27,0,168,386,4432,7095
TAMIL NADU,DHARMAPURI,2002,94,49,2,145,20,0,20,40,48,23,25,96,21,0,31,185,471,177,294,1179,316,7,45,2,70,998,1873,14,62,8,30,0,114,435,2908,5816
TAMIL NADU,DINDIGUL,2002,61,38,0,99,14,0,14,28,26,25,1,52,9,0,18,156,555,195,360,1293,50,13,30,1,28,456,912,2,33,44,23,0,102,334,3274,5165
TAMIL NADU,ERODE,2002,59,12,1,72,13,0,13,26,49,28,21,98,8,0,18,173,661,233,428,1521,74,26,39,7,32,2707,3371,3,68,6,31,0,108,486,2193,6666
TAMIL NADU,KANCHIPURAM,2002,48,43,0,91,20,0,20,40,18,0,18,36,19,0,14,203,574,78,496,1384,91,2,26,0,0,409,921,9,41,16,13,0,79,393,5930,7869
TAMIL NADU,KANYAKUMARI,2002,33,67,0,100,10,0,10,20,10,10,0,20,1,0,5,249,321,39,282,897,10,5,32,17,17,516,1528,4,43,82,29,0,158,931,2349,4731
TAMIL NADU,KARUR,2002,29,12,0,41,10,0,10,20,16,15,1,32,3,0,16,48,304,126,178,675,23,1,6,0,9,201,446,1,8,1,24,0,34,206,1661,2579
TAMIL NADU,MADURAI RURAL,2002,65,45,0,110,15,0,15,30,32,16,16,64,11,0,52,107,318,83,235,806,131,6,53,1,44,638,1171,8,60,6,45,0,119,298,2524,4459
TAMIL NADU,MADURAI URBAN,2002,22,71,0,93,7,0,7,14,26,12,14,52,6,14,25,176,756,228,528,1733,77,11,124,8,12,232,568,6,23,123,25,0,177,104,1841,3689
TAMIL NADU,NAGAPATTINAM,2002,48,65,0,113,27,0,27,54,33,24,9,66,0,0,4,100,334,76,258,772,83,3,36,1,29,1246,1517,7,83,6,14,0,110,119,1823,4061
TAMIL NADU,NAMAKKAL,2002,43,25,0,68,13,0,13,26,25,25,0,50,2,0,6,39,221,77,144,489,72,1,10,3,19,1601,1985,3,41,18,26,0,88,279,1330,3777
TAMIL NADU,NILGIRIS,2002,21,15,0,36,6,0,6,12,3,0,3,6,2,0,1,73,135,20,115,346,34,5,10,0,0,261,347,0,20,4,25,0,49,37,728,1380
TAMIL NADU,PERAMBALUR,2002,41,58,5,104,16,0,16,32,30,22,8,60,1,0,9,79,197,115,82,483,104,2,33,5,26,840,1152,4,88,15,22,0,129,142,1214,2931
TAMIL NADU,PUDUKOTTAI,2002,34,19,1,54,10,0,10,20,25,23,2,50,3,0,6,70,234,64,170,547,169,11,14,1,22,289,661,4,49,6,32,0,91,155,2237,3391
TAMIL NADU,RAMNATHAPURAM,2002,37,50,0,87,13,0,13,26,20,9,11,40,4,0,8,67,227,7,220,533,191,14,15,2,36,551,920,5,51,6,23,0,85,111,1735,3166
TAMIL NADU,SALEM RURAL,2002,79,41,2,122,14,0,14,28,26,24,2,52,7,0,7,72,209,69,140,504,228,2,15,2,29,1860,2508,3,54,6,27,0,90,372,1452,4507
TAMIL NADU,SALEM URBAN,2002,24,21,0,45,8,0,8,16,7,3,4,14,4,0,4,55,366,186,180,795,21,9,47,1,0,151,363,5,3,13,15,0,36,134,1108,1996
TAMIL NADU,SIVAGANGAI,2002,36,50,0,86,6,0,6,12,16,10,6,32,2,0,7,134,336,68,268,815,73,1,28,3,31,408,691,3,22,9,44,0,78,147,1476,2832
TAMIL NADU,THANJAVUR,2002,56,110,0,166,10,0,10,20,40,16,24,80,2,0,17,143,581,147,434,1324,115,5,35,6,31,664,1143,1,30,19,23,0,73,287,1734,3909
TAMIL NADU,THENI,2002,23,58,0,81,12,0,12,24,26,19,7,52,4,0,14,76,259,42,217,612,67,5,39,5,18,411,702,4,52,5,15,0,76,157,1691,2941
TAMIL NADU,THIRUNELVELI RURAL,2002,80,103,3,186,41,0,41,82,65,47,18,130,2,0,30,239,590,38,552,1451,7,9,59,3,85,803,1235,3,143,52,28,0,226,269,4015,6629
TAMIL NADU,THIRUNELVELI URBAN,2002,23,37,0,60,3,0,3,6,15,12,3,30,1,0,8,43,200,41,159,452,72,5,9,0,3,57,229,6,10,14,10,0,40,83,677,1276
TAMIL NADU,THIRUVALLUR,2002,41,43,0,84,10,0,10,20,34,33,1,68,5,0,12,98,208,15,193,531,159,5,25,2,17,384,784,7,96,24,28,0,155,192,2222,3612
TAMIL NADU,THIRUVANNAMALAI,2002,35,39,0,74,10,0,10,20,44,44,0,88,3,0,17,164,490,75,415,1164,289,10,28,2,45,739,1340,9,54,29,18,0,110,227,2701,4953
TAMIL NADU,THIRUVARUR,2002,30,32,1,63,4,0,4,8,13,3,10,26,2,0,3,74,170,44,126,419,65,5,13,2,20,813,981,5,50,15,2,0,72,63,1150,2532
TAMIL NADU,THOOTHUGUDI,2002,72,103,1,176,13,0,13,26,26,19,7,52,6,0,23,169,514,62,452,1226,129,6,38,6,38,487,916,4,121,0,48,0,173,212,3074,5090
TAMIL NADU,TRICHY RLY.,2002,2,1,0,3,0,0,0,0,0,0,0,0,0,0,1,8,76,1,75,161,2,0,1,0,0,26,33,0,2,1,1,0,4,4,107,232
TAMIL NADU,TRICHY RURAL,2002,46,50,0,96,5,0,5,10,14,13,1,28,1,0,2,41,157,57,100,358,69,3,10,2,12,916,1301,10,14,7,2,0,33,289,1668,3318
TAMIL NADU,TRICHY URBAN,2002,21,20,0,41,2,0,2,4,12,9,3,24,0,0,6,88,544,118,426,1182,0,0,28,5,0,101,265,7,16,106,20,0,149,131,1388,2495
TAMIL NADU,VELLORE,2002,61,73,3,137,31,0,31,62,55,33,22,110,6,0,11,336,879,242,637,2111,139,15,94,4,45,993,1707,13,48,21,6,0,88,417,4995,8245
TAMIL NADU,VILLUPURAM,2002,76,82,2,160,51,0,51,102,67,53,14,134,0,0,4,142,470,141,329,1086,374,16,27,0,24,885,1897,3,92,17,42,0,154,571,4315,7260
TAMIL NADU,VIRUDHUNAGAR,2002,52,55,1,108,13,0,13,26,23,23,0,46,2,0,17,154,409,77,332,991,93,14,59,3,28,597,1012,4,64,12,36,0,116,218,2426,4280
TRIPURA,DHALAI,2002,29,7,0,36,6,0,6,12,33,20,13,66,1,0,4,16,12,0,12,45,23,0,2,0,8,138,177,2,11,0,9,0,22,6,94,401
TRIPURA,NORTH,2002,28,10,0,38,35,0,35,70,16,6,10,32,12,0,26,36,42,21,21,158,28,3,6,3,11,150,215,2,20,0,60,0,82,14,210,712
TRIPURA,SOUTH,2002,31,9,1,41,30,0,30,60,16,6,10,32,2,0,12,45,51,0,51,161,63,2,4,1,7,100,187,4,57,0,90,0,151,10,200,735
TRIPURA,WEST,2002,113,12,0,125,37,0,37,74,63,16,47,126,14,0,14,95,165,30,135,453,66,7,8,3,14,130,244,8,40,0,77,0,125,16,345,1227
UTTAR PRADESH,AGRA,2002,158,159,28,345,41,0,41,82,139,102,37,278,18,2,107,272,1059,589,470,2517,260,166,297,6,19,573,1674,50,86,82,372,0,590,353,1370,5617
UTTAR PRADESH,ALIGARH,2002,178,216,21,415,31,0,31,62,112,69,43,224,20,2,111,151,576,191,385,1436,252,78,169,0,20,319,1054,38,72,21,169,0,300,216,1224,3996
UTTAR PRADESH,ALLAHABAD,2002,146,188,34,368,40,0,40,80,80,63,17,160,14,0,51,225,642,205,437,1574,211,87,295,9,30,506,1463,63,57,55,147,0,322,325,1757,4962
UTTAR PRADESH,AMBEDKAR NAGAR,2002,55,38,15,108,10,0,10,20,35,34,1,70,7,1,13,59,96,10,86,272,24,17,41,0,11,171,301,16,16,11,30,0,73,37,325,1028
UTTAR PRADESH,AURAIYA,2002,56,46,8,110,10,0,10,20,41,17,24,82,8,0,24,37,71,17,54,211,33,20,19,2,7,197,374,29,20,4,42,0,95,96,266,1036
UTTAR PRADESH,AZAMGARH,2002,111,91,24,226,7,0,7,14,41,7,34,82,4,3,90,119,160,24,136,536,112,50,66,2,7,311,548,23,27,23,72,0,145,0,536,1879
UTTAR PRADESH,BADAUN,2002,206,226,35,467,31,0,31,62,88,46,42,176,19,0,56,87,271,25,246,704,48,27,64,0,30,524,698,44,48,5,63,0,160,5,740,2617
UTTAR PRADESH,BAGHPAT,2002,95,109,4,208,15,0,15,30,24,15,9,48,3,0,35,28,126,24,102,318,41,14,49,2,4,1,154,17,14,16,45,0,92,43,432,1117
UTTAR PRADESH,BAHRAICH,2002,59,34,21,114,14,0,14,28,23,17,6,46,0,3,15,61,126,23,103,331,34,11,41,2,18,214,373,16,10,8,0,0,34,53,306,1069
UTTAR PRADESH,BALLIA,2002,43,64,18,125,7,0,7,14,14,14,0,28,4,1,11,70,123,12,111,332,79,9,8,0,4,180,298,16,12,45,23,0,96,18,687,1436
UTTAR PRADESH,BALRAMPUR,2002,25,15,14,54,13,0,13,26,13,9,4,26,0,0,2,36,45,6,39,128,9,14,30,1,0,103,179,5,9,5,11,0,30,22,163,535
UTTAR PRADESH,BANDA,2002,75,42,17,134,20,0,20,40,23,6,17,46,4,0,16,70,97,20,77,284,82,29,48,1,12,232,408,21,31,9,43,0,104,4,598,1474
UTTAR PRADESH,BARABANKI,2002,78,67,18,163,32,0,32,64,51,39,12,102,10,0,46,99,260,29,231,675,59,47,19,0,12,298,525,27,29,9,171,0,236,90,776,2198
UTTAR PRADESH,BAREILLY,2002,237,265,30,532,65,0,65,130,122,93,29,244,42,0,101,195,678,164,514,1694,90,65,160,0,11,633,1191,62,70,54,261,0,447,232,1019,4392
UTTAR PRADESH,BASTI,2002,46,54,22,122,16,0,16,32,31,27,4,62,3,0,14,77,123,25,98,340,77,23,39,4,23,163,433,24,13,20,31,0,88,104,505,1412
UTTAR PRADESH,BIJNOR,2002,107,87,17,211,26,0,26,52,65,49,16,130,8,0,45,69,274,36,238,670,62,35,83,7,12,105,387,34,34,33,156,0,257,83,569,1911
UTTAR PRADESH,BULANDSHAHAR,2002,217,172,21,410,33,0,33,66,94,60,34,188,13,0,80,99,404,110,294,1000,159,59,112,3,29,266,778,47,70,104,185,0,406,150,855,3172
UTTAR PRADESH,CHANDOLI,2002,27,21,9,57,6,0,6,12,9,6,3,18,0,0,15,45,79,10,69,218,13,15,29,2,7,79,154,14,11,8,24,0,57,9,205,627
UTTAR PRADESH,CHITRAKOOT DHAM,2002,25,8,8,41,8,0,8,16,10,2,8,20,0,0,4,20,33,6,27,90,5,5,13,0,9,25,89,9,23,2,10,0,44,32,148,397
UTTAR PRADESH,DEORIA,2002,39,48,21,108,5,0,5,10,20,18,2,40,1,0,15,53,96,20,76,261,91,20,44,2,8,284,564,15,10,10,18,0,53,115,667,1582
UTTAR PRADESH,ETAH,2002,210,278,15,503,37,0,37,74,86,49,37,172,36,0,75,69,237,47,190,654,146,57,67,4,3,355,640,81,43,15,85,0,224,8,1263,3170
UTTAR PRADESH,ETAWAH,2002,85,70,5,160,12,0,12,24,47,21,26,94,3,1,30,57,123,27,96,337,57,25,34,1,10,128,374,25,32,11,32,0,100,119,585,1492
UTTAR PRADESH,FAIZABAD,2002,62,43,15,120,15,0,15,30,18,17,1,36,10,1,14,72,169,28,141,435,40,101,12,0,13,262,552,12,18,24,33,0,87,124,623,1681
UTTAR PRADESH,FATEHGARH,2002,96,62,15,173,9,0,9,18,37,25,12,74,2,2,14,32,76,26,50,202,54,28,49,0,3,169,318,32,0,0,0,0,32,15,718,1413
UTTAR PRADESH,FATEHPUR,2002,91,43,28,162,12,0,12,24,29,19,10,58,3,0,17,60,99,21,78,278,13,24,46,0,5,206,431,26,18,12,44,0,100,137,724,1637
UTTAR PRADESH,FIROZABAD,2002,138,127,16,281,26,0,26,52,95,51,44,190,6,1,59,52,229,84,145,576,85,59,96,0,21,377,638,36,37,46,105,0,224,0,944,2555
UTTAR PRADESH,G.R.P.,2002,30,12,3,45,2,0,2,4,7,4,3,14,15,2,46,1,2845,84,2761,5754,10,34,42,2,0,2,92,0,11,31,0,0,42,2,942,4039
UTTAR PRADESH,GAUTAMBUDH NAGAR,2002,72,68,12,152,19,0,19,38,36,29,7,72,7,2,28,65,652,341,311,1406,57,42,116,2,0,15,373,17,20,30,42,0,109,141,770,2213
UTTAR PRADESH,GHAZIABAD,2002,231,375,18,624,20,1,19,40,99,69,30,198,13,2,83,191,1274,674,600,2837,96,95,198,2,5,82,884,21,35,108,176,0,340,406,1089,4619
UTTAR PRADESH,GHAZIPUR,2002,55,42,27,124,4,0,4,8,16,7,9,32,1,0,16,46,80,6,74,223,32,0,44,0,2,163,241,14,12,12,50,0,88,0,432,1048
UTTAR PRADESH,GONDA,2002,23,65,24,112,11,0,11,22,31,23,8,62,5,2,20,106,155,25,130,443,32,19,70,2,5,260,450,29,20,16,27,0,92,62,521,1505
UTTAR PRADESH,GORAKHPUR,2002,112,74,31,217,27,0,27,54,43,39,4,86,5,1,46,174,226,68,158,678,107,58,109,1,1,280,810,30,28,19,56,0,133,254,936,2618
UTTAR PRADESH,HAMIRPUR,2002,62,32,13,107,9,0,9,18,19,6,13,38,1,0,23,33,69,10,59,195,17,12,17,0,0,52,151,17,34,4,28,0,83,53,366,861
UTTAR PRADESH,HARDOI,2002,135,103,27,265,39,0,39,78,48,36,12,96,1,0,20,42,159,18,141,381,45,24,55,0,21,389,675,26,54,36,72,0,188,141,553,1990
UTTAR PRADESH,HATHRAS,2002,76,80,9,165,25,0,25,50,49,30,19,98,19,4,52,57,175,31,144,482,116,54,58,0,4,158,464,21,41,12,107,0,181,74,654,1845
UTTAR PRADESH,J.P.NAGAR,2002,85,41,6,132,15,0,15,30,31,27,4,62,3,0,26,43,98,21,77,268,54,10,53,0,0,35,240,10,22,10,80,0,122,88,531,1241
UTTAR PRADESH,JALAUN,2002,79,28,8,115,4,0,4,8,34,14,20,68,3,0,15,36,134,26,108,322,18,19,13,0,10,24,163,22,19,17,22,0,80,79,569,1153
UTTAR PRADESH,JAUNPUR,2002,51,57,28,136,8,0,8,16,16,15,1,32,4,0,20,68,122,35,87,336,46,23,70,6,2,242,534,23,18,10,45,0,96,145,401,1405
UTTAR PRADESH,JHANSI,2002,62,29,33,124,14,0,14,28,28,11,17,56,0,0,26,43,192,75,117,453,32,24,48,0,1,177,285,14,21,2,42,0,79,3,628,1419
UTTAR PRADESH,KANNAUJ,2002,67,53,10,130,6,0,6,12,24,16,8,48,6,0,14,32,73,6,67,198,16,9,28,0,4,51,181,15,10,2,37,0,64,73,391,921
UTTAR PRADESH,KANPUR DEHAT,2002,56,45,10,111,13,0,13,26,41,31,10,82,20,1,33,39,120,7,113,333,56,24,37,1,12,271,529,37,26,3,73,0,139,128,390,1436
UTTAR PRADESH,KANPUR NAGAR,2002,202,166,24,392,30,0,30,60,163,126,37,326,16,3,106,268,1153,629,524,2699,156,158,223,4,17,664,1641,50,75,123,307,0,555,419,1581,5908
UTTAR PRADESH,KAUSHAMBI,2002,61,30,13,104,28,0,28,56,20,15,5,40,1,1,14,41,83,4,79,223,23,17,32,1,18,139,309,13,25,2,32,0,72,79,277,950
UTTAR PRADESH,KHIRI,2002,144,139,27,310,41,0,41,82,60,50,10,120,6,3,33,86,272,37,235,672,68,31,37,6,30,367,576,66,45,14,97,0,222,37,843,2452
UTTAR PRADESH,KUSHI NAGAR,2002,55,29,19,103,7,0,7,14,24,15,9,48,3,1,10,34,108,23,85,264,61,26,42,1,10,209,487,18,22,35,7,0,82,138,339,1198
UTTAR PRADESH,LALITPUR,2002,18,11,8,37,10,0,10,20,2,1,1,4,9,0,1,23,48,15,33,129,20,9,13,0,1,26,104,9,14,13,5,0,41,35,309,584
UTTAR PRADESH,LUCKNOW,2002,175,162,38,375,43,0,43,86,195,147,48,390,23,0,145,656,2210,821,1389,5244,219,190,358,4,16,85,1199,59,92,105,369,0,625,327,3151,8622
UTTAR PRADESH,MAHARAJGANJ,2002,46,20,19,85,13,0,13,26,10,0,10,20,1,0,4,28,39,4,35,111,40,9,18,1,4,85,230,6,15,11,10,0,42,73,227,679
UTTAR PRADESH,MAHOBA,2002,41,8,8,57,5,0,5,10,7,0,7,14,5,0,17,52,57,11,46,188,13,6,14,0,10,41,118,13,21,5,0,0,39,34,236,593
UTTAR PRADESH,MAINPURI,2002,123,122,15,260,9,0,9,18,55,27,28,110,23,0,67,53,129,28,101,401,86,35,71,2,20,192,409,42,17,0,38,0,97,3,599,1701
UTTAR PRADESH,MATHURA,2002,123,139,11,273,16,0,16,32,49,32,17,98,9,0,63,77,376,172,204,901,114,61,117,2,2,125,638,29,40,45,94,0,208,217,901,2610
UTTAR PRADESH,MAU,2002,46,45,10,101,15,0,15,30,26,23,3,52,6,0,27,64,73,8,65,243,87,17,31,1,10,121,340,6,29,22,41,0,98,73,369,1119
UTTAR PRADESH,MEERUT,2002,230,175,15,420,35,0,35,70,127,74,53,254,13,9,122,173,857,356,501,2031,114,86,149,9,3,48,608,26,47,87,212,0,372,199,1282,4018
UTTAR PRADESH,MIRZAPUR,2002,46,35,13,94,7,0,7,14,17,11,6,34,5,0,12,38,108,20,88,271,31,21,19,3,0,123,323,15,15,8,28,0,66,126,232,902
UTTAR PRADESH,MORADABAD,2002,178,160,31,369,36,0,36,72,77,59,18,154,14,2,60,126,518,121,397,1238,86,40,112,0,5,118,416,35,53,75,174,0,337,55,897,2852
UTTAR PRADESH,MUZAFFARNAGAR,2002,287,195,9,491,30,0,30,60,121,60,61,242,14,2,122,127,479,159,320,1223,112,38,88,6,4,10,374,37,34,30,163,0,264,116,1164,3188
UTTAR PRADESH,PILIBHIT,2002,91,100,14,205,41,0,41,82,51,34,17,102,12,1,46,58,179,27,152,475,53,34,76,0,0,12,222,33,19,70,103,0,225,47,867,1907
UTTAR PRADESH,PRATAPGARH,2002,64,87,17,168,18,0,18,36,25,16,9,50,8,1,21,55,113,24,89,311,75,20,57,1,0,336,577,27,18,4,36,0,85,88,791,1862
UTTAR PRADESH,RAIBAREILLY,2002,75,56,23,154,35,0,35,70,40,35,5,80,2,0,24,98,245,25,220,614,70,44,44,1,13,324,619,26,46,22,110,0,204,123,688,2109
UTTAR PRADESH,RAMPUR,2002,87,77,15,179,20,0,20,40,40,38,2,80,6,0,31,70,277,39,238,661,40,22,45,2,2,81,250,11,36,14,106,0,167,58,372,1412
UTTAR PRADESH,SAHARANPUR,2002,89,114,9,212,15,0,15,30,64,55,9,128,4,0,44,81,309,125,184,747,70,49,139,3,0,5,266,24,19,42,216,0,301,0,1035,2331
UTTAR PRADESH,SANT KABIRNAGAR,2002,22,18,4,44,4,0,4,8,12,0,12,24,2,0,4,16,39,9,30,100,14,11,17,0,0,100,173,6,6,3,16,0,31,31,93,418
UTTAR PRADESH,SHAHJAHANPUR,2002,210,205,34,449,40,0,40,80,89,38,51,178,7,2,70,88,337,58,279,841,44,32,81,0,16,211,503,49,52,35,83,0,219,119,912,2716
UTTAR PRADESH,SHRAWASTI,2002,18,25,9,52,3,0,3,6,6,5,1,12,2,1,7,37,59,6,53,165,18,5,19,0,0,46,114,3,16,19,12,0,50,26,157,488
UTTAR PRADESH,SIDHARTHNAGAR,2002,15,10,9,34,6,0,6,12,21,18,3,42,1,1,8,43,39,8,31,131,16,12,39,3,2,77,198,6,19,4,11,0,40,49,204,595
UTTAR PRADESH,SITAPUR,2002,167,144,43,354,73,0,73,146,99,61,38,198,3,0,87,171,590,60,530,1441,102,42,62,0,32,310,710,83,65,13,66,0,227,162,1091,3405
UTTAR PRADESH,SONBHADRA,2002,33,29,13,75,5,0,5,10,7,5,2,14,1,0,9,36,70,15,55,186,13,8,16,0,4,104,232,8,8,8,8,0,32,87,90,557
UTTAR PRADESH,ST.RAVIDASNAGAR,2002,29,15,7,51,0,0,0,0,5,2,3,10,1,0,10,35,65,28,37,176,18,9,9,0,1,84,193,4,1,1,18,0,24,72,148,532
UTTAR PRADESH,SULTANPUR,2002,85,109,22,216,23,0,23,46,34,28,6,68,5,0,45,99,229,43,186,607,62,57,53,1,9,314,636,20,22,15,66,0,123,140,730,2140
UTTAR PRADESH,UNNAO,2002,126,94,15,235,34,0,34,68,63,55,8,126,5,0,51,67,218,36,182,559,92,32,60,0,14,397,740,57,70,8,118,0,253,145,996,2662
UTTAR PRADESH,VARANASI,2002,78,87,11,176,16,0,16,32,52,36,16,104,4,1,52,136,494,236,258,1181,91,85,97,12,5,311,797,34,23,110,104,0,271,196,810,2809
UTTARAKHAND,ALMORA,2002,17,14,3,34,3,0,3,6,2,2,0,4,2,0,14,22,55,1,54,148,12,5,7,0,8,68,118,11,7,1,6,0,25,18,49,324
UTTARAKHAND,BAGESHWAR,2002,4,1,0,5,5,0,5,10,3,3,0,6,0,0,9,2,22,1,21,55,0,2,7,0,0,16,29,2,0,0,7,0,9,4,45,129
UTTARAKHAND,CHAMOLI,2002,15,7,1,23,4,0,4,8,6,5,1,12,2,0,6,27,18,3,15,71,21,0,3,0,2,14,61,5,12,7,4,0,28,21,52,227
UTTARAKHAND,CHAMPAWAT,2002,6,4,0,10,2,0,2,4,4,4,0,8,0,0,1,8,14,4,10,37,2,0,1,0,0,12,18,1,3,0,0,0,4,3,31,92
UTTARAKHAND,DEHRADUN,2002,39,37,15,91,12,0,12,24,62,50,12,124,4,3,22,139,294,110,184,756,71,35,121,2,3,75,458,5,11,29,79,0,124,151,568,1777
UTTARAKHAND,HARIDWAR,2002,75,70,6,151,23,0,23,46,63,38,25,126,5,3,49,90,430,150,280,1007,114,48,78,5,8,207,580,11,41,30,102,0,184,120,450,2028
UTTARAKHAND,NAINITAL,2002,34,32,4,70,5,0,5,10,13,13,0,26,3,0,17,75,164,48,116,423,35,10,27,0,2,79,212,5,11,4,36,1,57,59,190,806
UTTARAKHAND,PAURI GARHWAL,2002,20,18,0,38,6,0,6,12,11,10,1,22,2,0,13,62,57,5,52,191,11,9,13,0,5,71,140,5,7,0,14,0,26,31,71,426
UTTARAKHAND,PITHORAGARH,2002,6,5,3,14,3,0,3,6,0,0,0,0,0,0,4,8,20,1,19,52,12,2,4,0,0,7,25,3,7,5,4,0,19,0,178,271
UTTARAKHAND,RUDRA PRAYAG,2002,9,5,0,14,0,0,0,0,1,1,0,2,1,0,6,14,13,0,13,47,15,1,1,0,5,22,50,4,7,0,1,0,12,6,9,120
UTTARAKHAND,TEHRI GARHWAL,2002,7,11,0,18,3,0,3,6,5,5,0,10,1,0,2,19,35,2,33,92,6,12,7,0,2,42,96,3,10,0,10,0,23,27,81,283
UTTARAKHAND,UDHAMSINGH NAGAR,2002,54,39,12,105,14,0,14,28,22,19,3,44,12,0,30,64,221,43,178,548,26,20,38,1,5,139,229,11,24,18,41,0,94,0,466,1257
UTTARAKHAND,UTTARKASHI,2002,6,6,3,15,9,0,9,18,6,5,1,12,0,0,4,24,22,6,16,72,17,1,5,0,0,8,31,0,5,3,12,0,20,0,105,236
WEST BENGAL,24 PARGANAS NORTH,2002,204,55,47,306,88,0,88,176,91,63,28,182,10,0,60,21,1842,467,1375,3775,248,40,77,6,1,0,372,29,84,1,630,0,744,0,3360,6894
WEST BENGAL,24 PARGANAS SOUTH,2002,140,2,62,204,68,0,68,136,67,66,1,134,19,0,26,13,1068,312,756,2194,218,4,19,3,6,0,250,53,64,2,555,0,674,0,3576,5965
WEST BENGAL,ASANSOL,2002,11,0,4,15,1,0,1,2,3,0,3,6,0,34,5,1,39,15,24,118,8,7,9,0,1,2,28,2,1,0,28,0,31,1,206,363
WEST BENGAL,BANKURA,2002,39,27,14,80,19,0,19,38,12,11,1,24,12,11,9,6,215,5,210,468,61,3,19,2,5,45,280,20,22,0,85,0,127,145,434,1205
WEST BENGAL,BIRBHUM,2002,57,21,23,101,36,0,36,72,28,22,6,56,3,32,11,5,195,34,161,441,150,11,3,2,12,87,447,1,50,0,175,0,226,182,926,2010
WEST BENGAL,BURDWAN,2002,92,11,38,141,53,0,53,106,48,44,4,96,13,37,27,23,524,58,466,1148,150,0,35,4,4,117,381,21,59,0,296,0,376,71,2506,4129
WEST BENGAL,COOCHBEHAR,2002,30,1,7,38,43,0,43,86,42,41,1,84,4,3,10,9,123,20,103,272,39,0,14,4,1,130,188,5,39,1,155,0,200,0,486,1146
WEST BENGAL,DAKSHIN DINAJPUR,2002,23,0,16,39,20,0,20,40,26,24,2,52,2,36,1,3,86,12,74,214,35,0,7,1,1,37,99,14,31,0,61,0,106,18,696,1114
WEST BENGAL,DARJEELING,2002,63,0,22,85,22,0,22,44,23,23,0,46,10,29,24,6,476,117,359,1021,25,0,7,5,2,102,578,1,21,1,55,0,78,437,550,1881
WEST BENGAL,HOOGHLY,2002,77,6,25,108,32,0,32,64,36,35,1,72,5,105,13,13,438,62,376,1012,309,5,61,1,0,246,760,5,26,2,328,0,361,138,902,2773
WEST BENGAL,HOWRAH,2002,18,2,11,31,6,0,6,12,8,6,2,16,8,15,8,3,120,38,82,274,64,11,62,0,8,112,376,9,9,0,65,0,83,119,701,1359
WEST BENGAL,HOWRAH CITY,2002,24,3,9,36,10,0,10,20,24,20,4,48,4,102,16,2,283,106,177,690,43,16,45,3,5,117,351,5,7,0,71,0,83,122,347,1258
WEST BENGAL,HOWRAH G.R.P.,2002,9,7,0,16,3,0,3,6,1,0,1,2,1,23,10,0,316,0,316,666,9,0,2,1,0,0,12,0,5,0,1,0,6,0,121,509
WEST BENGAL,JALPAIGURI,2002,92,21,54,167,38,0,38,76,22,14,8,44,13,12,27,9,400,58,342,861,52,34,12,3,7,143,468,3,54,0,154,0,211,217,557,1924
WEST BENGAL,KHARAGPUR G.R.P.,2002,3,3,0,6,0,0,0,0,1,1,0,2,3,8,6,0,124,0,124,265,5,0,0,0,0,0,6,0,0,0,0,0,0,1,31,185
WEST BENGAL,KOLKATA,2002,58,148,15,221,33,0,33,66,107,74,33,214,18,58,166,190,3716,980,2736,7864,242,256,859,44,0,1173,3018,4,160,24,235,0,423,444,2713,10663
WEST BENGAL,MALDA,2002,53,32,32,117,33,0,33,66,39,15,24,78,3,16,8,1,283,47,236,594,28,15,11,7,0,72,273,5,60,3,69,0,137,140,701,1611
WEST BENGAL,MURSHIDABAD,2002,123,5,53,181,62,0,62,124,37,35,2,74,15,49,24,6,310,39,271,714,133,0,8,8,0,140,568,8,58,0,254,0,320,279,1059,2631
WEST BENGAL,NADIA,2002,99,0,38,137,79,0,79,158,82,82,0,164,18,16,23,10,609,0,609,1285,228,0,0,0,4,512,955,13,90,0,270,0,373,211,1484,3786
WEST BENGAL,PASCHIM MIDNAPUR,2002,86,38,24,148,53,0,53,106,47,47,0,94,16,20,24,9,328,53,275,725,167,24,23,0,44,47,305,22,35,0,249,0,306,0,1331,2587
WEST BENGAL,PURAB MIDNAPUR,2002,38,1,18,57,25,0,25,50,42,42,0,84,7,10,11,9,157,10,147,351,136,2,3,1,2,0,144,39,10,0,175,0,224,0,1260,1946
WEST BENGAL,PURULIA,2002,41,0,8,49,15,0,15,30,14,14,0,28,6,13,15,3,230,3,227,497,53,9,24,0,3,0,89,4,51,0,92,0,147,0,577,1158
WEST BENGAL,SEALDAH G.R.P.,2002,22,4,3,29,0,0,0,0,4,0,4,8,2,6,14,0,246,0,246,514,10,0,4,0,0,0,14,0,1,0,0,0,1,0,94,410
WEST BENGAL,SILIGURI G.R.P.,2002,4,0,0,4,0,0,0,0,1,1,0,2,2,1,1,0,89,0,89,182,0,0,1,0,0,0,1,0,1,0,0,0,1,0,30,130
WEST BENGAL,UTTAR DINAJPUR,2002,38,26,17,81,20,0,20,40,26,14,12,52,10,10,5,6,232,22,210,495,48,14,10,3,8,30,291,10,26,0,66,1,103,178,541,1325
A & N ISLANDS,ANDAMAN,2002,14,3,0,17,1,0,1,2,2,1,1,4,1,0,7,47,46,2,44,147,11,4,11,0,2,92,120,0,16,3,4,0,23,0,316,580
A & N ISLANDS,NICOBAR,2002,3,0,1,4,1,0,1,2,0,0,0,0,0,0,0,2,3,0,3,8,0,0,0,0,0,5,5,0,1,0,0,0,1,0,12,28
CHANDIGARH,CHANDIGARH,2002,31,35,7,73,18,0,18,36,54,47,7,108,1,1,26,336,1647,617,1030,3658,78,35,181,5,5,107,418,1,36,28,56,0,121,7,1111,3806
D & N HAVELI,D and N HAVELI,2002,11,2,0,13,4,0,4,8,9,5,4,18,3,0,1,38,75,38,37,192,5,12,10,0,2,29,58,0,3,0,3,0,6,0,142,349
DAMAN & DIU,DAMAN,2002,7,1,0,8,0,0,0,0,2,1,1,4,1,0,0,51,46,31,15,144,14,5,10,0,2,16,47,0,0,0,3,0,3,0,53,211
DAMAN & DIU,DIU,2002,1,2,0,3,0,0,0,0,1,1,0,2,1,0,1,5,10,4,6,27,2,0,0,0,0,2,4,0,0,0,0,0,0,0,25,50
DELHI UT,CENTRAL,2002,23,38,7,68,22,0,22,44,71,57,14,142,1,1,39,143,1356,453,903,2896,8,46,143,4,1,108,330,2,41,17,6,0,66,20,1481,3578
DELHI UT,EAST,2002,50,35,9,94,10,0,10,20,141,109,32,282,7,13,37,210,1440,779,661,3147,14,32,105,7,6,247,426,19,55,6,16,0,96,15,1407,3881
DELHI UT,G.R.P.(RLY),2002,2,4,0,6,0,0,0,0,3,0,3,6,1,0,12,0,1280,21,1259,2573,0,4,22,0,0,10,36,0,3,0,0,0,3,0,66,1407
DELHI UT,I.G.I. AIRPORT,2002,4,0,1,5,0,0,0,0,1,1,0,2,0,0,2,1,52,8,44,107,1,4,576,0,0,0,582,0,2,2,0,0,4,1,77,724
DELHI UT,NEW DELHI,2002,6,8,1,15,8,0,8,16,20,12,8,40,0,2,20,54,1149,347,802,2374,10,24,266,10,2,45,458,0,11,15,2,0,28,101,652,2406
DELHI UT,NORTH,2002,40,22,12,74,27,0,27,54,84,47,37,168,7,12,43,131,1183,412,771,2559,14,66,136,7,8,160,391,5,31,23,4,0,63,0,1666,3681
DELHI UT,NORTH EAST,2002,66,65,2,133,39,0,39,78,156,111,45,312,2,8,65,139,878,473,405,1970,12,24,71,3,3,224,357,13,27,3,29,0,72,20,1108,2957
DELHI UT,NORTH WEST,2002,135,90,9,234,120,0,120,240,430,259,171,860,20,11,112,487,2290,1210,1080,5210,14,75,136,3,12,360,650,26,101,16,20,0,163,50,4674,9191
DELHI UT,S.T.F.,2002,0,0,0,0,0,0,0,0,0,0,0,0,0,0,0,0,0,0,0,0,0,0,0,0,0,0,0,0,0,0,0,0,0,0,0,0
DELHI UT,SOUTH,2002,80,60,6,146,65,0,65,130,163,124,39,326,4,3,74,518,3541,1897,1644,7681,37,102,293,3,10,252,797,22,76,22,22,0,142,100,3853,9306
DELHI UT,SOUTH WEST,2002,52,45,5,102,68,0,68,136,126,80,46,252,4,4,48,364,1531,774,757,3482,24,34,168,5,8,167,456,21,62,13,20,0,116,50,1995,4814
DELHI UT,SPL CELL,2002,0,1,0,1,0,0,0,0,0,0,0,0,0,0,0,0,0,0,0,0,0,0,28,0,0,0,28,0,0,0,0,0,0,0,15,44
DELHI UT,WEST,2002,73,72,16,161,44,0,44,88,128,93,35,256,1,13,50,313,1925,1060,865,4227,5,33,154,4,7,278,540,27,37,11,16,0,91,59,3882,7148
LAKSHADWEEP,LAKSHADWEEP,2002,0,0,0,0,1,0,1,2,0,0,0,0,0,0,0,9,12,0,12,33,18,0,0,0,2,5,25,0,1,0,0,0,1,0,5,53
PUDUCHERRY,PONDICHERRY,2002,29,43,2,74,6,0,6,12,10,6,4,20,2,0,6,129,526,258,268,1189,193,11,31,3,22,1093,1543,5,59,26,9,0,99,190,2042,4437
ANDHRA PRADESH,ADILABAD,2003,107,65,11,183,35,0,35,70,46,16,30,92,8,0,24,207,284,35,249,807,98,19,146,1,42,1194,1748,11,141,39,238,0,429,248,1917,4881
ANDHRA PRADESH,ANANTAPUR,2003,173,115,9,297,19,0,19,38,60,45,15,120,4,0,17,190,358,90,268,927,144,33,84,10,40,1873,2490,4,224,45,146,0,419,306,728,4582
ANDHRA PRADESH,CHITTOOR,2003,109,80,1,190,36,0,36,72,90,34,56,180,5,0,18,304,901,142,759,2129,66,47,292,22,27,1049,2025,23,121,173,60,0,377,522,2678,6624
ANDHRA PRADESH,CUDDAPAH,2003,95,7,4,106,10,0,10,20,37,28,9,74,4,0,9,109,199,33,166,520,74,17,65,8,35,815,1281,5,104,31,60,0,200,267,1492,3447
ANDHRA PRADESH,CYBERABAD,2003,155,101,4,260,31,0,31,62,102,62,40,204,14,0,56,1041,1489,291,1198,4089,49,67,691,8,45,1203,2850,25,96,78,543,1,743,787,3719,10305
ANDHRA PRADESH,EAST GODAVARI,2003,73,78,2,153,18,0,18,36,59,35,24,118,4,0,17,569,1162,178,984,2914,79,83,252,21,71,2918,3848,11,150,110,357,0,628,424,1158,7616
ANDHRA PRADESH,GUNTAKAL RLY.,2003,4,0,0,4,1,0,1,2,1,1,0,2,0,0,5,0,209,0,209,423,0,0,0,6,0,9,17,0,2,0,0,0,2,2,129,368
ANDHRA PRADESH,GUNTUR,2003,210,84,2,296,46,0,46,92,95,77,18,190,16,0,28,316,1173,228,945,2706,124,82,368,12,69,1633,2699,22,228,99,399,0,748,411,2298,7715
ANDHRA PRADESH,HYDERABAD CITY,2003,124,132,5,261,57,0,57,114,155,64,91,310,18,1,91,1875,6574,2195,4379,15133,231,158,2093,21,68,4595,7655,42,165,296,1082,0,1585,489,1980,20252
ANDHRA PRADESH,KARIMNAGAR,2003,153,105,11,269,88,0,88,176,89,67,22,178,12,1,43,261,460,18,442,1237,180,46,376,10,48,2771,3794,53,362,132,602,1,1150,363,1542,7709
ANDHRA PRADESH,KHAMMAM,2003,89,44,6,139,45,0,45,90,41,35,6,82,6,0,8,211,364,86,278,953,120,32,144,8,45,2246,2934,17,162,246,180,0,605,339,826,5179
ANDHRA PRADESH,KRISHNA,2003,66,65,3,134,45,0,45,90,55,16,39,110,2,0,12,233,601,37,564,1449,50,28,170,13,48,1992,2546,20,186,107,317,0,630,245,1025,5283
ANDHRA PRADESH,KURNOOL,2003,125,101,4,230,28,0,28,56,35,16,19,70,8,0,24,146,262,18,244,702,88,18,196,17,34,1113,1715,11,231,131,202,0,575,249,1752,4775
ANDHRA PRADESH,MAHABOOBNAGAR,2003,191,108,22,321,69,0,69,138,46,33,13,92,5,0,33,270,452,39,413,1212,117,32,104,9,69,931,1509,19,179,36,238,0,472,247,2213,5390
ANDHRA PRADESH,MEDAK,2003,124,36,16,176,30,0,30,60,52,37,15,104,10,0,50,300,502,75,427,1364,84,20,100,6,60,1848,2521,44,128,37,174,0,383,403,794,4818
ANDHRA PRADESH,NALGONDA,2003,142,68,5,215,62,0,62,124,49,37,12,98,9,0,24,165,354,71,283,906,177,31,154,4,46,1258,2118,33,249,51,319,0,652,448,2003,5651
ANDHRA PRADESH,NELLORE,2003,80,70,1,151,27,0,27,54,63,58,5,126,2,2,12,232,569,89,480,1386,67,25,172,10,67,1898,2560,10,204,97,231,0,542,321,1792,5952
ANDHRA PRADESH,NIZAMABAD,2003,90,49,20,159,29,0,29,58,35,7,28,70,7,0,32,241,332,38,294,944,52,22,182,10,36,2135,2693,11,61,32,329,3,436,256,710,4674
ANDHRA PRADESH,PRAKASHAM,2003,94,36,5,135,22,0,22,44,42,31,11,84,9,0,19,143,346,59,287,863,38,22,101,7,26,1450,1890,13,133,149,114,0,409,246,705,3720
ANDHRA PRADESH,RANGA REDDY,2003,65,30,3,98,14,0,14,28,23,14,9,46,0,0,10,135,134,2,132,413,32,5,47,0,35,837,1084,12,71,12,113,0,208,128,274,1980
ANDHRA PRADESH,SECUNDERABAD RLY.,2003,10,0,0,10,0,0,0,0,0,0,0,0,4,0,5,0,413,0,413,835,6,0,2,26,0,7,41,0,0,0,0,0,0,0,63,536
ANDHRA PRADESH,SRIKAKULAM,2003,39,32,4,75,9,0,9,18,8,4,4,16,7,0,4,102,167,20,147,447,43,25,71,2,24,654,1034,7,58,44,147,0,256,215,1001,2663
ANDHRA PRADESH,VIJAYAWADA,2003,34,58,0,92,27,0,27,54,63,45,18,126,5,0,61,876,3417,351,3066,7776,17,54,816,27,21,2101,3285,7,170,146,1208,0,1531,249,727,10084
ANDHRA PRADESH,VIJAYAWADA RLY.,2003,0,0,0,0,0,0,0,0,0,0,0,0,0,0,2,0,360,2,358,722,0,0,6,2,1,11,29,0,0,3,0,0,3,9,36,430
ANDHRA PRADESH,VISAKHA RURAL,2003,61,5,1,67,15,0,15,30,15,15,0,30,0,1,6,115,194,0,194,510,30,15,58,6,35,654,1025,3,54,16,89,0,162,227,999,2599
ANDHRA PRADESH,VISAKHAPATNAM,2003,19,21,0,40,9,0,9,18,30,20,10,60,4,0,5,281,532,174,358,1354,1,81,290,24,3,362,956,3,11,30,146,0,190,195,1214,3261
ANDHRA PRADESH,VIZIANAGARAM,2003,30,16,1,47,6,0,6,12,3,0,3,6,1,0,8,106,134,1,133,383,13,25,33,5,0,436,674,4,34,25,127,0,190,162,981,2150
ANDHRA PRADESH,WARANGAL,2003,128,80,3,211,61,0,61,122,103,69,34,206,6,0,23,293,452,133,319,1226,276,43,224,11,0,1821,2709,35,222,0,162,0,419,334,2550,6827
ANDHRA PRADESH,WEST GODAVARI,2003,77,92,4,173,107,0,107,214,88,65,23,176,6,0,14,329,1014,116,898,2377,72,69,344,12,54,1731,2705,21,382,121,584,0,1108,423,1936,7480
ARUNACHAL PRADESH,CHANGLANG,2003,10,1,0,11,4,0,4,8,7,7,0,14,4,0,0,16,19,0,19,58,1,1,1,0,3,33,39,0,0,0,2,0,2,0,43,145
ARUNACHAL PRADESH,DIBANG VALLEY,2003,1,1,0,2,2,0,2,4,1,1,0,2,2,0,6,15,13,0,13,49,1,1,2,0,0,38,42,0,1,0,5,0,6,0,27,116
ARUNACHAL PRADESH,K/KUMEY,2003,4,1,0,5,0,0,0,0,2,2,0,4,1,0,1,0,1,0,1,4,0,0,0,0,0,10,10,0,0,0,0,0,0,0,5,25
ARUNACHAL PRADESH,KAMENG EAST,2003,4,0,0,4,0,0,0,0,2,2,0,4,0,0,5,15,11,0,11,42,1,0,0,0,0,33,34,0,10,0,1,0,11,0,19,101
ARUNACHAL PRADESH,KAMENG WEST,2003,7,1,0,8,1,0,1,2,0,0,0,0,1,0,2,11,11,0,11,36,0,0,0,2,0,22,24,0,0,0,0,0,0,0,25,83
ARUNACHAL PRADESH,LOHIT,2003,16,0,0,16,1,0,1,2,15,14,1,30,4,0,2,26,25,0,25,82,0,2,2,0,0,30,34,0,5,0,1,0,6,0,60,189
ARUNACHAL PRADESH,PAPUM PARE,2003,9,2,0,11,3,0,3,6,10,8,2,20,11,0,11,56,110,38,72,298,1,10,2,0,0,67,80,0,7,0,1,0,8,0,105,405
ARUNACHAL PRADESH,SIANG EAST,2003,6,2,0,8,9,0,9,18,10,9,1,20,4,0,13,22,46,4,42,131,0,1,7,1,1,40,50,0,4,0,1,0,5,0,65,232
ARUNACHAL PRADESH,SIANG UPPER,2003,4,2,1,7,1,0,1,2,1,1,0,2,0,0,0,8,16,0,16,40,0,1,0,0,0,12,13,0,0,0,0,0,0,0,9,55
ARUNACHAL PRADESH,SIANG WEST,2003,5,2,0,7,5,0,5,10,5,4,1,10,2,0,2,22,50,5,45,126,2,7,4,0,0,57,70,0,6,0,1,0,7,0,87,257
ARUNACHAL PRADESH,SUBANSIRI LOWER,2003,3,3,1,7,3,0,3,6,4,0,4,8,4,0,5,20,17,2,15,63,1,2,1,1,1,11,17,0,0,0,0,0,0,0,46,123
ARUNACHAL PRADESH,SUBANSIRI UPPER,2003,4,1,0,5,1,0,1,2,2,2,0,4,2,0,7,15,11,0,11,46,0,0,0,1,3,35,39,0,0,0,0,0,0,0,36,118
ARUNACHAL PRADESH,TAWANG,2003,0,0,0,0,0,0,0,0,0,0,0,0,0,0,1,12,14,1,13,41,0,0,0,2,0,6,8,0,1,0,0,0,1,0,13,49
ARUNACHAL PRADESH,TIRAP,2003,2,3,1,6,1,0,1,2,8,0,8,16,2,0,5,13,25,0,25,70,0,3,2,0,2,33,40,0,9,0,2,0,11,0,35,146
ARUNACHAL PRADESH,UPPER DIBANG VALLEY,2003,2,1,0,3,0,0,0,0,1,1,0,2,0,0,0,2,1,0,1,4,0,0,0,0,0,0,0,0,0,0,0,0,0,0,10,17
ASSAM,BARPETA,2003,46,9,3,58,61,0,61,122,76,56,20,152,34,4,21,88,121,2,119,389,213,16,41,5,10,216,620,6,15,0,112,0,133,119,428,1644
ASSAM,BONGAIGAON,2003,27,9,2,38,27,0,27,54,46,40,6,92,22,0,15,68,93,0,93,291,75,11,17,0,1,73,221,6,10,0,61,0,77,44,165,772
ASSAM,C.I.D.,2003,0,0,0,0,0,0,0,0,1,1,0,2,0,0,0,0,0,0,0,0,0,1,4,0,0,0,5,0,0,0,0,0,0,0,18,24
ASSAM,CACHAR,2003,68,35,0,103,70,0,70,140,120,95,25,240,26,2,13,273,398,0,398,1110,395,41,58,4,82,212,1087,3,118,0,229,0,350,295,1015,3457
ASSAM,DARRANG,2003,73,21,0,94,53,0,53,106,83,63,20,166,26,2,22,138,202,12,190,592,97,17,22,0,23,209,444,7,93,0,48,0,148,76,188,1400
ASSAM,DHEMAJI,2003,20,18,0,38,43,0,43,86,25,10,15,50,3,0,13,31,94,0,94,235,24,10,14,1,38,195,310,0,14,0,44,0,58,28,147,762
ASSAM,DHUBRI,2003,64,20,1,85,68,0,68,136,62,51,11,124,32,5,12,77,109,7,102,344,468,64,35,0,16,315,1076,6,87,0,151,0,244,178,150,1920
ASSAM,DIBRUGARH,2003,107,33,11,151,38,0,38,76,54,39,15,108,44,1,36,122,298,32,266,799,81,14,28,3,136,369,779,0,28,0,28,0,56,148,322,1901
ASSAM,G.R.P.,2003,4,0,0,4,0,0,0,0,1,1,0,2,6,0,3,0,55,0,55,119,7,0,1,0,0,10,18,0,1,0,0,0,1,0,94,182
ASSAM,GOALPARA,2003,30,23,3,56,60,0,60,120,51,47,4,102,31,1,11,5,159,0,159,366,118,8,28,5,11,62,265,2,36,0,152,0,190,33,269,1098
ASSAM,GOLAGHAT,2003,55,16,7,78,67,0,67,134,73,60,13,146,7,0,24,94,296,16,280,717,8,19,38,5,35,348,559,0,26,0,58,0,84,106,177,1459
ASSAM,GUWAHATI CITY,2003,50,29,3,82,38,0,38,76,216,184,32,432,26,2,100,606,1157,248,909,3048,415,168,213,7,7,527,1508,4,52,0,135,0,191,171,1664,5590
ASSAM,HAILAKANDI,2003,25,18,0,43,27,0,27,54,43,35,8,86,5,0,6,73,80,3,77,244,114,6,13,5,24,136,309,2,29,2,30,0,63,11,142,791
ASSAM,JORHAT,2003,46,7,0,53,40,0,40,80,28,28,0,56,6,0,14,59,189,3,186,457,74,26,21,2,20,161,348,0,26,0,23,0,49,44,345,1131
ASSAM,KAMRUP,2003,24,18,0,42,48,0,48,96,51,23,28,102,20,0,14,71,190,0,190,485,71,17,42,1,8,76,282,0,6,0,10,0,16,67,521,1255
ASSAM,KARBI ANGLONG,2003,67,12,0,79,16,0,16,32,37,13,24,74,8,0,14,23,113,18,95,271,34,6,2,2,19,45,130,0,14,0,4,0,18,22,181,619
ASSAM,KARIMGANJ,2003,31,19,0,50,29,0,29,58,47,40,7,94,9,2,5,71,104,8,96,295,215,20,18,1,28,60,371,5,4,0,84,0,93,29,138,919
ASSAM,KOKRAJHAR,2003,46,23,1,70,22,0,22,44,40,31,9,80,4,0,8,50,75,0,75,212,49,14,17,1,5,114,272,2,28,0,37,0,67,72,115,723
ASSAM,LAKHIMPUR,2003,31,19,4,54,76,0,76,152,80,77,3,160,11,0,26,18,271,3,268,597,82,13,62,1,27,367,644,0,44,0,108,0,152,92,319,1651
ASSAM,MORIGAON,2003,14,7,3,24,35,0,35,70,49,46,3,98,10,0,7,65,80,1,79,242,75,7,21,1,5,83,236,1,34,0,26,0,61,44,294,861
ASSAM,N.C.HILLS,2003,19,10,0,29,0,0,0,0,13,10,3,26,3,0,12,0,40,0,40,95,4,1,2,1,25,20,56,0,2,0,16,0,18,3,41,212
ASSAM,NAGAON,2003,75,51,5,131,105,0,105,210,169,159,10,338,54,5,50,256,440,22,418,1245,287,58,59,5,53,490,1204,7,107,4,181,0,299,252,826,3539
ASSAM,NALBARI,2003,35,32,1,68,33,0,33,66,64,43,21,128,23,0,28,69,130,2,128,380,14,11,21,1,15,295,395,0,18,0,23,0,41,38,364,1215
ASSAM,R.P.O.,2003,2,0,0,2,5,0,5,10,0,0,0,0,3,0,1,0,2,0,2,8,5,0,0,0,0,3,8,0,1,0,5,0,6,0,3,30
ASSAM,SIBSAGAR,2003,55,26,2,83,38,0,38,76,76,76,0,152,5,0,26,93,268,9,259,660,60,17,46,3,42,230,450,4,15,0,74,0,93,52,496,1628
ASSAM,SONITPUR,2003,98,27,2,127,64,0,64,128,90,90,0,180,25,2,23,168,362,3,359,942,172,30,58,1,29,262,711,3,56,0,146,0,205,159,540,2317
ASSAM,TINSUKIA,2003,79,3,0,82,32,0,32,64,33,33,0,66,28,0,19,88,199,17,182,533,183,16,13,3,18,74,310,2,14,0,23,0,39,3,265,1095
BIHAR,ARARIA,2003,49,26,2,77,38,0,38,76,56,17,39,112,40,1,49,49,181,27,154,501,369,33,26,1,31,4,489,13,3,0,24,0,40,25,1051,2071
BIHAR,ARWAL,2003,30,25,6,61,3,0,3,6,9,0,9,18,11,1,5,10,36,0,36,99,59,2,1,0,15,58,142,19,0,0,13,0,32,7,287,597
BIHAR,AURANGABAD,2003,84,52,0,136,18,0,18,36,26,6,20,52,18,0,39,70,127,5,122,381,145,9,6,0,13,51,294,25,6,0,19,0,50,70,1551,2329
BIHAR,BAGAHA,2003,30,23,9,62,21,0,21,42,40,10,30,80,4,0,13,28,90,0,90,225,97,6,36,7,11,44,207,4,3,0,6,0,13,6,454,932
BIHAR,BANKA,2003,89,18,5,112,19,0,19,38,25,14,11,50,40,1,28,49,89,1,88,296,174,14,7,0,15,1,238,19,5,1,9,0,34,27,615,1250
BIHAR,BEGUSARAI,2003,145,53,3,201,19,0,19,38,96,28,68,192,16,0,73,63,291,50,241,734,216,16,26,2,0,23,387,29,0,0,34,0,63,104,1694,2903
BIHAR,BETTIAH,2003,72,94,0,166,27,0,27,54,89,15,74,178,12,0,36,70,191,4,187,500,455,12,17,1,2,1202,1747,21,56,0,58,0,135,58,539,3012
BIHAR,BHABHUA,2003,76,77,1,154,11,0,11,22,40,11,29,80,24,1,34,58,166,14,152,449,156,24,38,3,20,141,426,21,6,0,13,0,40,44,282,1236
BIHAR,BHAGALPUR,2003,97,189,5,291,45,0,45,90,98,57,41,196,14,5,73,165,336,21,315,929,168,42,79,0,26,36,419,13,33,0,107,0,153,68,1443,3042
BIHAR,BHOJPUR,2003,125,46,4,175,12,0,12,24,48,1,47,96,34,5,38,86,240,18,222,643,164,44,71,0,38,80,476,24,14,0,75,0,113,79,1567,2794
BIHAR,BUXAR,2003,61,173,9,243,12,0,12,24,26,7,19,52,25,0,27,66,199,2,197,516,108,15,17,0,16,189,393,14,6,0,27,1,48,48,128,1167
BIHAR,DARBHANGA,2003,68,58,4,130,77,0,77,154,61,20,41,122,24,1,32,52,198,10,188,505,240,17,177,0,39,30,563,19,10,0,95,0,124,60,1546,2808
BIHAR,GAYA,2003,230,56,11,297,27,0,27,54,69,32,37,138,107,3,157,173,374,8,366,1188,311,44,33,2,45,377,951,37,40,0,46,0,123,139,1064,3345
BIHAR,GOPALGANJ,2003,65,78,6,149,12,0,12,24,34,13,21,68,9,2,27,46,89,15,74,262,164,5,55,0,4,3,310,14,0,6,34,0,54,79,1273,2005
BIHAR,JAMALPUR RLY.,2003,9,1,0,10,1,0,1,2,4,0,4,8,9,2,7,0,137,2,135,292,13,1,6,0,1,25,46,0,0,0,0,0,0,0,21,237
BIHAR,JAMUI,2003,64,25,0,89,24,0,24,48,34,7,27,68,32,0,25,50,81,2,79,269,115,0,9,0,10,127,296,11,12,0,34,0,57,35,367,1055
BIHAR,JEHANABAD,2003,64,101,1,166,9,0,9,18,40,5,35,80,33,0,35,40,146,7,139,400,79,13,40,0,18,24,194,16,0,0,34,0,50,20,967,1680
BIHAR,KATIHAR,2003,78,35,5,118,92,0,92,184,68,42,26,136,34,1,42,50,229,22,207,585,215,31,47,0,20,241,614,9,9,0,60,0,78,60,851,2177
BIHAR,KATIHAR RLY.,2003,7,0,2,9,0,0,0,0,10,6,4,20,11,2,16,6,257,3,254,549,16,3,9,1,1,0,31,3,2,0,4,0,9,1,173,524
BIHAR,KHAGARIA,2003,62,70,2,134,16,0,16,32,77,0,77,154,9,0,20,26,80,3,77,215,137,9,12,0,6,115,330,6,9,0,22,0,37,51,668,1397
BIHAR,KISHANGANJ,2003,27,4,6,37,17,0,17,34,39,38,1,78,12,0,11,43,96,3,93,258,127,8,11,0,1,155,312,5,2,0,20,0,27,10,365,959
BIHAR,LAKHISARAI,2003,56,26,2,84,7,0,7,14,39,4,35,78,7,2,26,13,56,5,51,160,48,2,0,0,4,0,78,10,0,0,6,0,16,24,454,782
BIHAR,MADHEPURA,2003,62,14,6,82,8,0,8,16,24,5,19,48,20,0,29,19,58,7,51,184,105,11,12,0,7,3,157,6,2,0,8,0,16,19,588,1001
BIHAR,MADHUBANI,2003,78,172,68,318,38,0,38,76,62,29,33,124,39,4,22,104,184,11,173,537,320,21,56,0,2,442,961,20,112,0,262,0,394,120,561,2687
BIHAR,MOTIHARI,2003,113,61,16,190,39,0,39,78,114,18,96,228,24,4,65,128,295,8,287,811,386,64,124,2,31,326,1045,36,49,0,110,0,195,112,2187,4286
BIHAR,MUNGER,2003,80,28,1,109,7,0,7,14,47,7,40,94,4,5,24,35,148,11,137,364,231,15,38,0,8,124,451,6,16,0,63,0,85,35,962,1877
BIHAR,MUZAFFARPUR,2003,120,30,16,166,59,0,59,118,160,20,140,320,41,7,107,187,659,59,600,1660,460,119,91,15,27,2084,2970,63,27,0,98,0,188,174,297,4841
BIHAR,MUZAFFARPUR RLY.,2003,19,9,0,28,3,0,3,6,6,4,2,12,15,4,11,5,324,10,314,683,11,0,20,1,0,35,71,1,4,0,0,0,5,4,122,594
BIHAR,NALANDA,2003,171,139,17,327,21,0,21,42,58,18,40,116,27,5,56,83,181,13,168,533,162,19,56,2,25,604,1018,49,39,0,64,1,153,150,1020,2949
BIHAR,NAUGACHIA,2003,47,23,0,70,12,0,12,24,29,2,27,58,4,1,10,16,48,33,15,127,83,2,3,2,4,4,145,8,1,0,8,0,17,47,341,693
BIHAR,NAWADAH,2003,88,60,10,158,13,0,13,26,53,12,41,106,21,2,24,37,79,5,74,242,158,7,15,1,9,96,349,19,10,1,11,0,41,63,570,1347
BIHAR,PATNA,2003,484,680,9,1173,34,0,34,68,220,15,205,440,124,28,694,469,1654,661,993,4623,494,198,370,24,59,389,1846,85,49,0,127,0,261,312,3267,9770
BIHAR,PATNA RLY.,2003,24,17,0,41,2,0,2,4,5,0,5,10,44,3,31,5,763,19,744,1609,7,2,10,0,0,0,26,0,7,0,3,0,10,7,189,1119
BIHAR,PURNEA,2003,99,74,12,185,50,0,50,100,52,12,40,104,80,2,131,72,231,78,153,747,189,9,4,0,6,12,299,13,11,0,27,0,51,79,766,1919
BIHAR,ROHTAS,2003,157,218,14,389,15,0,15,30,87,36,51,174,46,2,75,121,302,22,280,848,254,56,19,6,37,25,495,28,30,0,52,0,110,98,1213,2855
BIHAR,SAHARSA,2003,47,69,2,118,11,0,11,22,25,11,14,50,9,0,29,29,86,13,73,239,144,14,23,0,8,145,363,13,14,0,3,0,30,29,304,1004
BIHAR,SAMASTIPUR,2003,136,121,17,274,20,0,20,40,80,8,72,160,34,18,64,87,371,33,338,945,286,37,33,0,45,260,682,18,11,2,34,25,90,21,1250,2970
BIHAR,SARAN,2003,115,154,6,275,32,0,32,64,95,49,46,190,33,3,55,78,256,35,221,681,240,29,73,1,29,891,1322,65,17,1,82,0,165,59,1395,3709
BIHAR,SHEIKHPURA,2003,36,12,1,49,5,0,5,10,21,1,20,42,6,0,8,10,40,0,40,104,71,19,30,0,0,0,120,6,0,0,0,0,6,0,452,717
BIHAR,SHEOHAR,2003,12,19,3,34,8,0,8,16,11,3,8,22,6,1,4,6,16,1,15,49,31,3,16,1,1,0,52,7,3,0,11,0,21,0,251,410
BIHAR,SITAMARHI,2003,51,16,3,70,37,0,37,74,82,24,58,164,25,4,31,61,183,18,165,487,271,52,20,0,4,4,376,27,6,0,39,4,76,25,1462,2407
BIHAR,SIWAN,2003,86,160,4,250,13,0,13,26,62,22,40,124,49,0,114,88,155,28,127,561,186,14,18,0,15,124,455,32,36,0,54,0,122,98,757,2065
BIHAR,SUPAUL,2003,40,27,3,70,22,0,22,44,21,5,16,42,36,0,35,25,64,8,56,224,182,15,32,0,6,128,372,6,6,0,19,1,32,9,569,1246
BIHAR,VAISHALI,2003,118,207,7,332,29,0,29,58,85,40,45,170,9,0,31,108,338,62,276,824,182,49,161,20,10,262,782,69,22,0,65,5,161,98,1620,3495
CHHATTISGARH,BALRAMPUR,2003,22,19,0,41,24,0,24,48,4,0,4,8,13,1,11,51,34,3,31,144,16,0,1,0,7,29,65,3,29,3,15,0,50,12,194,488
CHHATTISGARH,BILASPUR,2003,95,55,27,177,49,0,49,98,12,12,0,24,3,0,32,549,679,153,526,1942,123,9,22,4,10,480,841,18,165,3,87,0,273,193,2281,4896
CHHATTISGARH,BIZAPUR,2003,23,38,0,61,8,0,8,16,2,2,0,4,32,0,3,8,12,11,1,67,13,0,0,0,8,29,56,0,5,0,1,0,6,6,77,265
CHHATTISGARH,DANTEWARA,2003,44,35,0,79,12,0,12,24,6,3,3,12,8,0,5,56,29,7,22,127,15,0,7,0,3,75,133,0,14,0,4,0,18,33,259,605
CHHATTISGARH,DHAMTARI,2003,14,7,0,21,32,0,32,64,8,7,1,16,0,0,4,104,118,37,81,344,21,2,18,1,7,88,195,3,71,8,8,0,90,58,840,1412
CHHATTISGARH,DURG,2003,58,50,0,108,117,0,117,234,21,17,4,42,1,3,45,559,731,38,693,2070,40,16,82,6,15,445,604,13,229,31,118,0,391,0,3547,6127
CHHATTISGARH,GRP RAIPUR,2003,1,3,0,4,1,0,1,2,2,2,0,4,0,0,2,5,198,5,193,403,1,0,1,1,0,12,15,0,1,2,1,0,4,0,96,327
CHHATTISGARH,JAGDALPUR,2003,51,34,3,88,71,0,71,142,12,12,0,24,5,0,18,172,108,32,76,411,40,1,17,0,8,181,247,0,72,4,8,0,84,0,1118,1923
CHHATTISGARH,JANJGIR,2003,30,23,0,53,47,0,47,94,8,5,3,16,1,0,19,171,175,27,148,541,55,3,28,2,10,380,536,3,84,8,42,0,137,58,586,1733
CHHATTISGARH,JASHPUR,2003,40,11,5,56,33,0,33,66,3,3,0,6,3,1,20,49,49,14,35,171,12,3,4,0,1,107,176,0,39,1,3,0,43,49,271,704
CHHATTISGARH,KABIRDHAM,2003,12,11,0,23,24,0,24,48,3,2,1,6,0,0,3,69,59,3,56,190,28,0,7,0,3,273,335,1,59,4,10,0,74,24,279,869
CHHATTISGARH,KANKER,2003,34,35,0,69,29,0,29,58,5,4,1,10,21,0,9,51,38,4,34,157,16,1,4,0,9,48,116,0,30,0,7,0,37,38,499,874
CHHATTISGARH,KORBA,2003,32,17,0,49,37,0,37,74,7,6,1,14,1,2,8,239,305,76,229,860,71,5,28,1,8,131,349,4,97,14,40,0,155,105,1509,2661
CHHATTISGARH,KORIYA,2003,41,12,1,54,40,0,40,80,4,4,0,8,5,0,6,175,99,15,84,384,26,1,9,0,5,144,222,0,66,1,24,0,91,37,617,1313
CHHATTISGARH,MAHASAMUND,2003,21,11,5,37,30,0,30,60,3,3,0,6,1,0,6,130,123,21,102,383,24,1,8,0,0,206,348,2,39,2,24,0,67,109,667,1412
CHHATTISGARH,NARAYANPUR,2003,11,13,0,24,3,0,3,6,1,1,0,2,7,0,1,9,10,3,7,37,0,2,0,0,5,9,23,0,0,0,1,0,1,7,35,114
CHHATTISGARH,RAIGARH,2003,46,27,0,73,36,0,36,72,15,15,0,30,1,4,34,224,239,30,209,741,56,12,19,2,11,154,347,2,94,6,32,0,134,93,834,1941
CHHATTISGARH,RAIPUR,2003,77,53,4,134,126,0,126,252,41,33,8,82,1,1,41,510,798,365,433,2149,46,12,117,4,10,487,1012,15,185,15,116,0,331,336,3203,6198
CHHATTISGARH,RAJNANDGAON,2003,36,26,6,68,60,0,60,120,8,6,2,16,7,0,16,214,150,49,101,537,32,5,25,3,13,113,191,13,67,2,28,0,110,0,1423,2247
CHHATTISGARH,SARGUJA,2003,88,33,0,121,119,0,119,238,12,12,0,24,30,2,48,276,216,29,187,788,68,3,15,0,18,262,366,2,135,1,32,0,170,0,980,2340
GOA,NORTH GOA,2003,22,8,3,33,22,0,22,44,8,8,0,16,5,0,12,180,273,79,194,743,34,32,70,2,14,101,340,1,11,4,9,0,25,87,432,1330
GOA,SOUTH GOA,2003,12,17,3,32,9,0,9,18,6,5,1,12,0,0,9,77,191,53,138,468,13,28,36,1,4,97,256,1,8,3,15,0,27,77,307,914
GUJARAT,AHMEDABAD COMMR.,2003,90,68,3,161,18,0,18,36,157,96,61,314,31,6,365,959,5377,2287,3090,12115,212,294,394,6,10,1371,2460,3,50,30,595,0,678,173,5987,16199
GUJARAT,AHMEDABAD RURAL,2003,38,11,1,50,3,0,3,6,18,13,5,36,15,0,21,97,249,70,179,631,54,50,22,6,8,357,713,1,18,0,61,0,80,216,1392,2638
GUJARAT,AHWA-DANG,2003,6,1,0,7,0,0,0,0,0,0,0,0,1,0,2,2,5,0,5,15,4,2,0,3,1,19,39,0,2,0,3,0,5,10,43,104
GUJARAT,AMRELI,2003,19,11,0,30,6,0,6,12,28,28,0,56,0,0,26,88,164,50,114,442,27,30,16,19,8,328,508,0,24,1,98,0,123,80,967,1940
GUJARAT,ANAND,2003,28,21,2,51,5,0,5,10,36,32,4,72,10,1,19,170,432,129,303,1064,40,60,65,9,13,518,899,0,24,3,130,0,157,194,1732,3512
GUJARAT,BHARUCH,2003,43,9,0,52,5,0,5,10,28,25,3,56,11,0,31,120,470,178,292,1102,27,101,37,7,26,359,741,0,19,1,69,0,89,184,1246,2793
GUJARAT,BHAVNAGAR,2003,57,36,0,93,5,0,5,10,70,55,15,140,15,0,39,304,611,245,366,1580,116,118,95,15,35,119,508,6,36,11,126,0,179,10,2991,4815
GUJARAT,DAHOD,2003,43,7,0,50,0,0,0,0,19,19,0,38,26,1,69,88,122,49,73,428,37,18,2,8,39,275,379,0,22,0,15,0,37,0,746,1537
GUJARAT,GANDHINAGAR,2003,23,12,0,35,0,0,0,0,34,28,6,68,5,0,64,157,617,231,386,1460,66,27,32,7,13,332,661,2,25,2,113,0,142,184,1665,3380
GUJARAT,HIMATNAGAR,2003,42,12,1,55,6,0,6,12,44,44,0,88,14,0,30,200,331,79,252,906,58,64,70,16,23,339,761,2,47,1,160,0,210,191,2531,4182
GUJARAT,JAMNAGAR,2003,34,19,1,54,10,0,10,20,27,21,6,54,2,0,19,232,388,129,259,1029,40,33,34,15,29,342,493,0,20,0,150,0,170,0,1830,3225
GUJARAT,JUNAGADH,2003,52,20,0,72,13,0,13,26,47,41,6,94,14,0,37,243,628,174,454,1550,95,64,104,14,39,449,923,6,40,8,312,0,366,158,2489,4832
GUJARAT,KHEDA NORTH,2003,46,13,2,61,11,0,11,22,49,46,3,98,11,0,18,149,366,80,286,910,42,85,72,18,16,431,867,0,27,0,125,0,152,203,1943,3627
GUJARAT,KUTCH,2003,30,22,2,54,7,0,7,14,25,23,2,50,12,0,29,240,285,100,185,851,57,18,47,5,16,425,764,0,26,4,165,0,195,196,1661,3272
GUJARAT,MEHSANA,2003,37,31,0,68,7,0,7,14,57,52,5,114,13,2,53,251,699,147,552,1717,93,53,91,8,16,1166,1549,0,34,1,207,0,242,122,1848,4789
GUJARAT,NARMADA,2003,13,1,0,14,4,0,4,8,3,3,0,6,4,0,0,21,32,3,29,89,9,15,3,0,4,83,149,0,4,0,7,0,11,35,239,477
GUJARAT,NAVSARI,2003,26,7,0,33,2,0,2,4,10,9,1,20,4,0,7,86,138,57,81,373,16,50,24,6,1,105,202,0,6,0,15,0,21,0,899,1402
GUJARAT,PALANPUR,2003,38,20,1,59,20,0,20,40,42,39,3,84,6,0,44,234,331,59,272,946,77,39,98,16,18,1267,1640,0,47,1,135,0,183,125,1229,3788
GUJARAT,PANCHMAHAL,2003,45,8,1,54,11,0,11,22,31,31,0,62,35,0,25,109,337,76,261,843,51,38,24,8,37,338,496,0,34,2,74,0,110,0,984,2192
GUJARAT,PATAN,2003,17,11,1,29,2,0,2,4,15,15,0,30,3,0,9,99,232,37,195,575,64,50,38,6,9,361,598,0,21,0,112,0,133,70,1237,2357
GUJARAT,PORBANDAR,2003,8,6,1,15,1,0,1,2,7,5,2,14,0,0,2,35,78,31,47,193,14,67,15,4,2,100,235,0,7,1,44,0,52,33,533,958
GUJARAT,RAJKOT COMMR.,2003,37,12,1,50,5,0,5,10,34,30,4,68,7,0,51,350,1525,655,870,3458,98,38,77,10,16,357,683,5,8,13,158,0,184,87,1913,4802
GUJARAT,RAJKOT RURAL,2003,38,23,1,62,14,0,14,28,48,38,10,96,9,0,34,210,457,111,346,1167,78,61,11,8,47,432,843,4,35,4,174,0,217,206,2425,4319
GUJARAT,SURAT COMMR.,2003,75,16,5,96,25,0,25,50,62,40,22,124,16,3,57,388,1749,1192,557,3962,64,54,239,21,7,428,1047,19,17,2,126,0,164,234,794,4401
GUJARAT,SURAT RURAL,2003,52,11,0,63,11,0,11,22,16,9,7,32,6,0,14,99,203,71,132,525,32,45,39,7,16,280,724,0,21,0,204,0,225,305,795,2156
GUJARAT,SURENDRANAGAR,2003,25,14,0,39,16,0,16,32,32,25,7,64,9,1,19,130,288,56,232,735,57,113,22,13,16,983,1370,6,42,2,53,0,103,166,1044,3051
GUJARAT,VADODARA COMMR.,2003,38,28,1,67,8,0,8,16,36,31,5,72,6,0,44,434,1385,692,693,3254,195,97,197,2,20,366,1000,0,17,5,136,0,158,123,2574,5712
GUJARAT,VADODARA RURAL,2003,74,17,1,92,14,0,14,28,52,49,3,104,21,0,23,94,258,70,188,654,63,118,49,9,18,440,924,0,33,0,76,0,109,227,1628,3215
GUJARAT,VALSAD,2003,31,7,4,42,5,0,5,10,13,10,3,26,22,0,27,234,369,143,226,1021,33,54,47,7,13,214,368,0,7,0,37,0,44,0,1357,2481
GUJARAT,W.RLY,2003,9,4,0,13,2,0,2,4,4,2,2,8,10,0,89,21,1178,0,1178,2476,5,17,11,2,0,27,66,0,9,0,4,0,13,4,157,1553
HARYANA,AMBALA,2003,26,16,3,45,10,0,10,20,26,24,2,52,1,2,14,236,208,99,109,669,2,13,73,1,9,190,289,7,17,31,129,0,184,1,883,1898
HARYANA,BHIWANI,2003,47,22,3,72,15,0,15,30,17,7,10,34,4,4,29,163,190,105,85,580,92,18,56,1,13,237,418,28,17,0,69,0,114,1,968,1994
HARYANA,FARIDABAD,2003,57,30,2,89,36,0,36,72,70,49,21,140,5,20,20,264,701,447,254,1711,132,133,38,7,12,300,634,14,34,980,136,0,1164,12,4107,7110
HARYANA,FATEHABAD,2003,18,16,4,38,7,0,7,14,15,7,8,30,0,3,6,71,88,42,46,256,16,9,29,4,5,177,243,3,11,4,47,0,65,3,402,938
HARYANA,GRP,2003,19,6,0,25,1,0,1,2,0,0,0,0,1,3,2,0,149,0,149,304,9,1,6,0,0,5,31,3,0,50,0,0,53,10,464,729
HARYANA,GURGAON,2003,62,33,6,101,32,0,32,64,44,37,7,88,6,18,40,359,817,575,242,2057,64,37,38,1,9,227,380,13,17,26,101,0,157,4,1729,3683
HARYANA,HISSAR,2003,50,26,4,80,16,0,16,32,27,18,9,54,6,26,14,199,360,210,150,965,27,33,138,1,7,270,476,17,35,10,80,0,142,0,1009,2355
HARYANA,JHAJJAR,2003,39,28,3,70,9,0,9,18,8,8,0,16,3,6,13,73,135,67,68,365,53,30,29,0,0,147,355,17,32,35,92,0,176,96,424,1272
HARYANA,JIND,2003,33,20,13,66,17,0,17,34,11,5,6,22,0,11,3,86,127,76,51,354,53,22,23,2,4,127,233,10,7,13,34,0,64,2,466,1084
HARYANA,KAITHAL,2003,18,16,2,36,15,0,15,30,4,2,2,8,5,7,10,89,188,89,99,487,0,58,15,0,6,222,303,8,14,0,125,0,147,2,402,1206
HARYANA,KARNAL,2003,41,33,4,78,27,0,27,54,22,14,8,44,8,7,18,203,380,190,190,996,44,19,46,1,8,641,985,14,18,1,173,0,206,226,281,2215
HARYANA,KURUKSHETRA,2003,30,15,3,48,23,0,23,46,11,7,4,22,3,4,15,146,361,178,183,890,0,9,135,3,6,188,341,12,23,18,92,0,145,0,707,1804
HARYANA,MAHENDRAGARH,2003,16,10,3,29,10,0,10,20,11,9,2,22,3,1,3,88,108,48,60,311,48,31,7,1,4,140,234,4,12,0,27,0,43,3,705,1235
HARYANA,PANCHKULA,2003,11,4,4,19,12,0,12,24,15,13,2,30,0,6,8,113,199,98,101,525,1,34,54,0,1,14,178,5,10,83,56,0,154,74,715,1419
HARYANA,PANIPAT,2003,47,21,10,78,38,0,38,76,16,9,7,32,8,19,23,161,409,237,172,1029,24,46,16,0,3,156,438,13,17,22,165,0,217,193,456,1863
HARYANA,REWARI,2003,16,10,0,26,11,0,11,22,11,9,2,22,0,6,9,111,165,94,71,456,34,23,14,0,9,140,221,7,22,1,34,0,64,1,793,1417
HARYANA,ROHTAK,2003,50,52,2,104,25,0,25,50,21,15,6,42,4,4,20,242,339,206,133,948,22,22,41,5,2,170,417,17,12,23,34,0,86,155,502,1764
HARYANA,SIRSA,2003,38,36,2,76,22,0,22,44,18,5,13,36,2,2,11,155,209,89,120,588,17,21,55,2,8,354,463,9,10,0,70,0,89,6,468,1515
HARYANA,SONIPAT,2003,62,37,5,104,15,0,15,30,26,20,6,52,3,40,13,127,271,128,143,725,1,20,55,1,9,300,568,17,21,5,68,0,111,182,550,1828
HARYANA,YAMUNANAGAR,2003,22,15,3,40,12,0,12,24,15,13,2,30,1,1,10,95,187,101,86,481,0,7,32,0,7,148,194,4,15,0,86,0,105,0,623,1283
HIMACHAL PRADESH,BILASPUR,2003,8,5,0,13,13,0,13,26,12,11,1,24,2,0,2,48,51,26,25,154,65,1,15,0,19,59,189,0,20,2,17,0,39,30,729,1098
HIMACHAL PRADESH,CHAMBA,2003,6,3,0,9,10,0,10,20,14,14,0,28,0,0,0,111,34,9,25,179,14,4,6,0,15,61,144,0,13,0,8,0,21,44,242,585
HIMACHAL PRADESH,G.R.P.,2003,0,0,0,0,0,0,0,0,0,0,0,0,0,0,0,0,0,0,0,0,0,0,0,0,0,0,0,0,0,0,0,0,0,0,1,1
HIMACHAL PRADESH,HAMIRPUR,2003,4,5,0,9,6,0,6,12,8,7,1,16,0,0,0,25,25,5,20,75,30,3,13,0,9,228,326,0,13,1,15,0,29,43,440,868
HIMACHAL PRADESH,KANGRA,2003,38,16,0,54,8,0,8,16,7,6,1,14,1,0,2,75,70,30,40,218,121,6,15,2,18,223,394,0,28,0,35,0,63,9,1341,2015
HIMACHAL PRADESH,KINNAUR,2003,3,1,1,5,6,0,6,12,4,4,0,8,0,0,0,36,16,0,16,68,9,2,1,0,0,9,38,0,2,0,2,0,4,17,47,156
HIMACHAL PRADESH,KULLU,2003,14,1,2,17,16,0,16,32,8,6,2,16,1,0,3,43,29,6,23,105,30,2,8,0,6,47,130,2,24,0,13,0,39,37,461,747
HIMACHAL PRADESH,LAHAUL-SPITI,2003,0,0,0,0,2,0,2,4,0,0,0,0,0,0,0,2,1,0,1,4,1,0,1,0,0,1,17,0,0,0,1,0,1,14,36,59
HIMACHAL PRADESH,MANDI,2003,10,9,0,19,23,0,23,46,7,5,2,14,0,0,0,85,63,17,46,211,67,7,19,0,24,177,363,1,52,2,43,0,98,69,1086,1744
HIMACHAL PRADESH,SHIMLA,2003,18,15,0,33,21,0,21,42,21,16,5,42,1,0,3,143,152,45,107,451,105,16,20,0,10,79,318,2,40,8,15,0,65,88,1206,1963
HIMACHAL PRADESH,SIRMAUR,2003,6,4,1,11,8,0,8,16,15,14,1,30,0,0,2,28,38,15,23,106,63,4,10,1,6,58,168,1,24,0,18,0,43,26,350,663
HIMACHAL PRADESH,SOLAN,2003,13,8,1,22,11,0,11,22,10,7,3,20,1,0,1,58,88,38,50,236,63,6,11,0,7,339,463,0,24,3,24,0,51,37,627,1332
HIMACHAL PRADESH,UNA,2003,5,7,0,12,2,0,2,4,7,6,1,14,2,0,6,53,60,27,33,181,42,12,11,0,7,104,225,0,10,2,30,0,42,49,371,780
JAMMU & KASHMIR,ANANTNAG,2003,77,71,5,153,9,0,9,18,81,74,7,162,3,0,19,125,105,24,81,357,102,8,21,2,35,27,215,0,63,45,0,0,108,20,529,1347
JAMMU & KASHMIR,AWANTIPORA,2003,8,3,1,12,2,0,2,4,13,13,0,26,1,0,6,49,23,3,20,102,13,0,1,2,0,1,17,0,21,4,0,0,25,0,208,356
JAMMU & KASHMIR,BARAMULLA,2003,95,92,2,189,18,0,18,36,90,74,16,180,1,0,9,156,208,40,168,582,172,10,22,2,18,25,249,0,159,23,1,0,183,0,712,1815
JAMMU & KASHMIR,BORDER,2003,8,26,0,34,9,0,9,18,8,6,2,16,2,0,1,23,32,6,26,90,26,2,9,0,5,10,104,0,8,11,7,0,26,52,529,768
JAMMU & KASHMIR,BUDGAM,2003,48,24,5,77,11,0,11,22,46,40,6,92,0,0,1,80,119,20,99,319,82,3,13,0,13,6,137,0,69,12,1,0,82,20,368,921
JAMMU & KASHMIR,CRIME JAMMU,2003,1,0,0,1,0,0,0,0,0,0,0,0,0,0,0,0,0,0,0,0,0,0,34,0,0,0,34,0,0,0,0,0,0,0,1,36
JAMMU & KASHMIR,CRIME SRINAGAR,2003,1,0,0,1,0,0,0,0,0,0,0,0,0,0,0,0,0,0,0,0,0,6,74,0,0,0,80,0,0,0,0,0,0,0,0,81
JAMMU & KASHMIR,DODA,2003,87,95,0,182,6,0,6,12,19,19,0,38,0,0,7,47,23,0,23,100,28,7,11,1,26,18,117,0,8,4,3,0,15,26,345,761
JAMMU & KASHMIR,GANDERBAL,2003,15,10,1,26,8,0,8,16,45,45,0,90,0,0,2,39,53,6,47,147,92,2,3,0,15,0,127,0,82,6,1,0,89,15,199,588
JAMMU & KASHMIR,HANDWARA,2003,39,60,2,101,2,0,2,4,22,17,5,44,0,0,9,26,29,1,28,93,52,1,5,0,10,3,74,0,24,4,1,0,29,3,134,426
JAMMU & KASHMIR,JAMMU,2003,34,63,6,103,20,0,20,40,57,50,7,114,0,0,10,252,363,185,178,988,56,29,50,5,14,37,275,3,12,66,21,0,102,84,2188,3370
JAMMU & KASHMIR,KARGIL,2003,0,0,0,0,1,0,1,2,6,6,0,12,0,0,0,4,4,0,4,12,7,1,2,0,1,0,11,0,0,0,0,0,0,0,57,83
JAMMU & KASHMIR,KATHUA,2003,16,28,0,44,13,0,13,26,20,20,0,40,2,0,2,48,46,15,31,144,56,4,15,0,7,27,160,0,8,9,7,0,24,51,687,1046
JAMMU & KASHMIR,KULGAM,2003,43,8,0,51,5,0,5,10,50,45,5,100,0,0,11,40,29,3,26,109,46,0,12,0,8,5,89,0,23,15,0,0,38,18,250,563
JAMMU & KASHMIR,KUPWARA,2003,38,151,0,189,5,0,5,10,35,27,8,70,0,0,1,32,42,0,42,117,49,6,16,2,2,6,91,0,68,4,0,0,72,10,246,713
JAMMU & KASHMIR,LEH,2003,0,1,0,1,3,0,3,6,1,1,0,2,0,0,0,2,3,2,1,8,6,0,1,0,0,0,7,0,2,0,0,0,2,0,123,142
JAMMU & KASHMIR,POONCH,2003,111,113,0,224,12,0,12,24,12,11,1,24,0,0,0,18,61,0,61,140,19,4,8,0,27,38,103,0,11,3,1,0,15,7,282,727
JAMMU & KASHMIR,PULWAMA,2003,70,80,3,153,10,0,10,20,48,43,5,96,7,0,22,79,124,14,110,356,131,2,5,0,21,32,203,2,38,8,0,0,48,12,262,956
JAMMU & KASHMIR,RAILWAYS,2003,0,0,0,0,1,0,1,2,0,0,0,0,0,0,0,0,14,0,14,28,0,0,1,0,0,0,1,0,1,0,0,0,1,0,8,25
JAMMU & KASHMIR,RAJOURI,2003,86,135,0,221,28,0,28,56,19,19,0,38,2,0,1,51,46,3,43,146,22,5,11,0,49,26,130,2,8,7,14,0,31,17,774,1303
JAMMU & KASHMIR,RAMBAN,2003,53,94,1,148,10,0,10,20,10,5,5,20,0,0,0,19,16,1,15,51,17,2,6,0,26,8,59,0,8,3,0,0,11,0,336,609
JAMMU & KASHMIR,REASI,2003,33,52,0,85,8,0,8,16,6,5,1,12,3,0,0,9,10,0,10,32,0,0,5,0,7,3,15,0,2,3,0,0,5,0,134,275
JAMMU & KASHMIR,SRINAGAR,2003,56,94,3,153,23,0,23,46,114,91,23,228,2,0,51,344,513,240,273,1423,138,20,79,6,34,29,346,0,249,130,6,0,385,40,1178,3109
JAMMU & KASHMIR,UDHAMPUR,2003,10,16,0,26,7,0,7,14,10,4,6,20,0,0,2,83,86,13,73,257,53,4,4,1,10,9,84,3,11,19,8,0,41,3,874,1213
JHARKHAND,BOKARO,2003,58,108,2,168,48,0,48,96,40,26,14,80,40,5,64,122,425,95,330,1081,180,28,24,2,10,422,784,29,32,0,16,0,77,118,381,2154
JHARKHAND,CHAIBASA,2003,129,42,34,205,38,0,38,76,21,19,2,42,7,0,17,34,98,5,93,254,39,15,2,0,9,16,86,0,17,0,8,0,25,5,204,735
JHARKHAND,CHATRA,2003,35,2,3,40,14,0,14,28,7,4,3,14,29,0,23,18,80,3,77,230,130,0,10,0,5,0,150,16,2,0,0,0,18,5,659,1038
JHARKHAND,DEOGHAR,2003,55,40,5,100,53,0,53,106,8,7,1,16,13,1,31,89,107,36,71,348,184,16,16,0,7,167,395,14,14,1,20,0,49,5,736,1582
JHARKHAND,DHANBAD,2003,92,31,7,130,43,0,43,86,55,41,14,110,53,8,50,190,573,28,545,1447,218,10,77,0,15,308,643,30,47,0,18,0,95,15,1387,3227
JHARKHAND,DHANBAD RLY.,2003,9,1,0,10,0,0,0,0,4,3,1,8,41,0,33,9,120,5,115,323,20,0,5,0,0,0,30,1,1,0,0,0,2,5,114,363
JHARKHAND,DUMKA,2003,57,142,3,202,49,0,49,98,19,0,19,38,9,0,9,51,76,12,64,221,22,10,13,0,13,16,117,9,23,0,69,0,101,43,334,967
JHARKHAND,GARHWA,2003,32,21,3,56,23,0,23,46,18,6,12,36,25,0,26,33,67,0,67,218,156,5,10,0,12,71,283,13,5,0,12,0,30,29,424,985
JHARKHAND,GIRIDIH,2003,65,27,7,99,35,0,35,70,31,22,9,62,63,2,50,116,236,5,231,703,128,6,32,0,24,62,350,42,52,0,37,0,131,98,1273,2386
JHARKHAND,GODDA,2003,31,36,0,67,76,0,76,152,25,15,10,50,9,0,15,46,129,0,129,328,124,7,20,0,0,302,458,4,0,0,56,0,60,5,1310,2195
JHARKHAND,GUMLA,2003,131,24,12,167,31,0,31,62,14,12,2,28,32,0,33,41,56,5,51,218,43,7,9,0,3,0,66,0,14,0,11,0,25,4,304,769
JHARKHAND,HAZARIBAGH,2003,81,42,11,134,40,0,40,80,36,20,16,72,103,5,102,132,406,77,329,1154,295,18,47,0,4,403,772,41,57,0,30,0,128,5,981,2839
JHARKHAND,JAMSHEDPUR,2003,49,112,5,166,28,0,28,56,37,34,3,74,12,4,36,108,436,102,334,1032,122,24,82,0,3,270,620,12,23,0,58,0,93,119,598,2138
JHARKHAND,JAMSHEDPUR RLY.,2003,6,0,0,6,2,0,2,4,2,2,0,4,9,0,11,7,84,2,82,195,23,0,2,0,0,0,30,3,0,0,0,0,3,5,81,235
JHARKHAND,JAMTARA,2003,17,6,3,26,35,0,35,70,12,7,5,24,2,1,7,16,42,0,42,110,36,2,4,1,0,123,182,5,6,0,26,0,37,16,116,476
JHARKHAND,KODERMA,2003,30,25,0,55,0,0,0,0,0,0,0,0,39,0,24,13,35,6,29,146,103,8,15,0,4,187,355,7,8,0,37,0,52,38,178,751
JHARKHAND,LATEHAR,2003,43,14,3,60,10,0,10,20,1,1,0,2,46,2,22,69,42,0,42,223,28,1,1,0,0,38,111,0,5,0,3,0,8,43,148,519
JHARKHAND,LOHARDAGGA,2003,44,9,1,54,15,0,15,30,7,4,3,14,3,0,23,16,28,3,25,98,28,6,5,2,3,7,56,0,4,0,12,0,16,5,230,448
JHARKHAND,PAKUR,2003,27,29,4,60,31,0,31,62,12,7,5,24,7,0,13,25,45,9,36,135,57,4,14,0,9,141,245,0,3,1,10,0,14,20,74,526
JHARKHAND,PALAMU,2003,70,24,1,95,13,0,13,26,14,8,6,28,51,0,31,62,67,3,64,278,194,2,23,0,7,404,635,11,4,0,13,0,28,5,607,1603
JHARKHAND,RANCHI,2003,250,136,0,386,55,0,55,110,70,2,68,140,89,9,183,214,740,161,579,1975,264,63,53,0,7,0,392,9,73,0,61,0,143,5,1996,4277
JHARKHAND,SAHEBGANJ,2003,61,43,3,107,23,0,23,46,16,5,11,32,5,0,12,24,69,2,67,179,25,8,8,0,8,31,113,9,17,0,19,0,45,33,228,642
JHARKHAND,SARAIKELA,2003,60,42,0,102,31,0,31,62,26,6,20,52,5,0,32,22,162,5,157,383,33,22,5,0,0,19,84,7,14,0,36,0,57,5,452,973
JHARKHAND,SIMDEGA,2003,50,1,2,53,19,0,19,38,12,11,1,24,10,0,17,11,32,0,32,102,29,3,2,0,4,75,124,0,3,0,7,0,10,11,87,375
KARNATAKA,BAGALKOT,2003,50,28,6,84,12,0,12,24,16,11,5,32,1,0,7,84,112,39,73,316,180,4,20,2,17,342,565,2,44,0,45,0,91,0,979,1951
KARNATAKA,BANGALORE COMMR.,2003,216,280,1,497,34,0,34,68,132,11,121,264,46,46,311,1713,7123,2682,4441,16362,273,241,1780,87,0,3847,6312,34,213,39,213,0,499,84,12547,29260
KARNATAKA,BANGALORE RURAL,2003,128,85,17,230,27,0,27,54,34,19,15,68,17,0,49,462,864,156,708,2256,465,28,54,0,103,1363,2013,31,107,0,130,0,268,0,3445,7409
KARNATAKA,BELGAUM,2003,107,39,3,149,11,0,11,22,28,15,13,56,13,4,41,205,298,102,196,859,243,26,111,5,18,703,1130,12,45,4,93,0,154,24,2461,4494
KARNATAKA,BELLARY,2003,48,41,0,89,14,0,14,28,12,6,6,24,3,2,16,128,265,49,216,679,218,6,34,1,14,528,804,2,58,0,36,0,96,3,1873,3302
KARNATAKA,BIDAR,2003,37,57,3,97,6,0,6,12,22,17,5,44,8,2,43,210,226,46,180,715,144,8,36,3,27,1142,1360,5,45,3,67,0,120,0,1975,4069
KARNATAKA,BIJAPUR,2003,55,33,2,90,9,0,9,18,18,11,7,36,5,0,15,108,115,40,75,358,226,1,22,2,13,634,898,4,68,0,83,0,155,0,2870,4283
KARNATAKA,CHAMARAJNAGAR,2003,25,16,0,41,3,0,3,6,2,2,0,4,4,0,4,76,121,5,116,326,87,2,19,1,8,358,475,4,40,0,19,0,63,0,382,1171
KARNATAKA,CHICKMAGALUR,2003,28,30,1,59,12,0,12,24,14,10,4,28,7,1,13,213,308,41,267,850,150,9,6,1,10,916,1098,4,49,7,89,0,149,6,1139,3013
KARNATAKA,CHITRADURGA,2003,42,20,0,62,19,0,19,38,15,7,8,30,5,0,10,135,185,46,139,520,326,10,27,1,5,840,1209,6,43,1,32,0,82,0,1554,3276
KARNATAKA,DAKSHIN KANNADA,2003,35,30,1,66,3,0,3,6,10,5,5,20,7,0,7,163,220,99,121,617,194,4,40,2,22,508,775,2,23,4,31,0,60,5,2210,3521
KARNATAKA,DAVANAGERE,2003,28,20,3,51,16,0,16,32,14,6,8,28,9,2,35,192,329,100,229,896,277,11,47,1,0,584,922,10,56,2,78,0,146,2,1272,2988
KARNATAKA,DHARWAD COMMR.,2003,23,18,0,41,3,0,3,6,11,4,7,22,4,1,16,126,288,118,170,723,80,6,81,0,0,183,354,3,3,9,28,0,43,4,906,1793
KARNATAKA,DHARWAD RURAL,2003,28,11,3,42,5,0,5,10,0,0,0,0,8,0,6,39,60,5,55,173,106,4,12,0,3,137,262,3,11,0,12,0,26,0,455,903
KARNATAKA,GADAG,2003,16,12,0,28,1,0,1,2,4,2,2,8,5,0,1,56,62,11,51,186,98,5,14,0,7,150,274,1,12,0,13,0,26,0,385,842
KARNATAKA,GULBARGA,2003,88,72,3,163,14,0,14,28,29,20,9,58,5,3,33,199,190,47,143,620,334,4,67,2,62,1193,1677,5,150,0,103,0,258,15,1707,4278
KARNATAKA,HASSAN,2003,53,67,0,120,16,0,16,32,20,9,11,40,9,0,39,257,348,92,256,1001,200,11,34,1,25,1395,1666,3,78,0,43,0,124,0,1597,4196
KARNATAKA,HAVERI,2003,25,8,0,33,3,0,3,6,8,6,2,16,8,0,4,59,113,23,90,297,239,15,20,0,0,252,526,1,33,0,17,0,51,0,1022,1827
KARNATAKA,K.G.F.,2003,12,20,1,33,5,0,5,10,4,2,2,8,3,0,11,78,123,23,100,338,66,3,23,0,0,281,374,7,21,2,17,0,47,1,242,920
KARNATAKA,KODAGU,2003,32,24,0,56,11,0,11,22,6,2,4,12,5,0,6,132,69,9,60,281,89,3,11,1,3,354,461,1,27,0,18,0,46,0,490,1282
KARNATAKA,KOLAR,2003,65,56,1,122,14,0,14,28,32,26,6,64,1,0,22,153,357,70,287,890,298,10,35,2,0,667,1012,10,32,1,52,0,95,0,1405,3213
KARNATAKA,KOPPAL,2003,24,23,0,47,12,0,12,24,5,5,0,10,8,0,13,53,68,10,58,210,97,7,15,2,1,180,302,5,18,2,27,0,52,0,575,1135
KARNATAKA,MANDYA,2003,57,59,0,116,13,0,13,26,8,6,2,16,5,0,22,179,305,64,241,816,299,14,20,2,0,966,1301,5,65,0,77,0,147,0,1659,3755
KARNATAKA,MYSORE COMMR.,2003,26,22,0,48,8,0,8,16,9,7,2,18,3,1,49,132,324,127,197,833,47,17,43,3,0,361,471,5,14,0,44,0,63,0,711,1819
KARNATAKA,MYSORE RURAL,2003,40,23,0,63,4,0,4,8,5,3,2,10,2,0,16,176,191,19,172,576,158,2,9,0,0,812,981,7,59,0,45,0,111,0,825,2374
KARNATAKA,RAICHUR,2003,37,26,8,71,12,0,12,24,16,16,0,32,5,0,8,126,124,19,105,387,217,12,72,1,9,505,825,7,61,5,79,0,152,9,995,2334
KARNATAKA,RAILWAYS,2003,13,3,1,17,0,0,0,0,2,0,2,4,7,0,9,0,538,5,533,1092,15,1,3,0,0,20,39,1,2,0,0,0,3,0,197,812
KARNATAKA,SHIMOGA,2003,51,40,0,91,15,0,15,30,21,14,7,42,5,3,21,156,266,90,176,717,242,7,33,1,14,915,1221,4,73,0,127,0,204,9,1703,3706
KARNATAKA,TUMKUR,2003,79,46,2,127,14,0,14,28,24,1,23,48,6,0,19,260,396,107,289,1077,179,15,34,3,48,1027,1314,10,77,1,38,0,126,8,1717,4003
KARNATAKA,UDUPI,2003,15,10,2,27,5,0,5,10,9,0,9,18,3,0,9,121,107,25,82,347,144,4,19,1,4,354,528,0,21,1,23,0,45,2,1316,2170
KARNATAKA,UTTAR KANNADA,2003,23,22,0,45,0,0,0,0,1,1,0,2,3,0,6,64,85,27,58,243,93,5,11,1,2,396,508,0,37,3,25,0,65,0,1529,2306
KERALA,ALAPUZHA,2003,23,37,0,60,10,0,10,20,12,12,0,24,5,0,38,200,170,69,101,583,385,17,121,5,27,1179,1734,3,124,2,178,0,307,0,4439,6975
KERALA,CBCID,2003,18,5,0,23,1,0,1,2,4,1,3,8,1,0,2,5,10,6,4,28,8,20,32,65,3,3,131,0,0,0,2,0,2,0,53,232
KERALA,ERNAKULAM COMMR.,2003,21,28,7,56,11,0,11,22,11,5,6,22,26,0,66,304,486,145,341,1368,221,19,290,1,15,531,1078,0,77,7,54,0,138,1,4653,6829
KERALA,ERNAKULAM RURAL,2003,25,38,16,79,22,0,22,44,12,8,4,24,10,2,28,292,323,89,234,978,348,20,115,3,17,1150,1654,2,109,0,92,0,203,1,5455,8080
KERALA,IDUKKI,2003,28,14,0,42,14,0,14,28,0,0,0,0,1,0,16,155,167,20,147,506,233,18,65,1,17,1309,1645,0,93,6,104,0,203,2,2009,4252
KERALA,KANNUR,2003,12,38,7,57,13,0,13,26,4,2,2,8,8,0,13,218,164,68,96,567,505,15,81,5,0,804,1411,0,65,3,174,0,242,1,2143,4273
KERALA,KASARGOD,2003,24,19,9,52,15,0,15,30,9,4,5,18,6,0,16,143,169,97,72,503,372,2,69,3,36,635,1124,0,71,3,66,0,140,7,1169,2843
KERALA,KOLLAM,2003,36,22,97,155,53,0,53,106,24,11,13,48,8,0,28,260,329,152,177,954,712,9,158,8,58,2215,3169,5,317,0,365,0,687,9,4667,9380
KERALA,KOTTAYAM,2003,19,25,7,51,25,0,25,50,15,10,5,30,4,0,45,357,327,68,259,1060,316,28,279,3,14,1697,2337,0,141,10,115,0,266,0,3257,6684
KERALA,KOZHIKODE COMMR.,2003,14,14,18,46,10,0,10,20,7,3,4,14,4,0,23,494,335,145,190,1191,399,17,233,2,15,546,1212,2,50,5,157,0,214,0,2372,4717
KERALA,KOZHIKODE RURAL,2003,8,17,31,56,24,0,24,48,6,4,2,12,3,6,6,141,154,63,91,464,458,10,165,2,48,571,1255,1,76,5,210,0,292,1,2039,3982
KERALA,MALAPPURAM,2003,18,17,25,60,42,0,42,84,11,4,7,22,7,1,9,296,265,114,151,843,441,24,289,2,14,753,1523,2,57,2,460,0,521,0,3174,5909
KERALA,PALAKKAD,2003,52,41,25,118,47,0,47,94,12,1,11,24,11,2,35,281,262,97,165,853,458,39,157,3,46,1143,1850,3,140,4,214,0,361,4,2486,5465
KERALA,PATHANAMTHITTA,2003,27,10,31,68,13,0,13,26,0,0,0,0,1,0,25,130,144,59,85,444,221,13,59,2,22,867,1188,2,94,0,116,0,212,4,2425,4206
KERALA,RAILWAYS,2003,3,0,1,4,0,0,0,0,0,0,0,0,0,0,4,2,157,2,155,320,10,0,2,0,0,16,28,0,0,0,0,0,0,0,45,240
KERALA,THRISSUR,2003,39,35,33,107,29,0,29,58,20,7,13,40,23,3,89,333,488,147,341,1424,658,29,388,4,2,1224,2309,3,157,10,224,0,394,4,6002,9797
KERALA,TRIVANDRUM COMMR.,2003,10,53,16,79,17,0,17,34,14,7,7,28,14,0,113,334,442,185,257,1345,311,19,277,8,13,893,1521,2,114,5,82,0,203,0,2452,5189
KERALA,TRIVANDRUM RURAL,2003,37,27,11,75,28,0,28,56,28,23,5,56,7,5,64,360,309,109,200,1054,488,14,173,11,53,1687,2426,7,212,4,232,0,455,0,3787,7544
KERALA,WAYANADU,2003,21,8,9,38,20,0,20,40,0,0,0,0,3,0,14,104,190,33,157,501,254,10,108,1,13,473,860,1,50,2,85,0,138,1,860,2227
MADHYA PRADESH,ANUPPUR,2003,10,4,0,14,10,0,10,20,1,1,0,2,1,0,3,55,46,5,41,151,3,1,3,0,0,18,25,1,14,2,3,0,20,0,458,633
MADHYA PRADESH,ASHOK NAGAR,2003,24,24,3,51,33,0,33,66,5,4,1,10,0,1,11,119,101,17,84,333,56,11,3,0,20,860,985,6,140,12,36,0,194,35,695,2195
MADHYA PRADESH,BALAGHAT,2003,55,25,2,82,61,0,61,122,7,5,2,14,2,1,12,171,164,22,142,514,36,8,8,0,13,382,487,10,134,32,69,0,245,40,1663,2895
MADHYA PRADESH,BARWANI,2003,45,24,0,69,38,0,38,76,9,8,1,18,3,8,15,93,121,35,86,361,39,3,10,1,6,326,472,4,88,5,23,0,120,87,1304,2252
MADHYA PRADESH,BETUL,2003,65,51,4,120,137,0,137,274,24,22,2,48,1,0,11,229,190,38,152,621,20,0,27,0,13,442,571,9,171,11,51,0,242,69,1788,3313
MADHYA PRADESH,BHIND,2003,61,101,3,165,25,0,25,50,28,18,10,56,3,8,40,191,250,29,221,742,100,12,32,0,28,639,923,24,94,0,53,0,171,112,1843,3647
MADHYA PRADESH,BHOPAL,2003,54,111,0,165,93,0,93,186,55,46,9,110,1,4,97,978,1640,673,967,4360,92,32,109,16,20,646,1094,16,252,23,142,0,433,179,10129,14689
MADHYA PRADESH,BHOPAL RLY.,2003,5,2,1,8,3,0,3,6,1,0,1,2,2,0,25,32,1086,11,1075,2231,5,0,8,0,1,2,16,2,14,6,1,0,23,0,308,1504
MADHYA PRADESH,BURHANPUR,2003,6,2,0,8,7,0,7,14,0,0,0,0,0,1,2,17,37,8,29,94,5,4,4,0,0,102,122,1,22,0,13,0,36,7,226,456
MADHYA PRADESH,CHHATARPUR,2003,55,69,1,125,56,0,56,112,11,8,3,22,2,2,32,228,135,22,113,534,49,3,11,1,22,542,714,17,164,13,50,0,244,86,1493,3042
MADHYA PRADESH,CHHINDWARA,2003,45,34,5,84,82,0,82,164,14,12,2,28,1,1,9,164,181,53,128,537,26,2,27,0,20,1071,1248,12,187,27,78,0,304,102,1451,3539
MADHYA PRADESH,DAMOH,2003,47,50,0,97,49,0,49,98,18,13,5,36,0,0,19,146,114,21,93,393,18,1,9,0,7,1123,1201,27,179,0,64,0,270,43,762,2676
MADHYA PRADESH,DATIYA,2003,55,39,0,94,30,0,30,60,13,7,6,26,1,2,31,99,132,14,118,397,19,5,14,0,10,391,490,10,66,0,35,0,111,51,984,1987
MADHYA PRADESH,DEWAS,2003,57,85,2,144,88,0,88,176,34,20,14,68,27,6,67,366,999,153,846,2464,112,25,44,0,31,396,722,12,213,68,196,0,489,114,5536,8478
MADHYA PRADESH,DHAR,2003,87,86,0,173,82,0,82,164,27,23,4,54,5,17,46,261,515,112,403,1359,138,27,11,0,46,586,808,40,200,13,85,0,338,0,2666,4938
MADHYA PRADESH,DINDORI,2003,14,3,0,17,37,0,37,74,2,2,0,4,0,0,5,61,44,10,34,154,5,1,10,0,6,109,152,1,64,8,22,0,95,21,622,1035
MADHYA PRADESH,GUNA,2003,37,32,8,77,83,0,83,166,8,6,2,16,0,1,21,258,254,52,202,788,76,6,21,0,16,953,1180,9,175,7,68,0,259,108,1437,3578
MADHYA PRADESH,GWALIOR,2003,91,137,8,236,72,0,72,144,81,50,31,162,10,8,112,997,967,407,560,3061,151,36,109,2,9,847,1342,24,161,6,125,0,316,188,3692,7833
MADHYA PRADESH,HARDA,2003,13,10,0,23,25,0,25,50,1,1,0,2,4,0,14,42,83,34,49,226,7,0,3,0,3,277,293,3,52,0,22,0,77,3,266,828
MADHYA PRADESH,HOSHANGABAD,2003,49,53,68,170,70,0,70,140,10,7,3,20,1,2,48,337,357,90,267,1102,29,6,19,1,12,465,532,19,127,7,52,0,205,0,1629,3361
MADHYA PRADESH,INDORE,2003,93,129,3,225,77,0,77,154,61,43,18,122,6,7,162,966,2856,1452,1404,6853,134,64,123,5,42,974,1682,22,240,84,298,0,644,340,9312,15998
MADHYA PRADESH,INDORE RLY.,2003,4,2,1,7,0,0,0,0,0,0,0,0,0,0,4,4,111,2,109,230,3,0,4,0,0,8,15,1,3,0,0,0,4,0,57,202
MADHYA PRADESH,JABALPUR,2003,92,131,0,223,103,0,103,206,45,25,20,90,3,4,96,635,1151,434,717,3040,95,26,84,2,18,3420,3825,57,297,60,108,0,522,180,3397,10004
MADHYA PRADESH,JABALPUR RLY.,2003,1,3,0,4,0,0,0,0,3,2,1,6,0,4,16,8,223,4,219,474,1,0,1,0,0,15,17,0,4,1,0,0,5,0,117,397
MADHYA PRADESH,JHABUA,2003,119,101,15,235,36,0,36,72,37,35,2,74,5,12,18,143,214,31,183,606,46,3,17,0,47,634,771,0,112,10,12,0,134,24,1766,3371
MADHYA PRADESH,KATNI,2003,35,34,3,72,37,0,37,74,6,4,2,12,1,2,27,190,225,103,122,670,30,5,16,0,6,886,1048,17,137,15,61,0,230,105,719,2557
MADHYA PRADESH,KHANDWA,2003,31,30,0,61,53,0,53,106,20,18,2,40,2,3,9,225,222,48,174,683,37,9,23,0,6,34,154,6,157,21,23,0,207,45,1835,2791
MADHYA PRADESH,KHARGON,2003,37,36,7,80,50,0,50,100,13,13,0,26,5,15,18,259,646,34,612,1589,77,31,27,2,6,393,687,5,184,31,43,0,263,151,2125,4161
MADHYA PRADESH,MANDLA,2003,37,15,1,53,39,0,39,78,2,2,0,4,0,0,5,92,113,16,97,323,20,4,17,0,4,344,440,4,143,13,44,0,204,51,1199,2147
MADHYA PRADESH,MANDSAUR,2003,30,27,0,57,45,0,45,90,12,5,7,24,3,2,33,231,413,86,327,1095,52,24,33,1,21,306,501,4,126,12,54,0,196,64,1265,2758
MADHYA PRADESH,MORENA,2003,57,65,4,126,40,0,40,80,32,21,11,64,6,2,42,248,458,80,378,1214,167,0,29,2,14,783,1099,23,93,3,41,0,160,104,2274,4487
MADHYA PRADESH,NARSINGHPUR,2003,44,39,2,85,40,0,40,80,3,3,0,6,0,1,19,101,127,31,96,375,28,3,11,0,15,898,1011,15,134,19,34,0,202,56,557,2146
MADHYA PRADESH,NEEMUCH,2003,13,15,2,30,31,0,31,62,9,5,4,18,4,1,18,225,313,110,203,874,36,31,20,1,11,319,463,4,65,10,65,0,144,45,878,2116
MADHYA PRADESH,PANNA,2003,36,16,1,53,32,0,32,64,7,4,3,14,0,0,15,100,122,12,110,359,14,5,5,0,9,72,141,21,92,2,26,0,141,36,1021,1632
MADHYA PRADESH,RAISEN,2003,35,50,0,85,75,0,75,150,8,8,0,16,1,0,16,153,208,38,170,586,33,4,10,0,7,231,382,17,176,0,46,0,239,97,2209,3376
MADHYA PRADESH,RAJGARH,2003,31,48,1,80,88,0,88,176,9,5,4,18,1,0,35,214,328,35,293,906,121,9,10,1,35,367,654,2,163,20,83,0,268,111,2389,4066
MADHYA PRADESH,RATLAM,2003,45,46,3,94,62,0,62,124,14,9,5,28,2,7,18,169,443,111,332,1082,24,22,37,1,19,315,502,5,132,13,50,0,200,84,1936,3447
MADHYA PRADESH,REWA,2003,57,46,0,103,41,0,41,82,36,11,25,72,8,7,59,723,393,149,244,1583,49,7,16,0,26,582,787,28,110,2,44,0,184,107,2109,4450
MADHYA PRADESH,SAGAR,2003,59,109,0,168,121,0,121,242,30,28,2,60,0,1,32,411,521,38,483,1486,103,6,34,0,35,2040,2325,27,388,17,127,0,559,107,2688,6856
MADHYA PRADESH,SATNA,2003,61,59,0,120,59,0,59,118,18,5,13,36,1,1,38,330,362,119,243,1094,34,5,17,1,21,910,1163,33,187,5,57,0,282,175,2163,4537
MADHYA PRADESH,SEONI,2003,27,24,2,53,54,0,54,108,1,1,0,2,0,0,13,103,93,22,71,302,28,5,14,0,5,375,513,6,86,4,25,0,121,86,944,1895
MADHYA PRADESH,SHAHDOL,2003,60,21,8,89,68,0,68,136,12,8,4,24,0,0,31,340,301,37,264,973,29,7,15,0,28,322,401,13,221,14,120,0,368,0,2555,4165
MADHYA PRADESH,SHAJAPUR,2003,31,51,3,85,71,0,71,142,13,9,4,26,3,1,43,268,535,62,473,1385,103,18,23,0,31,1037,1290,10,166,36,79,0,291,78,1118,3718
MADHYA PRADESH,SHEOPUR,2003,15,28,0,43,19,0,19,38,4,1,3,8,3,2,7,58,96,9,87,262,37,5,9,0,2,227,296,1,51,0,11,0,63,16,663,1254
MADHYA PRADESH,SHIVPURI,2003,60,66,0,126,69,0,69,138,47,16,31,94,0,0,21,191,210,60,150,632,109,15,16,0,12,400,651,13,130,0,32,0,175,99,1983,3473
MADHYA PRADESH,SIDHI,2003,44,19,5,68,38,0,38,76,26,24,2,52,2,1,16,342,303,21,282,967,32,4,27,0,18,446,618,17,121,2,27,0,167,91,2136,3717
MADHYA PRADESH,SIHORE,2003,32,32,2,66,86,0,86,172,6,4,2,12,0,0,24,154,336,45,291,850,24,13,21,0,12,369,530,6,87,12,32,0,137,91,1873,3212
MADHYA PRADESH,TIKAMGARH,2003,40,31,0,71,50,0,50,100,15,5,10,30,1,1,14,169,154,17,137,493,47,1,14,0,23,912,1057,20,98,5,21,0,144,60,1002,2678
MADHYA PRADESH,UJJAIN,2003,58,146,1,205,59,0,59,118,40,34,6,80,8,4,73,602,1174,201,973,3035,91,30,48,1,44,813,1108,7,172,27,125,0,331,81,4030,7634
MADHYA PRADESH,UMARIYA,2003,27,4,34,65,20,0,20,40,0,0,0,0,1,1,16,111,69,0,69,267,17,0,8,0,8,143,182,5,59,3,22,0,89,6,690,1244
MADHYA PRADESH,VIDISHA,2003,41,48,0,89,94,0,94,188,9,7,2,18,23,0,20,275,286,49,237,890,122,10,11,0,60,606,852,12,197,24,40,0,273,43,1789,3710
MAHARASHTRA,AHMEDNAGAR,2003,101,38,2,141,44,0,44,88,27,13,14,54,17,13,102,302,786,232,554,2006,254,29,77,6,44,575,1465,15,51,3,287,0,356,480,998,4251
MAHARASHTRA,AKOLA,2003,48,38,0,86,29,0,29,58,29,29,0,58,10,1,45,298,727,86,641,1808,89,15,70,5,28,832,1155,9,80,5,132,0,226,116,1294,3900
MAHARASHTRA,AMRAVATI COMMR.,2003,31,25,2,58,26,0,26,52,15,12,3,30,6,3,35,316,948,157,791,2256,85,21,38,5,20,435,675,3,45,19,77,0,144,71,760,2986
MAHARASHTRA,AMRAVATI RURAL,2003,53,38,3,94,47,0,47,94,17,15,2,34,11,0,31,343,902,41,861,2189,138,19,29,4,70,855,1247,8,118,22,151,0,299,132,772,3763
MAHARASHTRA,AURANGABAD COMMR.,2003,28,26,1,55,8,0,8,16,19,13,6,38,17,5,49,234,506,167,339,1317,126,16,111,4,11,339,709,4,25,10,130,0,169,102,515,2286
MAHARASHTRA,AURANGABAD RURAL,2003,60,24,0,84,14,0,14,28,4,4,0,8,10,2,47,110,281,54,227,731,165,9,35,1,53,798,1261,32,48,8,190,0,278,200,584,2675
MAHARASHTRA,BEED,2003,72,55,1,128,25,0,25,50,17,11,6,34,23,7,73,282,599,103,496,1583,318,24,47,2,53,992,1622,10,58,8,186,0,262,186,849,3887
MAHARASHTRA,BHANDARA,2003,30,7,1,38,41,0,41,82,7,6,1,14,3,0,12,224,361,33,328,961,73,13,19,0,30,378,630,7,54,27,69,0,157,117,840,2313
MAHARASHTRA,BULDHANA,2003,53,33,4,90,39,0,39,78,17,13,4,34,17,2,40,239,723,62,661,1744,167,19,69,7,86,825,1353,61,106,26,164,0,357,180,944,3821
MAHARASHTRA,CHANDRAPUR,2003,41,21,8,70,36,0,36,72,13,12,1,26,8,1,29,295,574,77,497,1481,116,21,47,1,27,508,909,3,85,21,101,0,210,189,888,3033
MAHARASHTRA,DHULE,2003,32,13,2,47,7,0,7,14,5,5,0,10,2,3,3,82,219,70,149,528,61,17,38,2,3,290,634,2,18,6,90,0,116,223,636,1754
MAHARASHTRA,GADCHIROLI,2003,58,28,4,90,30,0,30,60,17,13,4,34,9,0,7,113,131,10,121,391,21,21,8,1,51,282,444,2,57,20,81,0,160,60,500,1501
MAHARASHTRA,GONDIA,2003,41,13,1,55,25,0,25,50,12,11,1,24,7,1,9,214,300,27,273,831,27,10,13,1,15,360,508,6,93,26,74,0,199,82,545,1875
MAHARASHTRA,HINGOLI,2003,28,29,1,58,14,0,14,28,7,7,0,14,4,0,44,98,142,21,121,430,107,6,31,0,25,488,734,1,36,6,112,0,155,77,479,1735
MAHARASHTRA,JALGAON,2003,82,39,3,124,38,0,38,76,20,9,11,40,13,2,28,228,475,103,372,1221,135,65,147,2,19,822,1466,8,79,21,239,0,347,276,1186,3927
MAHARASHTRA,JALNA,2003,53,25,1,79,8,0,8,16,15,14,1,30,7,0,43,165,309,63,246,833,146,16,44,2,28,644,980,15,53,14,204,0,286,100,538,2430
MAHARASHTRA,KOLHAPUR,2003,66,40,7,113,15,0,15,30,18,11,7,36,5,0,24,229,508,178,330,1274,148,93,304,6,16,567,1420,25,47,7,64,0,143,286,883,3358
MAHARASHTRA,LATUR,2003,56,34,0,90,21,0,21,42,15,15,0,30,4,2,34,100,291,42,249,722,175,25,58,0,37,950,1399,31,49,2,80,0,162,154,956,3074
MAHARASHTRA,MUMBAI,2003,242,115,8,365,133,0,133,266,150,85,65,300,30,53,239,2550,9793,2883,6910,22458,131,392,1178,73,7,3562,5975,8,282,44,199,0,533,632,5865,25686
MAHARASHTRA,MUMBAI RLY.,2003,9,8,0,17,4,0,4,8,2,2,0,4,1,2,32,3,1589,1,1588,3216,9,10,36,1,0,28,84,1,16,1,0,0,18,0,89,1841
MAHARASHTRA,NAGPUR COMMR.,2003,104,40,0,144,26,0,26,52,36,29,7,72,16,37,172,1079,2022,722,1300,5348,165,46,151,16,14,783,1399,4,36,36,136,0,212,224,2214,7357
MAHARASHTRA,NAGPUR RLY.,2003,8,2,0,10,1,0,1,2,2,2,0,4,1,1,12,3,940,7,933,1897,4,3,2,14,0,29,54,0,5,1,0,0,6,2,139,1169
MAHARASHTRA,NAGPUR RURAL,2003,73,28,5,106,52,0,52,104,23,19,4,46,4,5,63,341,860,66,794,2133,112,28,47,8,62,758,1324,5,95,42,111,0,253,309,1613,4644
MAHARASHTRA,NANDED,2003,71,90,1,162,33,0,33,66,24,14,10,48,25,8,74,362,518,76,442,1505,219,19,131,1,73,1508,2082,16,78,7,229,0,330,131,2211,5829
MAHARASHTRA,NANDURBAR,2003,43,13,0,56,10,0,10,20,10,9,1,20,10,1,11,89,134,21,113,379,91,9,23,3,5,277,502,2,34,12,77,0,125,94,335,1283
MAHARASHTRA,NASIK COMMR.,2003,27,20,1,48,11,0,11,22,14,12,2,28,13,3,31,375,705,241,464,1832,86,25,101,2,4,233,604,4,18,14,116,0,152,153,586,2542
MAHARASHTRA,NASIK RURAL,2003,110,46,5,161,54,0,54,108,20,14,6,40,25,8,51,260,447,81,366,1238,277,43,95,8,41,806,1681,3,84,31,358,0,476,411,1201,4384
MAHARASHTRA,NAVI MUMBAI,2003,50,19,0,69,16,0,16,32,17,7,10,34,10,19,49,318,782,330,452,1960,67,52,145,4,1,319,879,6,28,7,55,0,96,291,606,2861
MAHARASHTRA,OSMANABAD,2003,38,16,2,56,12,0,12,24,7,3,4,14,6,0,17,191,329,41,288,872,153,20,25,1,15,727,1117,3,37,11,92,0,143,176,629,2507
MAHARASHTRA,PARBHANI,2003,52,30,1,83,13,0,13,26,12,7,5,24,26,0,56,151,205,38,167,643,131,7,60,3,25,966,1269,7,49,5,149,0,210,77,325,2350
MAHARASHTRA,PUNE COMMR.,2003,110,54,4,168,40,0,40,80,46,27,19,92,11,8,97,868,2740,1568,1172,6464,531,63,462,7,7,983,2421,2,61,92,166,0,321,368,2093,8813
MAHARASHTRA,PUNE RLY.,2003,0,0,0,0,3,0,3,6,0,0,0,0,0,0,4,0,192,1,191,388,2,0,3,2,1,1,11,0,1,0,0,0,1,2,50,261
MAHARASHTRA,PUNE RURAL,2003,127,26,6,159,29,0,29,58,26,14,12,52,13,14,58,283,661,247,414,1690,143,41,87,0,21,563,1637,7,55,8,165,0,235,782,1364,4479
MAHARASHTRA,RAIGAD,2003,50,22,1,73,25,0,25,50,19,12,7,38,17,2,26,156,274,46,228,749,129,15,47,5,14,281,799,2,42,7,57,0,108,308,680,2179
MAHARASHTRA,RATNAGIRI,2003,20,14,3,37,16,0,16,32,5,1,4,10,2,0,5,154,178,31,147,517,48,18,43,5,17,191,434,0,27,10,47,0,84,112,357,1272
MAHARASHTRA,SANGLI,2003,78,24,5,107,47,0,47,94,24,12,12,48,9,4,19,187,498,136,362,1215,93,32,153,11,33,414,1033,7,39,8,87,0,141,297,644,2713
MAHARASHTRA,SATARA,2003,61,20,0,81,17,0,17,34,14,6,8,28,20,3,34,213,506,136,370,1282,88,31,79,1,16,413,968,8,42,5,156,0,211,340,1097,3164
MAHARASHTRA,SINDHUDURG,2003,14,4,1,19,8,0,8,16,8,4,4,16,4,1,8,97,93,13,80,296,38,17,9,2,10,178,310,1,16,3,3,0,23,56,239,810
MAHARASHTRA,SOLAPUR COMMR.,2003,22,15,2,39,15,0,15,30,15,8,7,30,9,1,45,160,351,104,247,917,66,19,116,2,10,197,486,4,19,3,72,0,98,76,463,1682
MAHARASHTRA,SOLAPUR RURAL,2003,112,50,6,168,44,0,44,88,22,15,7,44,10,3,34,173,367,67,300,954,153,26,35,4,30,726,1369,4,52,0,130,0,186,395,854,3230
MAHARASHTRA,THANE COMMR.,2003,111,63,4,178,51,0,51,102,58,35,23,116,23,20,148,929,1872,650,1222,4864,238,76,570,20,10,1378,2533,4,66,29,153,0,252,241,644,6708
MAHARASHTRA,THANE RURAL,2003,149,49,7,205,51,0,51,102,32,16,16,64,33,11,85,476,537,106,431,1679,208,64,103,9,20,644,1567,6,101,23,107,0,237,519,774,4008
MAHARASHTRA,WARDHA,2003,48,26,3,77,25,0,25,50,15,15,0,30,6,0,27,284,655,45,610,1627,48,26,50,6,53,791,1090,1,81,4,67,0,153,116,1451,3783
MAHARASHTRA,WASHIM,2003,27,24,1,52,15,0,15,30,13,10,3,26,11,0,21,100,323,18,305,778,75,7,21,3,33,514,727,9,60,12,119,0,200,74,497,1959
MAHARASHTRA,YAVATMAL,2003,83,68,6,157,50,0,50,100,38,35,3,76,6,3,23,218,745,70,675,1740,58,33,48,1,50,995,1346,12,135,16,170,0,333,161,1304,4223
MANIPUR,BISHNUPUR,2003,22,42,1,65,2,0,2,4,10,6,4,20,0,0,0,6,11,0,11,28,8,0,6,0,1,46,61,0,16,0,0,0,16,0,103,274
MANIPUR,CHANDEL,2003,17,6,0,23,0,0,0,0,3,1,2,6,0,0,1,0,5,1,4,11,5,1,0,0,4,10,20,0,0,0,0,0,0,0,31,83
MANIPUR,CHURACHANDPUR,2003,14,21,0,35,0,0,0,0,4,0,4,8,0,0,0,3,16,0,16,35,0,0,1,0,0,4,5,0,2,0,0,0,2,0,32,97
MANIPUR,IMPHAL(EAST),2003,25,32,1,58,3,0,3,6,18,10,8,36,0,0,1,9,44,29,15,98,18,2,8,0,5,64,97,0,2,0,0,0,2,0,226,458
MANIPUR,IMPHAL(WEST),2003,28,35,1,64,5,0,5,10,41,24,17,82,2,0,1,37,131,92,39,302,32,8,25,7,25,91,192,0,22,0,1,0,23,4,445,941
MANIPUR,SENAPATI,2003,17,13,2,32,0,0,0,0,7,1,6,14,1,0,1,1,3,0,3,9,5,1,4,0,4,3,17,0,0,0,0,0,0,0,70,132
MANIPUR,TAMENGLONG,2003,3,3,0,6,0,0,0,0,0,0,0,0,0,0,0,0,5,0,5,10,0,0,0,0,1,1,2,0,0,0,0,0,0,0,11,24
MANIPUR,THOUBAL,2003,22,42,1,65,8,0,8,16,34,26,8,68,0,0,1,10,33,2,31,77,5,4,32,0,4,100,145,0,1,0,3,0,4,0,188,488
MANIPUR,UKHRUL,2003,2,5,0,7,0,0,0,0,3,3,0,6,0,0,1,2,4,0,4,11,0,0,0,0,3,5,8,0,1,0,0,0,1,0,14,40
MEGHALAYA,GARO HILLS EAST,2003,14,16,1,31,1,0,1,2,7,0,7,14,4,0,6,19,20,0,20,69,3,0,3,1,5,11,23,0,0,0,0,0,0,0,21,132
MEGHALAYA,GARO HILLS SOUTH,2003,7,4,0,11,3,0,3,6,3,0,3,6,2,0,1,3,7,0,7,20,0,0,0,0,0,0,0,0,1,0,0,0,1,0,15,46
MEGHALAYA,GARO HILLS WEST,2003,24,8,12,44,6,0,6,12,18,0,18,36,13,0,17,21,24,0,24,99,0,0,4,1,3,14,22,0,5,0,0,0,5,0,30,200
MEGHALAYA,JAINTIA HILLS,2003,52,2,0,54,11,0,11,22,0,0,0,0,8,0,4,10,41,16,25,104,0,4,3,1,1,35,58,0,0,0,0,0,0,14,78,264
MEGHALAYA,KHASI HILLS EAST,2003,45,19,3,67,10,0,10,20,14,7,7,28,33,1,84,103,211,86,125,643,2,7,20,1,3,22,55,0,7,1,4,0,12,0,180,770
MEGHALAYA,KHASI HILLS WEST,2003,17,9,0,26,6,0,6,12,2,0,2,4,8,0,9,1,18,0,18,54,0,0,0,0,0,0,0,0,0,0,0,0,0,0,21,91
MEGHALAYA,RI-BHOI,2003,16,2,1,19,3,0,3,6,5,3,2,10,15,0,12,3,39,6,33,108,0,1,4,0,4,24,60,0,0,0,0,0,0,27,10,166
MIZORAM,AIZAWL,2003,14,24,1,39,24,0,24,48,4,1,3,8,1,0,14,264,709,42,667,1697,3,13,41,7,11,48,123,0,25,0,3,0,28,0,665,1871
MIZORAM,CHAMPHAI,2003,6,1,1,8,10,0,10,20,1,0,1,2,0,0,2,39,67,2,65,175,0,1,4,2,1,19,27,0,11,0,0,0,11,0,56,221
MIZORAM,KOLASIB,2003,5,2,1,8,5,0,5,10,2,0,2,4,3,0,3,33,77,4,73,193,0,0,2,0,3,15,30,0,11,0,0,0,11,10,81,253
MIZORAM,LAWNGTLAI,2003,6,3,0,9,1,0,1,2,0,0,0,0,1,0,0,7,50,1,49,108,0,0,1,1,1,5,8,0,6,0,0,0,6,0,62,144
MIZORAM,LUNGLEI,2003,6,2,0,8,6,0,6,12,0,0,0,0,0,0,2,59,205,8,197,471,0,4,7,0,4,20,35,0,15,0,0,0,15,0,25,355
MIZORAM,MAMIT,2003,2,2,0,4,1,0,1,2,0,0,0,0,0,0,0,18,34,0,34,86,0,0,1,2,1,6,10,0,0,0,0,0,0,0,26,93
MIZORAM,SAIHA,2003,6,1,0,7,4,0,4,8,1,1,0,2,0,0,0,34,101,0,101,236,0,0,3,0,2,19,24,0,11,0,0,0,11,0,178,360
MIZORAM,SERCHHIP,2003,1,1,0,2,3,0,3,6,0,0,0,0,0,0,0,33,60,0,60,153,0,1,1,0,0,10,13,0,9,0,0,0,9,1,39,159
NAGALAND,DIMAPUR,2003,15,2,3,20,2,0,2,4,12,2,10,24,2,0,54,20,74,17,57,224,0,1,1,2,0,19,44,0,0,0,0,1,1,21,9,238
NAGALAND,KIPHIRE,2003,1,0,0,1,1,0,1,2,1,0,1,2,1,0,0,2,2,0,2,7,0,0,0,1,0,0,1,0,0,0,0,0,0,0,7,16
NAGALAND,KOHIMA,2003,28,10,0,38,5,0,5,10,2,0,2,4,4,0,16,19,53,13,40,145,0,0,5,1,0,2,8,0,4,0,0,0,4,0,96,245
NAGALAND,MOKOKCHUNG,2003,8,3,1,12,1,0,1,2,10,0,10,20,3,0,3,7,9,3,6,31,3,0,1,0,5,9,26,0,0,2,0,0,2,8,30,103
NAGALAND,MON,2003,7,7,0,14,2,0,2,4,1,0,1,2,6,0,4,10,21,4,17,62,0,0,1,1,0,5,13,0,0,0,0,0,0,6,13,84
NAGALAND,PEREN,2003,4,0,2,6,1,0,1,2,4,0,4,8,0,0,2,3,5,0,5,15,0,0,0,1,0,1,5,0,0,0,0,0,0,3,1,27
NAGALAND,PHEK,2003,8,4,2,14,2,0,2,4,6,0,6,12,3,0,5,10,3,0,3,24,1,0,0,0,0,4,5,0,0,0,0,0,0,0,17,65
NAGALAND,TUENSANG,2003,9,1,0,10,0,0,0,0,0,0,0,0,0,0,3,9,11,0,11,34,4,1,1,1,0,0,7,0,0,0,0,0,0,0,16,56
NAGALAND,WOKHA,2003,5,6,0,11,0,0,0,0,2,1,1,4,0,0,3,3,40,0,40,86,0,1,2,0,0,6,12,0,0,0,0,0,0,3,14,85
NAGALAND,ZUNHEBOTO,2003,6,1,0,7,0,0,0,0,0,0,0,0,0,0,2,12,3,0,3,20,0,0,0,0,0,2,2,0,0,0,0,0,0,0,31,57
ODISHA,ANGUL,2003,42,50,1,93,20,0,20,40,9,9,0,18,6,0,27,74,167,5,162,441,83,16,20,0,19,50,333,18,111,0,36,0,165,145,720,1614
ODISHA,BALASORE,2003,45,26,1,72,49,0,49,98,40,32,8,80,6,5,51,137,186,15,171,571,58,12,32,0,14,198,314,30,61,25,44,0,160,0,1525,2545
ODISHA,BARAGARH,2003,27,35,10,72,30,0,30,60,4,4,0,8,7,0,19,56,124,51,73,330,83,19,27,0,13,40,292,10,70,3,91,0,174,110,594,1372
ODISHA,BERHAMPUR,2003,13,33,0,46,12,0,12,24,6,1,5,12,7,1,47,93,120,50,70,388,29,7,25,0,4,183,313,4,47,3,18,0,72,65,380,1097
ODISHA,BHADRAK,2003,17,45,0,62,25,0,25,50,21,21,0,42,5,0,21,57,82,3,79,247,48,5,16,0,19,23,174,21,49,2,67,0,139,63,824,1410
ODISHA,BOLANGIR,2003,24,48,0,72,25,0,25,50,4,4,0,8,0,0,26,72,123,5,118,344,100,10,48,0,10,78,252,0,95,5,38,0,138,6,936,1648
ODISHA,BOUDH,2003,14,6,0,20,11,0,11,22,6,4,2,12,0,0,9,23,40,0,40,112,15,4,2,0,9,25,66,1,32,1,10,0,44,11,186,405
ODISHA,CUTTACK,2003,47,143,138,328,32,0,32,64,32,26,6,64,17,0,113,303,576,219,357,1585,56,26,94,1,23,44,390,47,27,1,122,0,197,146,1997,3985
ODISHA,DEOGARH,2003,12,11,0,23,5,0,5,10,11,9,2,22,1,0,7,32,26,0,26,92,21,1,5,0,4,165,213,0,52,3,12,0,67,17,117,502
ODISHA,DHENKANAL,2003,34,46,0,80,9,0,9,18,9,7,2,18,4,0,15,71,65,8,57,220,62,7,10,0,24,103,287,3,67,10,27,0,107,81,540,1187
ODISHA,GAJAPATI,2003,9,9,0,18,4,0,4,8,5,4,1,10,0,0,3,15,25,4,21,68,14,0,7,0,7,53,100,3,21,1,7,0,32,19,166,368
ODISHA,GANJAM,2003,54,88,4,146,17,0,17,34,9,9,0,18,11,0,33,106,157,23,134,464,85,10,27,1,25,173,515,13,185,10,46,0,254,194,778,2026
ODISHA,JAGATSINGHPUR,2003,22,28,6,56,13,0,13,26,23,15,8,46,8,0,24,71,139,18,121,381,16,12,21,0,9,142,338,12,9,4,29,0,54,138,576,1302
ODISHA,JAJPUR,2003,23,23,0,46,17,0,17,34,22,21,1,44,10,0,19,110,173,13,160,485,43,8,17,1,10,254,419,19,18,0,73,0,110,86,704,1630
ODISHA,JHARSUGUDA,2003,22,9,2,33,15,0,15,30,8,8,0,16,2,2,15,62,81,7,74,243,31,1,16,0,7,15,277,0,38,4,23,0,65,207,402,962
ODISHA,KALAHANDI,2003,14,18,2,34,18,0,18,36,9,9,0,18,3,2,24,45,82,7,75,238,48,4,75,0,3,69,244,5,22,6,11,0,44,45,275,780
ODISHA,KANDHAMAL,2003,25,4,1,30,35,0,35,70,24,23,1,48,1,0,7,58,78,7,71,222,14,6,13,0,10,486,529,2,84,7,75,0,168,0,15,945
ODISHA,KENDRAPARA,2003,26,41,0,67,10,0,10,20,16,12,4,32,2,3,8,71,83,10,73,250,10,7,16,2,3,14,58,12,14,0,12,0,38,6,574,930
ODISHA,KEONJHAR,2003,76,33,4,113,37,0,37,74,25,25,0,50,12,0,25,65,157,10,147,416,83,9,11,3,11,72,422,14,84,17,55,0,170,233,947,1973
ODISHA,KHURDA,2003,65,109,0,174,57,0,57,114,47,35,12,94,28,9,151,553,1016,443,573,2773,111,28,160,2,24,1194,1680,29,39,19,131,0,218,161,1338,5271
ODISHA,KORAPUT,2003,41,27,0,68,38,0,38,76,23,21,2,46,4,0,24,99,162,11,151,451,56,4,31,0,12,41,194,0,82,4,51,0,137,50,785,1534
ODISHA,MALKANGIR,2003,31,16,9,56,17,0,17,34,5,4,1,10,1,0,4,17,47,2,45,116,5,1,7,0,3,73,104,1,16,1,6,0,24,15,165,440
ODISHA,MAYURBHANJ,2003,79,46,1,126,70,0,70,140,28,2,26,56,11,0,29,110,173,11,162,496,41,12,35,0,12,16,230,11,120,8,135,0,274,114,1162,2213
ODISHA,NAYAGARH,2003,28,34,2,64,15,0,15,30,18,11,7,36,3,1,18,57,93,11,82,265,20,1,9,0,11,84,197,12,10,2,15,0,39,72,398,903
ODISHA,NOWRANGPUR,2003,17,24,3,44,26,0,26,52,16,15,1,32,3,0,9,49,67,10,57,195,56,3,7,0,5,54,176,0,44,5,19,0,68,51,250,708
ODISHA,NUAPADA,2003,10,6,0,16,6,0,6,12,4,0,4,8,0,0,8,17,41,7,34,107,19,8,11,0,5,34,110,0,21,13,16,0,50,33,310,562
ODISHA,PURI,2003,49,125,0,174,39,0,39,78,19,14,5,38,5,5,41,141,211,20,191,614,57,8,31,0,18,56,236,0,7,0,24,0,31,66,1540,2442
ODISHA,RAYAGADA,2003,27,17,1,45,14,0,14,28,5,5,0,10,4,0,9,37,67,6,61,184,55,3,27,0,7,58,199,4,44,3,27,0,78,49,423,881
ODISHA,ROURKELA,2003,23,12,0,35,10,0,10,20,4,3,1,8,0,0,18,94,181,21,160,474,6,6,48,0,3,154,259,1,31,6,21,0,59,42,518,1178
ODISHA,SAMBALPUR,2003,29,48,1,78,22,0,22,44,10,9,1,20,12,0,36,148,220,38,182,636,31,6,37,0,6,78,267,1,61,13,15,0,90,109,892,1775
ODISHA,SONEPUR,2003,9,5,0,14,4,0,4,8,2,2,0,4,0,0,2,24,45,0,45,116,18,5,9,0,3,16,60,1,44,1,8,0,54,9,261,466
ODISHA,SRP(CUTTACK),2003,3,6,0,9,1,0,1,2,3,2,1,6,0,0,10,8,335,18,317,688,1,0,4,0,0,21,27,0,9,1,3,0,13,1,103,509
ODISHA,SRP(ROURKELA),2003,4,2,0,6,1,0,1,2,1,1,0,2,0,0,7,6,86,5,81,185,1,1,3,0,0,8,16,0,3,0,0,0,3,3,85,211
ODISHA,SUNDARGARH,2003,83,41,2,126,21,0,21,42,9,6,3,18,5,2,16,80,131,18,113,365,32,4,36,1,4,685,912,5,52,10,22,0,89,150,116,1507
PUNJAB,AMRITSAR,2003,49,31,3,83,11,0,11,22,38,25,13,76,0,7,16,102,161,98,63,447,0,20,207,5,2,177,481,4,9,0,50,0,63,70,460,1422
PUNJAB,BARNALA,2003,16,23,3,42,15,0,15,30,12,7,5,24,0,1,3,34,48,14,34,134,0,9,82,0,0,58,207,2,12,0,52,0,66,58,195,623
PUNJAB,BATALA,2003,34,24,3,61,13,0,13,26,12,9,3,24,0,3,1,40,60,20,40,164,0,7,82,1,4,128,285,6,6,0,28,0,40,63,200,715
PUNJAB,BHATINDA,2003,51,24,2,77,15,0,15,30,16,16,0,32,0,1,0,119,147,49,98,414,0,23,230,1,4,189,447,1,20,2,36,0,59,0,449,1330
PUNJAB,FARIDKOT,2003,12,8,2,22,10,0,10,20,7,5,2,14,0,3,2,44,55,26,29,159,0,7,99,3,3,94,206,2,8,0,49,0,59,0,153,561
PUNJAB,FATEHGARH SAHIB,2003,11,4,3,18,9,0,9,18,8,4,4,16,0,4,3,36,30,7,23,103,0,18,62,0,0,69,232,1,2,2,14,0,19,83,123,482
PUNJAB,FEROZEPUR,2003,51,65,5,121,30,0,30,60,20,11,9,40,2,1,5,158,250,101,149,666,0,29,143,2,6,476,736,7,32,0,34,0,73,80,513,1909
PUNJAB,G.R.P,2003,10,2,2,14,1,0,1,2,1,1,0,2,0,0,2,0,26,2,24,54,0,0,5,0,1,11,17,3,3,0,0,0,6,0,310,377
PUNJAB,GURDASPUR,2003,23,19,4,46,15,0,15,30,5,4,1,10,0,3,3,27,30,8,22,93,0,10,51,0,1,74,267,4,4,0,19,0,27,131,246,669
PUNJAB,HOSHIARPUR,2003,38,22,2,62,30,0,30,60,27,14,13,54,7,4,7,84,107,31,76,316,0,3,128,5,10,198,495,7,13,15,51,0,86,151,296,1205
PUNJAB,JAGRAON,2003,23,27,3,53,12,0,12,24,10,4,6,20,0,3,4,50,45,18,27,147,0,12,58,1,4,117,249,5,9,0,34,0,48,57,123,597
PUNJAB,JALANDHAR,2003,55,79,15,149,33,0,33,66,64,46,18,128,3,17,9,256,380,184,196,1045,0,10,507,5,4,370,1067,13,27,0,107,0,147,171,894,3019
PUNJAB,KAPURTHALA,2003,22,14,3,39,11,0,11,22,11,5,6,22,0,8,4,57,64,32,32,197,0,7,227,2,1,111,433,2,3,0,37,0,42,85,218,887
PUNJAB,KHANNA,2003,18,15,0,33,7,0,7,14,10,3,7,20,2,7,2,48,52,13,39,163,0,7,44,5,1,104,254,2,7,0,14,0,23,93,174,612
PUNJAB,LUDHIANA,2003,64,66,5,135,38,0,38,76,85,47,38,170,1,20,13,350,756,364,392,1896,0,49,351,9,9,270,894,8,72,175,116,0,371,206,2000,4663
PUNJAB,MAJITHA,2003,42,20,3,65,12,0,12,24,12,10,2,24,0,4,0,28,57,9,48,146,0,6,67,0,3,175,337,3,15,0,29,0,47,86,207,769
PUNJAB,MANSA,2003,17,22,2,41,11,0,11,22,7,6,1,14,1,1,3,35,53,11,42,146,0,12,44,0,1,133,191,6,8,0,12,0,26,1,177,546
PUNJAB,MOGA,2003,27,27,4,58,9,0,9,18,14,8,6,28,2,1,7,69,102,43,59,283,0,45,68,3,1,194,363,3,16,0,17,0,36,52,171,832
PUNJAB,MUKTSAR,2003,15,26,2,43,9,0,9,18,6,3,3,12,3,2,3,40,37,13,24,122,0,13,54,3,0,108,226,1,12,0,10,0,23,48,114,506
PUNJAB,NAWAN SHAHR,2003,15,25,0,40,14,0,14,28,15,10,5,30,0,1,4,64,85,24,61,239,0,0,81,3,9,200,362,1,5,0,32,0,38,69,114,737
PUNJAB,PATIALA,2003,49,32,7,88,33,0,33,66,36,30,6,72,4,13,5,221,325,166,159,893,0,15,257,1,0,421,1017,6,28,0,138,0,172,323,1035,2949
PUNJAB,ROPAR,2003,24,14,2,40,10,0,10,20,19,9,10,38,2,4,2,91,122,58,64,343,0,6,136,0,3,140,506,8,14,3,41,0,66,221,558,1420
PUNJAB,SANGRUR,2003,33,35,9,77,19,0,19,38,18,14,4,36,3,4,8,114,154,70,84,437,0,30,107,3,4,188,448,12,14,2,56,0,84,116,399,1328
PUNJAB,TARN TARAN,2003,32,20,5,57,13,0,13,26,11,4,7,22,0,5,2,27,52,14,38,138,0,5,33,4,0,119,223,3,7,0,11,0,21,62,187,598
RAJASTHAN,AJMER,2003,47,61,3,111,36,0,36,72,100,95,5,200,1,2,48,372,736,288,448,1895,57,36,311,4,15,709,1477,17,75,0,284,0,376,345,3101,6360
RAJASTHAN,ALWAR,2003,80,134,0,214,50,0,50,100,81,60,21,162,2,2,40,222,1121,387,734,2508,11,20,328,7,40,2217,2891,42,114,0,274,0,430,268,2065,7118
RAJASTHAN,BANSWARA,2003,35,26,0,61,53,0,53,106,54,51,3,108,4,0,12,96,128,26,102,368,259,6,42,0,31,1385,1812,3,89,2,100,0,194,89,757,3171
RAJASTHAN,BARAN,2003,25,90,2,117,50,0,50,100,66,66,0,132,0,3,18,157,398,72,326,974,46,15,138,1,22,280,556,3,175,10,187,0,375,54,1746,3486
RAJASTHAN,BARMER,2003,16,16,2,34,16,0,16,32,26,15,11,52,0,0,12,110,196,69,127,514,25,8,95,3,19,651,911,17,72,0,63,0,152,110,967,2424
RAJASTHAN,BHARATPUR,2003,91,92,3,186,41,0,41,82,105,68,37,210,1,8,40,81,841,234,607,1812,3,68,297,0,41,1219,1816,30,55,0,228,0,313,188,3759,7191
RAJASTHAN,BHILWARA,2003,24,56,0,80,42,0,42,84,148,112,36,296,1,1,48,262,815,280,535,1942,159,22,272,1,23,128,829,6,111,0,286,0,403,224,3261,5890
RAJASTHAN,BIKANER,2003,50,88,0,138,27,0,27,54,41,28,13,82,0,1,12,125,352,98,254,842,4,35,196,0,14,639,1022,14,50,0,164,0,228,134,1566,3512
RAJASTHAN,BUNDI,2003,28,100,3,131,42,0,42,84,69,49,20,138,1,1,21,179,364,87,277,930,71,17,77,2,17,873,1137,4,152,0,198,0,354,80,1349,3648
RAJASTHAN,CHITTORGARH,2003,50,48,6,104,78,0,78,156,191,164,27,382,2,6,39,329,657,177,480,1690,244,18,265,3,43,2320,3066,6,99,3,379,0,487,173,1615,6574
RAJASTHAN,CHURU,2003,29,34,1,64,22,0,22,44,29,14,15,58,2,0,1,99,243,27,216,588,75,15,228,0,11,985,1386,15,76,1,173,0,265,72,755,2866
RAJASTHAN,DAUSA,2003,33,17,0,50,17,0,17,34,40,21,19,80,2,1,5,82,411,178,233,912,82,20,116,0,17,76,472,3,20,0,61,0,84,161,2318,3482
RAJASTHAN,DHOLPUR,2003,40,67,1,108,20,0,20,40,32,27,5,64,1,3,17,68,226,58,168,541,71,9,52,2,15,1036,1266,21,36,0,92,0,149,81,640,2530
RAJASTHAN,DUNGARPUR,2003,30,20,2,52,15,0,15,30,29,29,0,58,0,0,9,59,55,21,34,178,105,7,39,0,24,140,403,10,50,1,54,0,115,88,1148,1885
RAJASTHAN,G.R.P.,2003,5,8,1,14,0,0,0,0,3,0,3,6,6,1,8,3,536,8,528,1090,2,3,4,1,0,2,13,2,12,2,0,0,16,1,258,858
RAJASTHAN,GANGANAGAR,2003,59,143,0,202,75,0,75,150,51,47,4,102,0,1,11,230,389,131,258,1020,10,46,531,2,9,1215,1943,16,69,0,352,0,437,130,1897,5236
RAJASTHAN,HANUMANGARH,2003,59,92,1,152,56,0,56,112,32,24,8,64,1,0,15,161,377,69,308,931,44,12,252,1,7,645,1063,18,93,1,254,0,366,102,1595,3818
RAJASTHAN,JAIPUR,2003,92,114,7,213,57,0,57,114,226,187,39,452,4,1,51,970,3161,1312,1849,7348,1459,226,1357,18,54,1565,5473,32,188,0,482,0,702,794,7900,18758
RAJASTHAN,JAISALMER,2003,3,0,0,3,3,0,3,6,10,6,4,20,0,0,3,32,120,16,104,275,13,1,25,0,8,3,80,4,16,0,13,0,33,30,412,696
RAJASTHAN,JALORE,2003,22,21,1,44,6,0,6,12,36,30,6,72,0,0,8,69,147,27,120,371,13,7,87,1,25,51,247,7,72,0,75,0,154,63,1693,2404
RAJASTHAN,JHALAWAR,2003,32,81,7,120,50,0,50,100,69,51,18,138,1,0,31,156,325,90,235,838,142,4,73,2,42,1107,1454,11,141,1,191,0,344,84,712,3262
RAJASTHAN,JHUNJHUNU,2003,41,10,0,51,27,0,27,54,47,33,14,94,0,0,6,122,269,58,211,666,87,20,125,1,20,191,543,7,50,0,102,0,159,99,2383,3607
RAJASTHAN,JODHPUR,2003,39,68,5,112,34,0,34,68,96,62,34,192,0,2,25,375,1011,490,521,2424,101,75,511,1,46,2318,3304,15,96,4,282,0,397,252,1468,6824
RAJASTHAN,KARAULI,2003,28,27,0,55,34,0,34,68,76,50,26,152,1,0,10,30,267,52,215,575,23,9,97,0,26,361,580,13,80,0,73,0,166,64,1998,3217
RAJASTHAN,KOTA,2003,35,292,0,327,35,0,35,70,134,115,19,268,0,1,41,324,987,510,477,2340,57,38,365,4,21,459,1104,9,146,2,307,0,464,160,2613,6030
RAJASTHAN,NAGAUR,2003,45,30,0,75,32,0,32,64,40,27,13,80,2,0,10,268,399,106,293,1078,15,14,173,0,23,349,715,10,115,0,128,0,253,141,2682,4476
RAJASTHAN,PALI,2003,38,54,4,96,27,0,27,54,80,65,15,160,1,0,29,233,318,95,223,899,78,36,184,0,36,42,584,9,184,1,190,0,384,208,3217,4969
RAJASTHAN,RAJSAMAND,2003,21,3,0,24,12,0,12,24,58,53,5,116,0,1,8,87,166,64,102,428,122,6,103,2,17,1304,1695,2,32,2,106,0,142,141,446,2639
RAJASTHAN,SAWAI MADHOPUR,2003,24,32,1,57,21,0,21,42,42,27,15,84,1,0,12,110,303,105,198,729,20,14,154,0,12,31,272,10,56,0,112,0,178,41,2102,3098
RAJASTHAN,SIKAR,2003,33,20,1,54,15,0,15,30,41,22,19,82,0,0,4,179,276,58,218,735,159,12,188,0,29,327,892,17,44,0,111,0,172,177,1919,3552
RAJASTHAN,SIROHI,2003,27,29,0,56,11,0,11,22,35,32,3,70,0,2,10,113,140,41,99,405,19,25,56,1,25,565,798,6,37,0,97,0,140,107,750,2055
RAJASTHAN,TONK,2003,20,27,5,52,11,0,11,22,60,48,12,120,0,0,13,145,291,79,212,740,182,20,139,0,10,1274,1761,5,45,1,179,1,231,136,1273,3837
RAJASTHAN,UDAIPUR,2003,61,77,5,143,35,0,35,70,91,72,19,182,2,4,38,224,431,178,253,1130,294,38,345,1,42,1706,2703,5,65,2,136,0,208,277,2227,6106
SIKKIM,EAST,2003,7,4,1,12,5,0,5,10,0,0,0,0,0,0,3,33,41,3,38,118,5,7,10,2,1,31,65,0,11,0,1,0,12,9,109,280
SIKKIM,NORTH,2003,1,0,0,1,2,0,2,4,0,0,0,0,0,0,0,3,2,0,2,7,0,0,0,0,0,0,0,0,0,0,0,0,0,0,6,14
SIKKIM,SOUTH,2003,3,1,1,5,1,0,1,2,0,0,0,0,1,0,0,8,19,0,19,47,1,0,1,0,1,12,21,0,6,0,0,0,6,6,30,91
SIKKIM,WEST,2003,3,2,1,6,2,0,2,4,0,0,0,0,1,0,0,4,3,0,3,11,4,0,1,1,0,13,22,0,8,0,0,0,8,3,12,58
TAMIL NADU,CHENGAI,2003,84,75,0,159,17,0,17,34,39,33,6,78,4,20,25,477,1170,223,947,2866,82,17,94,2,17,999,1801,15,100,62,78,0,255,590,7112,11079
TAMIL NADU,CHENNAI,2003,71,279,4,354,38,1,37,76,34,0,34,68,6,0,74,649,3779,959,2820,8287,43,19,627,8,1,749,1994,18,90,212,159,0,479,547,1173,8580
TAMIL NADU,CHENNAI RLY.,2003,0,1,0,1,0,0,0,0,0,0,0,0,2,0,15,0,199,3,196,415,3,2,2,0,0,32,44,0,4,2,0,0,6,5,307,574
TAMIL NADU,COIMBATORE RURAL,2003,72,61,1,134,16,0,16,32,19,14,5,38,6,1,35,265,1146,392,754,2599,321,38,71,3,20,1027,2205,17,79,29,97,0,222,725,5208,9257
TAMIL NADU,COIMBATORE URBAN,2003,22,17,0,39,4,0,4,8,6,1,5,12,3,0,29,173,993,374,619,2191,106,27,69,3,1,115,480,1,18,6,24,0,49,159,1411,3187
TAMIL NADU,CUDDALORE,2003,62,87,2,151,19,0,19,38,21,10,11,42,5,0,19,121,494,155,339,1133,113,2,14,1,59,581,1133,10,73,18,35,0,136,363,3999,6098
TAMIL NADU,DHARMAPURI,2003,90,58,2,150,23,0,23,46,41,34,7,82,7,0,19,152,332,131,201,842,374,17,38,1,54,1205,2016,16,91,11,36,0,154,327,3205,6099
TAMIL NADU,DINDIGUL,2003,62,35,0,97,18,0,18,36,23,14,9,46,4,0,22,118,467,153,314,1078,51,15,47,1,32,497,949,3,51,2,30,0,86,306,3236,5020
TAMIL NADU,ERODE,2003,53,18,2,73,11,0,11,22,46,33,13,92,2,0,23,194,676,245,431,1571,40,9,36,4,26,2210,2783,2,60,10,50,0,122,458,2122,6052
TAMIL NADU,KANCHIPURAM,2003,48,62,0,110,31,0,31,62,16,16,0,32,3,0,3,131,471,92,379,1079,75,0,31,0,4,447,1104,11,57,60,23,0,151,547,3067,5087
TAMIL NADU,KANYAKUMARI,2003,38,36,3,77,11,0,11,22,9,9,0,18,4,0,7,188,232,33,199,663,6,9,46,4,42,479,742,4,22,33,50,0,109,156,2123,3502
TAMIL NADU,KARUR,2003,26,14,0,40,3,0,3,6,13,10,3,26,3,0,3,62,296,94,202,660,15,3,11,0,10,800,1040,2,5,4,24,0,35,201,919,2414
TAMIL NADU,MADURAI RURAL,2003,48,73,1,122,22,0,22,44,31,24,7,62,6,16,50,115,383,51,332,953,173,7,61,1,21,1868,2431,13,58,8,63,0,142,300,792,4110
TAMIL NADU,MADURAI URBAN,2003,27,39,1,67,7,0,7,14,24,16,8,48,5,0,12,83,468,82,386,1036,64,5,115,2,6,224,500,10,29,49,35,0,123,84,1964,3253
TAMIL NADU,NAGAPATTINAM,2003,41,57,0,98,5,0,5,10,24,19,5,48,2,0,5,82,259,48,211,607,40,1,16,0,27,1300,1496,8,50,4,25,0,87,112,1578,3636
TAMIL NADU,NAMAKKAL,2003,31,24,0,55,7,0,7,14,22,22,0,44,1,0,8,56,257,117,140,579,67,2,18,0,14,1146,1511,6,54,20,41,0,121,264,1520,3558
TAMIL NADU,NILGIRIS,2003,18,17,0,35,9,0,9,18,3,2,1,6,0,0,3,93,144,26,118,384,26,3,10,1,0,280,348,0,39,4,0,0,43,28,921,1599
TAMIL NADU,PERAMBALUR,2003,31,56,1,88,13,0,13,26,36,26,10,72,0,0,1,58,204,97,107,467,57,6,15,2,17,740,954,3,65,10,42,0,120,117,964,2438
TAMIL NADU,PUDUKOTTAI,2003,32,21,0,53,8,0,8,16,21,14,7,42,1,0,7,67,185,56,129,445,162,13,15,3,23,282,644,2,52,5,28,0,87,146,2189,3262
TAMIL NADU,RAMNATHAPURAM,2003,26,23,0,49,10,0,10,20,15,10,5,30,0,0,5,59,217,34,183,498,158,8,20,0,25,511,830,3,49,6,45,0,103,108,1671,2959
TAMIL NADU,SALEM RURAL,2003,78,123,2,203,35,0,35,70,69,62,7,138,9,4,14,138,357,109,248,879,306,4,52,2,36,2813,3547,10,167,9,151,0,337,334,1597,6310
TAMIL NADU,SALEM URBAN,2003,15,18,0,33,11,0,11,22,9,8,1,18,3,2,2,51,337,144,193,732,14,1,25,1,2,149,302,3,11,13,13,0,40,110,1280,2070
TAMIL NADU,SIVAGANGAI,2003,24,33,1,58,4,0,4,8,25,19,6,50,0,0,3,67,231,38,193,532,41,8,31,1,14,337,580,4,17,7,34,0,62,148,1691,2721
TAMIL NADU,THANJAVUR,2003,60,78,0,138,14,0,14,28,53,22,31,106,2,0,8,151,452,101,351,1065,99,3,18,1,21,688,1102,1,100,14,33,0,148,272,1917,3985
TAMIL NADU,THENI,2003,35,47,0,82,6,0,6,12,7,5,2,14,2,0,14,69,246,45,201,577,104,6,51,0,19,586,912,4,53,7,25,0,89,146,1627,3054
TAMIL NADU,THIRUNELVELI RURAL,2003,54,76,0,130,43,0,43,86,30,27,3,60,0,0,10,150,439,42,397,1038,2,8,34,3,65,1445,1781,11,122,28,41,0,202,224,3582,6367
TAMIL NADU,THIRUNELVELI URBAN,2003,12,38,0,50,4,0,4,8,10,10,0,20,1,0,9,39,124,14,110,297,40,6,14,0,4,68,200,0,11,18,21,0,50,68,578,1065
TAMIL NADU,THIRUVALLUR,2003,25,47,0,72,14,0,14,28,23,23,0,46,3,0,8,71,279,15,264,640,140,15,20,1,24,1232,1645,8,70,13,28,0,119,213,950,3184
TAMIL NADU,THIRUVANNAMALAI,2003,38,17,1,56,25,0,25,50,26,20,6,52,0,0,10,138,358,57,301,864,146,9,28,1,33,1185,1612,6,37,8,22,0,73,210,1651,3949
TAMIL NADU,THIRUVARUR,2003,14,38,2,54,9,0,9,18,11,8,3,22,0,0,5,75,242,49,193,564,70,0,12,0,30,891,1091,2,71,9,19,0,101,88,1188,2776
TAMIL NADU,THOOTHUGUDI,2003,76,104,1,181,21,0,21,42,35,22,13,70,3,0,20,154,550,49,501,1277,205,12,64,3,40,626,1147,5,76,51,54,0,186,197,3056,5353
TAMIL NADU,TRICHY RLY.,2003,0,0,1,1,0,0,0,0,0,0,0,0,0,0,0,3,47,1,46,97,4,0,2,0,0,16,26,0,0,1,0,0,1,4,99,177
TAMIL NADU,TRICHY RURAL,2003,44,39,0,83,7,0,7,14,9,9,0,18,3,0,9,59,229,78,151,529,84,1,19,3,14,826,1217,7,16,4,44,1,72,270,1349,3037
TAMIL NADU,TRICHY URBAN,2003,17,11,0,28,6,0,6,12,14,7,7,28,1,0,5,62,449,99,350,966,10,1,51,2,3,86,284,0,5,41,44,0,90,131,1531,2470
TAMIL NADU,VELLORE,2003,87,30,0,117,20,0,20,40,42,23,19,84,0,0,5,179,591,128,463,1366,84,9,43,5,24,2431,2979,6,43,32,17,0,98,383,3323,7354
TAMIL NADU,VILLUPURAM,2003,77,54,3,134,39,0,39,78,52,40,12,104,2,0,14,159,412,162,250,999,318,17,23,2,38,726,1676,6,100,29,62,0,197,552,4050,6735
TAMIL NADU,VIRUDHUNAGAR,2003,53,37,0,90,27,0,27,54,21,20,1,42,2,0,13,141,498,85,413,1152,63,4,61,2,25,631,1005,3,77,42,62,0,184,219,2834,4815
TRIPURA,DHALAI,2003,40,22,0,62,5,0,5,10,36,2,34,72,4,0,14,16,13,0,13,60,35,0,4,1,12,50,126,2,8,0,10,0,20,24,234,530
TRIPURA,NORTH,2003,40,15,0,55,36,0,36,72,35,4,31,70,8,0,27,27,54,2,52,170,30,1,5,0,10,99,175,3,38,0,75,0,116,30,186,719
TRIPURA,SOUTH,2003,38,20,0,58,37,0,37,74,18,7,11,36,6,0,12,43,53,2,51,167,81,2,10,2,26,143,290,3,54,0,73,0,130,26,250,897
TRIPURA,WEST,2003,136,30,0,166,36,0,36,72,57,16,41,114,18,0,16,81,156,6,150,427,128,0,6,0,35,242,440,12,27,0,89,0,128,29,270,1368
UTTAR PRADESH,AGRA,2003,126,116,34,276,27,0,27,54,99,73,26,198,22,1,60,203,724,417,307,1734,140,83,122,21,12,360,778,55,59,55,183,0,352,40,896,3438
UTTAR PRADESH,ALIGARH,2003,156,167,42,365,24,0,24,48,92,60,32,184,11,6,83,93,454,174,280,1101,105,51,77,2,71,236,655,33,27,14,108,0,182,113,360,2325
UTTAR PRADESH,ALLAHABAD,2003,119,97,39,255,21,0,21,42,57,19,38,114,13,0,44,160,359,168,191,935,84,56,104,4,14,256,738,40,12,27,77,0,156,220,709,2512
UTTAR PRADESH,AMBEDKAR NAGAR,2003,12,22,14,48,7,0,7,14,15,15,0,30,0,1,10,24,59,12,47,153,8,16,13,0,3,30,92,10,6,7,16,0,39,22,111,406
UTTAR PRADESH,AURAIYA,2003,32,16,17,65,4,0,4,8,24,10,14,48,4,0,4,20,43,10,33,114,7,4,50,0,1,93,243,16,11,24,13,0,64,88,274,745
UTTAR PRADESH,AZAMGARH,2003,89,62,21,172,6,0,6,12,26,23,3,52,3,1,76,76,116,34,82,388,54,24,67,5,0,242,430,16,18,39,45,0,118,38,380,1404
UTTAR PRADESH,BADAUN,2003,182,137,34,353,31,0,31,62,73,40,33,146,9,3,47,76,175,22,153,485,28,28,28,1,20,205,316,28,29,89,15,0,161,6,590,1834
UTTAR PRADESH,BAGHPAT,2003,81,33,4,118,12,0,12,24,17,14,3,34,4,5,31,15,85,23,62,225,13,7,20,0,3,21,94,10,9,45,23,0,87,30,222,690
UTTAR PRADESH,BAHRAICH,2003,41,21,24,86,5,0,5,10,12,8,4,24,3,11,12,38,47,11,36,158,12,16,23,2,7,118,202,7,8,271,17,0,303,24,425,1144
UTTAR PRADESH,BALLIA,2003,32,36,32,100,2,0,2,4,5,3,2,10,2,3,7,38,81,24,57,212,40,7,10,2,4,65,171,8,8,25,8,0,49,43,194,652
UTTAR PRADESH,BALRAMPUR,2003,15,4,7,26,3,0,3,6,7,4,3,14,0,1,2,18,24,3,21,69,6,7,11,1,0,19,54,3,1,45,6,0,55,10,65,255
UTTAR PRADESH,BANDA,2003,49,23,12,84,10,0,10,20,10,6,4,20,0,0,9,24,49,6,43,131,21,17,52,1,4,64,159,13,15,17,10,0,55,0,346,746
UTTAR PRADESH,BARABANKI,2003,55,33,15,103,12,0,12,24,26,19,7,52,5,6,32,67,114,15,99,338,15,39,23,0,2,119,275,16,11,50,27,0,104,77,289,1033
UTTAR PRADESH,BAREILLY,2003,194,122,40,356,32,0,32,64,70,47,23,140,16,0,44,107,333,121,212,833,48,40,91,4,2,310,501,37,27,78,84,0,226,6,860,2545
UTTAR PRADESH,BASTI,2003,38,40,17,95,5,0,5,10,11,11,0,22,7,6,14,35,76,24,52,214,34,10,31,2,4,102,185,14,9,161,15,0,199,2,600,1233
UTTAR PRADESH,BIJNOR,2003,81,35,17,133,20,0,20,40,33,23,10,66,4,2,28,50,150,45,105,384,29,14,47,1,4,60,247,24,23,254,50,0,351,92,851,1869
UTTAR PRADESH,BULANDSHAHAR,2003,144,98,29,271,13,0,13,26,36,30,6,72,7,6,37,51,324,117,207,749,33,26,52,3,1,134,366,25,26,98,105,0,254,117,505,1870
UTTAR PRADESH,CHANDOLI,2003,30,16,5,51,3,0,3,6,5,2,3,10,0,0,7,17,52,22,30,128,3,11,18,0,2,56,93,11,5,14,3,0,33,3,129,390
UTTAR PRADESH,CHITRAKOOT DHAM,2003,30,7,7,44,10,0,10,20,13,0,13,26,0,1,3,14,15,4,11,48,6,4,1,0,2,55,101,6,7,0,7,0,20,33,78,299
UTTAR PRADESH,DEORIA,2003,34,43,26,103,3,0,3,6,14,12,2,28,3,0,14,42,67,14,53,193,63,13,19,2,5,106,283,21,7,9,14,0,51,75,264,844
UTTAR PRADESH,ETAH,2003,137,141,26,304,18,0,18,36,55,23,32,110,7,0,42,52,131,43,88,363,33,25,36,1,0,220,318,38,19,15,37,0,109,3,519,1555
UTTAR PRADESH,ETAWAH,2003,44,44,9,97,2,0,2,4,30,9,21,60,4,0,17,43,92,38,54,248,15,14,46,1,6,54,259,16,12,6,18,0,52,123,212,808
UTTAR PRADESH,FAIZABAD,2003,31,26,15,72,10,0,10,20,11,11,0,22,3,0,6,35,59,12,47,162,10,41,0,4,5,151,279,4,6,42,2,0,54,68,175,704
UTTAR PRADESH,FATEHGARH,2003,72,42,18,132,7,0,7,14,17,9,8,34,2,3,11,35,66,23,43,183,4,13,22,2,0,44,139,18,9,68,19,0,114,54,325,851
UTTAR PRADESH,FATEHPUR,2003,73,31,35,139,3,0,3,6,20,14,6,40,1,0,14,33,62,19,43,172,13,18,26,0,0,109,300,24,4,19,15,0,62,134,279,913
UTTAR PRADESH,FIROZABAD,2003,95,89,25,209,12,0,12,24,63,32,31,126,4,2,48,36,186,83,103,462,44,29,37,2,8,253,377,30,33,89,51,0,203,4,575,1715
UTTAR PRADESH,G.R.P.,2003,19,12,4,35,3,0,3,6,3,1,2,6,13,3,48,1,2487,79,2408,5039,8,21,40,5,0,5,80,0,6,24,0,0,30,1,575,3278
UTTAR PRADESH,GAUTAMBUDH NAGAR,2003,66,44,9,119,10,0,10,20,27,19,8,54,8,1,22,38,425,239,186,919,28,17,47,2,1,11,269,14,13,19,23,0,69,163,97,1085
UTTAR PRADESH,GHAZIABAD,2003,176,110,40,326,15,0,15,30,73,49,24,146,3,2,52,122,931,511,420,2041,27,64,108,27,3,66,320,17,18,65,97,0,197,25,586,2627
UTTAR PRADESH,GHAZIPUR,2003,48,37,18,103,2,0,2,4,8,8,0,16,0,0,12,52,62,9,53,188,23,0,16,5,4,95,165,11,3,24,24,0,62,22,193,659
UTTAR PRADESH,GONDA,2003,21,22,21,64,5,0,5,10,10,8,2,20,4,0,11,49,54,16,38,172,27,7,15,1,0,50,121,16,3,215,4,0,238,21,356,912
UTTAR PRADESH,GORAKHPUR,2003,82,64,39,185,13,0,13,26,37,32,5,74,1,1,42,136,215,95,120,610,78,45,71,13,0,169,534,18,22,25,36,0,101,158,425,1690
UTTAR PRADESH,HAMIRPUR,2003,36,13,26,75,10,0,10,20,7,4,3,14,1,0,3,11,41,10,31,97,7,7,9,0,0,30,53,12,15,5,2,0,34,0,130,365
UTTAR PRADESH,HARDOI,2003,101,72,27,200,24,0,24,48,38,31,7,76,2,1,34,40,129,19,110,335,21,29,49,0,15,269,483,18,30,83,37,0,168,100,327,1446
UTTAR PRADESH,HATHRAS,2003,52,76,9,137,21,0,21,42,38,23,15,76,16,6,55,39,141,41,100,398,75,29,55,1,0,89,249,10,19,21,74,0,124,0,561,1387
UTTAR PRADESH,J.P.NAGAR,2003,62,28,11,101,6,0,6,12,20,14,6,40,3,8,22,44,86,20,66,249,22,9,30,1,0,44,117,13,4,121,24,0,162,11,497,1066
UTTAR PRADESH,JALAUN,2003,68,23,13,104,6,0,6,12,23,8,15,46,3,1,11,9,75,21,54,174,10,11,21,0,0,4,132,22,11,13,15,0,61,86,309,734
UTTAR PRADESH,JAUNPUR,2003,33,32,31,96,4,0,4,8,16,13,3,32,3,0,21,57,100,38,62,281,19,17,47,7,5,65,250,22,6,45,29,0,102,90,459,1108
UTTAR PRADESH,JHANSI,2003,54,23,14,91,4,0,4,8,20,8,12,40,1,5,21,61,123,54,69,334,35,12,25,0,0,84,156,8,4,209,5,0,226,0,808,1516
UTTAR PRADESH,KANNAUJ,2003,64,38,16,118,4,0,4,8,29,22,7,58,2,0,11,33,48,6,42,142,12,16,19,2,0,2,51,16,14,28,29,0,87,0,487,870
UTTAR PRADESH,KANPUR DEHAT,2003,37,22,27,86,6,0,6,12,26,20,6,52,5,4,16,21,107,9,98,260,20,14,9,1,5,135,302,22,15,118,19,0,174,118,471,1218
UTTAR PRADESH,KANPUR NAGAR,2003,187,107,38,332,24,0,24,48,84,57,27,168,7,6,67,167,830,588,242,1907,61,71,117,9,7,328,853,43,40,147,94,0,324,260,537,3231
UTTAR PRADESH,KAUSHAMBI,2003,56,19,11,86,17,0,17,34,8,4,4,16,0,0,11,30,45,9,36,131,11,6,15,0,4,87,193,16,7,9,5,0,37,70,76,503
UTTAR PRADESH,KHIRI,2003,99,89,31,219,28,0,28,56,48,40,8,96,4,39,32,55,173,38,135,476,36,20,50,2,1,257,371,35,30,213,60,0,338,5,801,2108
UTTAR PRADESH,KUSHI NAGAR,2003,37,17,18,72,5,0,5,10,18,9,9,36,3,3,6,32,70,19,51,184,38,15,33,1,6,106,276,12,11,97,14,0,134,77,112,731
UTTAR PRADESH,LALITPUR,2003,12,5,8,25,5,0,5,10,5,4,1,10,0,0,2,10,23,9,14,58,11,2,8,0,0,61,107,5,4,60,3,0,72,25,95,344
UTTAR PRADESH,LUCKNOW,2003,176,100,34,310,38,0,38,76,118,98,20,236,10,3,114,420,1753,768,985,4053,108,168,300,13,8,78,973,29,63,302,216,0,610,298,2457,6806
UTTAR PRADESH,MAHARAJGANJ,2003,28,16,24,68,4,0,4,8,13,10,3,26,2,1,11,27,30,11,19,101,30,19,19,8,4,52,133,4,7,56,2,0,69,1,321,679
UTTAR PRADESH,MAHOBA,2003,32,19,10,61,2,0,2,4,7,5,2,14,0,0,10,15,38,8,30,101,10,6,14,0,3,25,74,9,13,7,3,0,32,16,147,386
UTTAR PRADESH,MAINPURI,2003,108,85,31,224,7,0,7,14,30,19,11,60,9,1,31,26,96,28,68,259,28,21,29,4,1,162,335,31,10,6,13,0,60,90,254,1073
UTTAR PRADESH,MATHURA,2003,94,103,19,216,16,0,16,32,36,26,10,72,4,0,46,61,293,188,105,697,56,36,50,1,6,66,400,18,21,36,65,0,140,185,308,1520
UTTAR PRADESH,MAU,2003,38,55,13,106,5,0,5,10,11,10,1,22,2,2,29,69,65,17,48,232,31,30,16,3,4,54,186,9,10,69,10,0,98,48,172,745
UTTAR PRADESH,MEERUT,2003,193,139,21,353,40,0,40,80,85,55,30,170,9,13,87,158,665,316,349,1597,91,63,89,11,5,32,505,31,31,165,199,0,426,214,364,2705
UTTAR PRADESH,MIRZAPUR,2003,31,27,11,69,6,0,6,12,11,6,5,22,4,0,13,45,68,20,48,198,8,9,16,0,0,44,100,12,6,4,8,0,30,23,198,544
UTTAR PRADESH,MORADABAD,2003,156,86,34,276,43,0,43,86,63,43,20,126,12,16,51,92,313,128,185,797,39,48,83,4,2,40,288,24,25,158,112,0,319,72,564,2037
UTTAR PRADESH,MUZAFFARNAGAR,2003,186,107,46,339,32,0,32,64,74,36,38,148,9,0,98,59,346,173,173,858,66,36,28,3,0,12,222,29,23,205,73,0,330,77,976,2485
UTTAR PRADESH,PILIBHIT,2003,63,62,14,139,21,0,21,42,36,20,16,72,6,2,18,28,132,28,104,318,22,6,34,0,0,8,109,13,9,137,0,0,159,39,531,1181
UTTAR PRADESH,PRATAPGARH,2003,44,39,19,102,9,0,9,18,22,19,3,44,1,0,13,45,79,23,56,217,34,32,56,0,0,193,318,24,7,12,38,0,81,3,331,1001
UTTAR PRADESH,RAIBAREILLY,2003,69,48,28,145,20,0,20,40,27,25,2,54,4,2,19,64,153,19,134,395,25,14,16,0,14,237,418,16,36,102,38,0,192,112,401,1445
UTTAR PRADESH,RAMPUR,2003,63,49,17,129,13,0,13,26,24,21,3,48,8,4,15,40,126,28,98,319,20,21,38,1,1,46,186,12,12,7,5,0,36,59,568,1149
UTTAR PRADESH,SAHARANPUR,2003,82,99,36,217,17,0,17,34,63,50,13,126,2,1,37,50,230,114,116,550,58,41,129,2,0,39,269,10,17,70,77,0,174,0,563,1623
UTTAR PRADESH,SANT KABIRNAGAR,2003,19,12,4,35,0,0,0,0,5,4,1,10,0,0,6,12,23,2,21,64,19,12,12,2,2,72,150,10,5,43,10,0,68,31,79,378
UTTAR PRADESH,SHAHJAHANPUR,2003,162,118,36,316,17,0,17,34,65,60,5,130,4,0,39,50,162,49,113,417,12,17,19,10,0,126,251,28,17,63,11,0,119,67,423,1446
UTTAR PRADESH,SHRAWASTI,2003,15,6,12,33,3,0,3,6,4,4,0,8,0,1,3,16,18,0,18,56,3,6,6,0,0,52,67,4,2,18,5,0,29,0,63,237
UTTAR PRADESH,SIDHARTHNAGAR,2003,10,14,9,33,2,0,2,4,7,7,0,14,2,0,3,17,29,9,20,80,10,6,12,0,0,50,95,8,4,7,11,0,30,17,416,634
UTTAR PRADESH,SITAPUR,2003,129,64,46,239,47,0,47,94,58,40,18,116,1,0,32,69,287,48,239,676,42,27,23,0,10,258,468,50,53,36,37,0,176,108,528,1905
UTTAR PRADESH,SONBHADRA,2003,19,14,13,46,5,0,5,10,6,4,2,12,4,2,3,19,39,11,28,106,7,4,8,1,3,46,135,11,7,15,6,0,39,66,36,334
UTTAR PRADESH,ST.RAVIDASNAGAR,2003,18,9,6,33,2,0,2,4,2,1,1,4,1,0,7,31,42,13,29,123,6,4,7,3,0,47,82,5,2,3,9,0,19,15,66,285
UTTAR PRADESH,SULTANPUR,2003,62,56,21,139,18,0,18,36,22,19,3,44,2,0,33,76,151,23,128,413,15,36,36,1,1,196,339,19,10,81,38,0,148,54,321,1249
UTTAR PRADESH,UNNAO,2003,111,64,19,194,23,0,23,46,22,19,3,44,4,8,41,39,124,34,90,340,33,16,24,0,0,255,477,42,28,195,45,0,310,149,645,1887
UTTAR PRADESH,VARANASI,2003,74,48,27,149,7,0,7,14,18,7,11,36,4,2,28,79,381,233,148,875,41,43,37,21,2,131,302,21,4,71,33,0,129,27,582,1681
UTTARAKHAND,ALMORA,2003,15,5,2,22,1,0,1,2,1,1,0,2,1,0,9,23,47,5,42,127,6,6,15,0,1,53,96,9,6,4,5,0,24,15,30,254
UTTARAKHAND,BAGESHWAR,2003,11,4,0,15,4,0,4,8,0,0,0,0,0,0,8,0,17,1,16,42,1,2,0,0,1,0,7,2,3,0,0,0,5,3,46,102
UTTARAKHAND,CHAMOLI,2003,9,9,0,18,4,0,4,8,3,3,0,6,0,0,1,36,14,2,12,65,33,1,1,1,2,33,85,3,8,2,1,0,14,14,26,201
UTTARAKHAND,CHAMPAWAT,2003,7,6,2,15,1,0,1,2,3,3,0,6,2,0,2,9,14,0,14,41,3,1,3,1,0,13,27,2,5,0,4,0,11,6,39,123
UTTARAKHAND,DEHRADUN,2003,31,43,5,79,16,0,16,32,30,28,2,60,3,2,29,114,311,119,192,770,58,42,151,1,4,73,441,11,13,31,85,0,140,112,508,1673
UTTARAKHAND,HARIDWAR,2003,75,45,9,129,31,0,31,62,48,25,23,96,4,0,37,82,388,147,241,899,85,30,93,2,8,206,521,7,21,36,79,0,143,97,393,1776
UTTARAKHAND,NAINITAL,2003,31,30,1,62,9,0,9,18,16,14,2,32,2,1,18,80,190,42,148,481,34,20,18,1,2,35,174,12,15,3,30,0,60,64,263,875
UTTARAKHAND,PAURI GARHWAL,2003,15,15,0,30,7,0,7,14,14,14,0,28,1,0,13,55,61,15,46,191,26,9,6,0,3,80,157,13,9,0,17,0,39,33,74,451
UTTARAKHAND,PITHORAGARH,2003,5,9,3,17,3,0,3,6,2,0,2,4,1,0,5,25,26,5,21,83,14,6,6,0,2,10,38,6,7,0,1,0,14,0,174,305
UTTARAKHAND,RUDRA PRAYAG,2003,8,4,0,12,2,0,2,4,3,2,1,6,0,0,2,16,9,0,9,36,18,1,8,0,1,9,45,7,2,0,4,0,13,8,41,143
UTTARAKHAND,TEHRI GARHWAL,2003,9,23,1,33,6,0,6,12,4,4,0,8,0,0,0,32,31,4,27,94,30,5,10,0,2,50,101,6,10,0,10,0,26,4,84,317
UTTARAKHAND,UDHAMSINGH NAGAR,2003,46,41,6,93,14,0,14,28,40,34,6,80,12,0,33,60,232,59,173,569,58,15,58,2,0,118,257,15,29,20,75,0,139,6,546,1426
UTTARAKHAND,UTTARKASHI,2003,6,2,2,10,9,0,9,18,7,6,1,14,0,0,3,25,28,1,27,84,26,0,10,0,7,7,50,0,8,2,6,0,16,0,129,277
WEST BENGAL,24 PARGANAS NORTH,2003,193,30,50,273,92,0,92,184,119,103,16,238,29,0,73,29,1988,615,1373,4107,243,17,99,14,0,0,373,24,105,3,672,0,804,0,3571,7351
WEST BENGAL,24 PARGANAS SOUTH,2003,125,5,60,190,89,0,89,178,81,69,12,162,8,0,30,7,1034,253,781,2113,250,1,65,1,7,0,324,47,105,1,822,0,975,0,3818,6556
WEST BENGAL,ASANSOL,2003,28,5,5,38,8,0,8,16,11,11,0,22,2,73,9,8,75,15,60,242,37,1,20,1,0,100,223,4,19,1,128,0,152,64,728,1327
WEST BENGAL,BANKURA,2003,41,13,11,65,43,0,43,86,11,11,0,22,11,15,9,11,240,0,240,526,51,2,19,3,5,260,448,20,31,0,106,0,157,108,331,1341
WEST BENGAL,BIRBHUM,2003,51,13,25,89,48,0,48,96,35,30,5,70,4,31,16,10,230,60,170,521,174,8,12,3,17,59,453,13,51,0,164,0,228,180,701,1845
WEST BENGAL,BURDWAN,2003,98,9,25,132,61,0,61,122,33,33,0,66,8,97,25,17,370,41,329,887,169,3,48,2,10,99,507,26,51,0,301,1,379,176,1580,3209
WEST BENGAL,COOCHBEHAR,2003,24,8,17,49,53,0,53,106,40,34,6,80,3,4,5,9,135,22,113,291,35,3,13,2,0,103,224,11,60,0,176,0,247,68,422,1191
WEST BENGAL,DAKSHIN DINAJPUR,2003,22,12,12,46,31,0,31,62,32,32,0,64,3,35,5,3,84,16,68,214,18,0,4,1,2,51,147,8,40,1,104,0,153,71,331,870
WEST BENGAL,DARJEELING,2003,54,0,16,70,24,0,24,48,26,26,0,52,2,59,13,6,465,148,317,1010,15,0,16,4,4,165,284,3,20,0,58,0,81,80,690,1720
WEST BENGAL,HOOGHLY,2003,88,3,31,122,39,0,39,78,34,31,3,68,18,79,29,25,594,84,510,1339,318,15,43,0,6,212,791,14,25,0,383,0,422,197,878,3031
WEST BENGAL,HOWRAH,2003,25,6,15,46,9,0,9,18,11,8,3,22,3,32,10,2,107,46,61,261,47,10,29,2,0,99,187,12,7,0,59,0,78,0,628,1113
WEST BENGAL,HOWRAH CITY,2003,18,5,12,35,6,0,6,12,12,7,5,24,5,89,21,2,275,87,188,667,29,18,63,2,1,101,214,5,11,1,65,0,82,0,676,1417
WEST BENGAL,HOWRAH G.R.P.,2003,11,3,0,14,0,0,0,0,3,2,1,6,2,41,8,0,292,0,292,635,13,1,3,2,0,17,36,0,5,0,1,0,6,0,65,467
WEST BENGAL,JALPAIGURI,2003,108,32,56,196,60,0,60,120,29,23,6,58,7,22,22,7,474,86,388,1006,59,20,6,1,2,197,561,4,75,1,164,0,244,276,679,2301
WEST BENGAL,KHARAGPUR G.R.P.,2003,2,1,0,3,0,0,0,0,0,0,0,0,6,2,6,0,108,0,108,230,3,0,2,0,0,6,14,0,0,0,0,0,0,3,26,165
WEST BENGAL,KOLKATA,2003,52,123,13,188,36,0,36,72,108,85,23,216,33,60,173,144,3684,929,2755,7778,200,222,990,95,0,1225,3179,16,185,57,222,0,480,447,2629,10714
WEST BENGAL,MALDA,2003,48,49,20,117,57,0,57,114,24,20,4,48,5,16,18,10,247,42,205,543,46,7,12,10,0,72,298,4,67,1,99,0,171,151,784,1747
WEST BENGAL,MURSHIDABAD,2003,116,16,42,174,106,0,106,212,91,84,7,182,7,60,20,5,391,56,335,874,180,7,13,8,0,418,854,17,131,0,408,0,556,228,1203,3467
WEST BENGAL,NADIA,2003,93,0,7,100,108,0,108,216,59,59,0,118,16,41,14,16,658,0,658,1403,193,0,0,0,12,635,933,23,96,2,299,0,420,93,1155,3520
WEST BENGAL,PASCHIM MIDNAPUR,2003,77,58,27,162,50,0,50,100,45,45,0,90,30,51,36,21,358,33,325,854,245,27,35,2,11,68,388,18,31,2,338,0,389,0,1426,2956
WEST BENGAL,PURAB MIDNAPUR,2003,43,0,12,55,33,0,33,66,52,49,3,104,2,34,15,5,143,1,142,342,188,0,0,0,4,1,193,37,11,0,233,0,281,0,1153,1966
WEST BENGAL,PURULIA,2003,46,0,10,56,25,0,25,50,16,14,2,32,6,19,21,1,147,8,139,341,36,11,27,0,0,0,74,8,34,0,82,0,124,0,600,1089
WEST BENGAL,SEALDAH G.R.P.,2003,22,3,3,28,0,0,0,0,3,0,3,6,1,13,11,0,207,0,207,439,2,0,6,0,0,14,23,1,2,0,0,0,3,1,48,337
WEST BENGAL,SILIGURI G.R.P.,2003,6,0,0,6,0,0,0,0,2,2,0,4,1,0,3,0,89,0,89,182,7,0,1,0,0,0,8,0,1,0,0,0,1,0,37,147
WEST BENGAL,UTTAR DINAJPUR,2003,34,6,15,55,24,0,24,48,25,23,2,50,5,10,6,4,218,39,179,461,38,5,8,0,6,270,484,14,23,1,64,0,102,157,394,1327
A & N ISLANDS,ANDAMAN,2003,16,4,1,21,2,0,2,4,2,2,0,4,1,0,7,56,58,3,55,180,19,1,13,0,7,107,147,0,9,2,7,0,18,0,299,611
A & N ISLANDS,NICOBAR,2003,5,0,0,5,0,0,0,0,0,0,0,0,1,0,0,0,2,0,2,5,0,2,0,0,1,3,6,0,0,0,0,0,0,0,19,33
CHANDIGARH,CHANDIGARH,2003,21,15,2,38,18,0,18,36,32,28,4,64,3,1,12,204,1238,552,686,2696,46,32,209,2,4,71,372,1,11,4,93,0,109,8,779,2806
D & N HAVELI,D and N HAVELI,2003,11,5,0,16,1,0,1,2,7,4,3,14,4,0,6,41,61,15,46,173,17,8,13,2,4,22,67,0,4,0,2,0,6,1,129,338
DAMAN & DIU,DAMAN,2003,6,3,0,9,4,0,4,8,1,1,0,2,4,0,1,37,44,23,21,130,29,7,8,3,1,14,68,0,3,0,0,0,3,6,69,240
DAMAN & DIU,DIU,2003,0,0,0,0,1,0,1,2,0,0,0,0,0,0,0,4,2,2,0,8,2,1,0,3,0,0,6,1,0,0,0,0,1,0,15,29
DELHI UT,CENTRAL,2003,29,20,6,55,20,0,20,40,63,40,23,126,2,4,14,102,1187,490,697,2496,0,48,141,4,4,135,342,4,29,10,49,0,92,10,1117,2998
DELHI UT,EAST,2003,44,38,6,88,37,0,37,74,158,119,39,316,4,15,39,179,1757,927,830,3751,9,41,121,2,3,231,479,15,73,8,190,0,286,72,1289,4331
DELHI UT,G.R.P.(RLY),2003,8,4,2,14,0,0,0,0,6,5,1,12,0,2,14,0,1015,16,999,2046,2,6,20,0,4,10,45,3,4,0,0,0,7,3,65,1168
DELHI UT,I.G.I. AIRPORT,2003,2,2,0,4,0,0,0,0,2,1,1,4,0,0,4,0,74,11,63,152,3,1,491,1,0,7,504,0,5,1,0,0,6,1,74,668
DELHI UT,NEW DELHI,2003,7,5,1,13,8,0,8,16,24,16,8,48,1,2,16,58,863,312,551,1803,4,31,232,15,3,38,402,1,20,8,13,0,42,79,748,2177
DELHI UT,NORTH,2003,32,23,12,67,34,0,34,68,63,44,19,126,1,10,35,81,923,337,586,1973,7,45,147,6,9,155,369,4,16,8,55,0,83,0,1725,3391
DELHI UT,NORTH EAST,2003,54,64,5,123,53,0,53,106,182,133,49,364,4,21,56,130,796,459,337,1803,4,30,92,6,0,222,393,20,41,5,128,0,194,39,1173,3125
DELHI UT,NORTH WEST,2003,106,101,12,219,128,0,128,256,301,191,110,602,6,18,93,390,2191,1232,959,4889,7,52,162,3,10,305,584,27,102,14,290,0,433,45,4419,8782
DELHI UT,S.T.F.,2003,0,2,0,2,0,0,0,0,0,0,0,0,0,5,0,0,0,0,0,5,0,0,43,3,0,0,46,0,0,0,0,0,0,0,15,68
DELHI UT,SOUTH,2003,86,52,10,148,83,0,83,166,134,102,32,268,4,12,57,375,3307,1790,1517,7062,19,95,334,1,8,220,756,24,89,21,199,0,333,79,3231,8440
DELHI UT,SOUTH WEST,2003,45,45,5,95,57,0,57,114,118,73,45,236,3,4,60,368,1396,716,680,3227,21,47,157,0,12,148,406,22,52,26,119,0,219,21,2453,5179
DELHI UT,WEST,2003,72,51,6,129,70,0,70,140,105,73,32,210,3,14,53,215,2035,1155,880,4355,4,35,139,2,7,237,477,10,58,4,168,0,240,53,3736,7077
LAKSHADWEEP,LAKSHADWEEP,2003,0,0,0,0,2,0,2,4,0,0,0,0,0,0,0,6,8,1,7,22,4,0,0,0,2,1,7,0,1,0,1,0,2,0,6,31
PUDUCHERRY,PONDICHERRY,2003,29,32,0,61,2,0,2,4,18,13,5,36,2,0,11,126,567,295,272,1273,159,12,32,1,18,1053,1457,1,56,27,4,0,88,182,2185,4517
ANDHRA PRADESH,ADILABAD,2004,113,83,11,207,50,0,50,100,48,42,6,96,4,0,9,177,256,46,210,702,88,34,152,5,30,1266,1846,14,135,71,296,0,516,271,1898,5011
ANDHRA PRADESH,ANANTAPUR,2004,152,79,5,236,20,0,20,40,51,31,20,102,8,0,35,208,442,199,243,1135,143,24,119,2,51,1142,1780,11,196,50,147,0,404,299,1112,4296
ANDHRA PRADESH,CHITTOOR,2004,105,52,1,158,28,0,28,56,69,27,42,138,8,0,17,337,1055,221,834,2472,82,26,267,3,30,1065,3531,22,116,197,234,0,569,2058,1188,6960
ANDHRA PRADESH,CUDDAPAH,2004,96,58,0,154,14,0,14,28,39,31,8,78,3,0,5,111,275,68,207,669,74,16,120,1,37,1153,1718,7,118,49,120,0,294,317,1494,4107
ANDHRA PRADESH,CYBERABAD,2004,145,74,8,227,40,0,40,80,69,69,0,138,12,0,43,941,1697,405,1292,4390,32,29,647,6,21,2922,4445,43,106,85,517,0,751,788,1686,9911
ANDHRA PRADESH,EAST GODAVARI,2004,96,101,1,198,31,0,31,62,47,23,24,94,3,0,17,392,1106,171,935,2624,105,86,251,12,23,3023,3973,13,112,105,293,0,523,473,1451,7741
ANDHRA PRADESH,GUNTAKAL RLY.,2004,8,1,0,9,0,0,0,0,0,0,0,0,1,0,1,0,177,0,177,356,0,0,2,5,0,7,16,0,1,0,0,0,1,2,133,338
ANDHRA PRADESH,GUNTUR,2004,163,96,0,259,46,0,46,92,88,60,28,176,5,0,36,349,1479,110,1369,3348,133,44,405,9,58,1714,2800,32,186,104,397,0,719,437,2763,8544
ANDHRA PRADESH,HYDERABAD CITY,2004,121,135,1,257,56,0,56,112,136,62,74,272,11,2,71,1359,5735,2078,3657,12913,141,110,2160,19,37,4837,7786,29,144,206,1142,2,1523,482,1932,18868
ANDHRA PRADESH,KARIMNAGAR,2004,123,93,9,225,85,0,85,170,124,98,26,248,7,0,25,236,540,75,465,1348,184,55,444,12,64,2902,4021,61,370,155,717,0,1303,360,1482,8048
ANDHRA PRADESH,KHAMMAM,2004,108,52,4,164,43,0,43,86,70,46,24,140,6,0,23,242,482,85,397,1235,122,37,166,0,45,1136,1858,18,176,310,400,0,904,352,2136,5928
ANDHRA PRADESH,KRISHNA,2004,60,57,1,118,33,0,33,66,28,13,15,56,4,0,13,197,732,31,701,1678,53,16,162,8,31,2070,2583,13,182,108,362,0,665,243,1004,5377
ANDHRA PRADESH,KURNOOL,2004,112,96,3,211,29,0,29,58,46,32,14,92,5,0,15,179,328,101,227,855,125,22,221,6,48,1271,2050,6,242,157,230,0,635,357,1874,5372
ANDHRA PRADESH,MAHABOOBNAGAR,2004,183,87,23,293,56,0,56,112,63,52,11,126,15,0,36,290,479,2,477,1299,171,38,109,7,40,902,1789,21,164,10,251,0,446,522,1078,4545
ANDHRA PRADESH,MEDAK,2004,127,36,10,173,52,0,52,104,49,32,17,98,10,0,19,257,505,88,417,1296,53,33,139,11,55,1888,2628,41,86,54,229,0,410,449,686,4789
ANDHRA PRADESH,NALGONDA,2004,118,59,5,182,46,0,46,92,72,57,15,144,4,0,26,205,401,83,318,1037,115,26,156,5,69,1368,2267,34,200,66,272,0,572,528,2234,6009
ANDHRA PRADESH,NELLORE,2004,94,248,13,355,107,0,107,214,72,55,17,144,49,0,40,421,873,219,654,2256,263,24,307,2,62,1919,3093,11,173,88,142,0,414,516,1623,7047
ANDHRA PRADESH,NIZAMABAD,2004,96,54,27,177,24,0,24,48,56,19,37,112,14,0,29,349,360,36,324,1112,81,20,174,3,40,1856,2421,17,74,46,339,0,476,247,898,4804
ANDHRA PRADESH,PRAKASHAM,2004,103,93,4,200,19,0,19,38,44,37,7,88,8,0,22,158,298,94,204,784,45,24,116,3,27,1473,1984,6,130,24,146,0,306,296,842,3881
ANDHRA PRADESH,RANGA REDDY,2004,73,39,6,118,25,0,25,50,26,22,4,52,0,0,11,170,205,20,185,591,42,5,41,1,60,883,1157,17,49,15,136,0,217,125,311,2240
ANDHRA PRADESH,SECUNDERABAD RLY.,2004,8,4,0,12,0,0,0,0,0,0,0,0,0,0,0,1,367,0,367,735,2,0,2,28,0,10,42,2,1,0,2,0,5,0,38,465
ANDHRA PRADESH,SRIKAKULAM,2004,26,30,14,70,15,0,15,30,15,13,2,30,2,0,3,108,196,0,196,505,26,24,79,1,5,699,1410,14,58,11,165,0,248,576,754,2821
ANDHRA PRADESH,VIJAYAWADA,2004,46,43,1,90,19,0,19,38,76,43,33,152,4,0,29,555,2272,356,1916,5132,12,27,531,6,17,2218,3051,10,132,196,678,0,1016,240,547,7659
ANDHRA PRADESH,VIJAYAWADA RLY.,2004,1,1,0,2,0,0,0,0,0,0,0,0,0,0,1,0,288,2,286,577,7,3,3,3,0,10,26,0,6,0,1,0,7,0,35,359
ANDHRA PRADESH,VISAKHA RURAL,2004,50,18,1,69,18,0,18,36,12,12,0,24,2,0,6,79,184,4,180,455,62,10,64,1,17,1124,1552,3,54,30,94,0,181,274,800,2903
ANDHRA PRADESH,VISAKHAPATNAM,2004,27,27,3,57,12,0,12,24,27,16,11,54,1,0,12,333,733,176,557,1812,3,62,280,2,8,374,912,1,24,43,243,0,311,183,784,3182
ANDHRA PRADESH,VIZIANAGARAM,2004,42,17,2,61,14,0,14,28,8,7,1,16,4,0,8,106,196,0,196,510,15,16,62,0,0,403,682,6,53,26,155,0,240,186,1145,2464
ANDHRA PRADESH,WARANGAL,2004,111,67,7,185,53,0,53,106,125,88,37,250,9,0,31,352,670,175,495,1732,304,9,400,6,0,1902,3055,43,228,0,162,0,433,434,2804,7717
ANDHRA PRADESH,WEST GODAVARI,2004,72,108,3,183,81,0,81,162,66,43,23,132,0,0,13,345,1247,197,1050,2852,57,78,349,8,40,1798,2767,17,301,104,518,0,940,437,1728,7370
ARUNACHAL PRADESH,CHANGLANG,2004,8,3,1,12,9,0,9,18,7,5,2,14,7,0,1,17,27,0,27,79,6,0,0,0,1,22,29,0,1,0,1,0,2,0,51,162
ARUNACHAL PRADESH,DIBANG VALLEY,2004,1,10,0,11,3,0,3,6,3,0,3,6,1,0,3,9,15,0,15,43,12,3,3,0,1,30,49,0,0,0,0,0,0,0,18,112
ARUNACHAL PRADESH,K/KUMEY,2004,5,0,0,5,0,0,0,0,1,1,0,2,2,0,0,4,2,0,2,10,1,1,1,0,0,11,14,0,0,0,0,0,0,0,11,39
ARUNACHAL PRADESH,KAMENG EAST,2004,4,1,0,5,0,0,0,0,2,2,0,4,0,0,0,18,11,0,11,40,4,0,2,0,0,34,40,0,4,0,0,0,4,0,20,100
ARUNACHAL PRADESH,KAMENG WEST,2004,3,0,0,3,2,0,2,4,4,2,2,8,1,0,4,5,24,0,24,58,1,1,2,0,0,23,27,0,1,0,0,0,1,0,33,104
ARUNACHAL PRADESH,LOHIT,2004,10,2,0,12,5,0,5,10,7,5,2,14,5,0,4,13,23,0,23,68,1,3,3,0,1,37,45,0,8,0,0,0,8,0,58,180
ARUNACHAL PRADESH,PAPUM PARE,2004,7,4,0,11,4,0,4,8,8,4,4,16,6,0,7,51,132,65,67,328,1,10,9,0,1,66,87,0,8,0,0,0,8,0,126,440
ARUNACHAL PRADESH,SIANG EAST,2004,1,2,0,3,11,0,11,22,14,10,4,28,4,0,5,20,41,1,40,111,14,2,7,0,4,66,93,0,11,0,1,0,12,0,89,292
ARUNACHAL PRADESH,SIANG UPPER,2004,1,4,0,5,1,0,1,2,0,0,0,0,0,0,0,9,10,1,9,29,0,1,0,0,1,5,7,0,2,0,0,0,2,0,17,51
ARUNACHAL PRADESH,SIANG WEST,2004,3,8,0,11,6,0,6,12,10,6,4,20,3,2,6,25,44,7,37,124,21,2,5,1,8,54,91,0,8,0,0,0,8,0,123,329
ARUNACHAL PRADESH,SUBANSIRI LOWER,2004,8,2,0,10,0,0,0,0,1,0,1,2,0,0,5,12,7,0,7,31,1,0,2,0,0,13,16,0,1,0,0,0,1,0,43,95
ARUNACHAL PRADESH,SUBANSIRI UPPER,2004,10,6,0,16,0,0,0,0,4,4,0,8,0,0,8,10,18,1,17,54,1,1,0,0,2,36,40,0,3,0,1,0,4,0,38,138
ARUNACHAL PRADESH,TAWANG,2004,0,2,0,2,0,0,0,0,0,0,0,0,0,0,0,6,11,0,11,28,2,0,0,0,0,16,18,0,13,0,1,0,14,0,24,75
ARUNACHAL PRADESH,TIRAP,2004,3,1,0,4,1,0,1,2,4,2,2,8,1,0,2,14,21,0,21,59,0,1,0,0,0,14,15,0,1,0,0,0,1,0,59,122
ARUNACHAL PRADESH,UPPER DIBANG VALLEY,2004,3,0,0,3,0,0,0,0,0,0,0,0,0,0,0,2,2,0,2,6,0,1,0,0,0,2,3,0,0,0,0,0,0,0,7,17
ASSAM,BARPETA,2004,48,6,1,55,50,0,50,100,74,60,14,148,21,2,28,84,238,2,236,611,241,13,42,6,12,185,539,8,25,4,102,0,139,40,313,1543
ASSAM,BONGAIGAON,2004,36,2,0,38,41,0,41,82,52,46,6,104,10,5,10,48,136,0,136,345,91,12,17,1,3,229,462,3,12,0,23,0,38,109,302,1142
ASSAM,C.I.D.,2004,0,0,0,0,0,0,0,0,0,0,0,0,0,0,0,0,0,0,0,0,0,0,5,0,0,0,5,0,0,0,0,0,0,0,17,22
ASSAM,CACHAR,2004,46,30,3,79,46,0,46,92,112,92,20,224,21,0,15,249,411,31,380,1107,388,61,66,3,42,196,1062,4,114,0,256,0,374,306,1149,3518
ASSAM,DARRANG,2004,69,16,1,86,55,0,55,110,59,38,21,118,33,4,31,126,262,21,241,718,93,19,21,0,29,364,592,7,55,0,38,0,100,66,305,1653
ASSAM,DHEMAJI,2004,17,17,0,34,53,0,53,106,53,40,13,106,2,0,5,29,125,0,125,286,24,6,24,3,8,211,307,0,33,0,74,0,107,31,123,838
ASSAM,DHUBRI,2004,53,15,1,69,79,0,79,158,75,65,10,150,21,2,11,68,136,5,131,374,546,73,43,2,23,324,1217,9,110,1,183,0,303,206,179,2160
ASSAM,DIBRUGARH,2004,125,19,3,147,58,0,58,116,88,68,20,176,7,2,14,107,350,19,331,830,62,22,24,5,22,478,804,4,50,0,63,0,117,191,380,2074
ASSAM,G.R.P.,2004,17,0,0,17,2,0,2,4,3,3,0,6,10,0,10,8,166,0,166,360,7,4,4,0,0,3,18,0,2,0,7,0,9,0,87,330
ASSAM,GOALPARA,2004,35,0,0,35,50,0,50,100,53,51,2,106,16,1,9,67,100,2,98,293,21,4,30,1,12,133,266,3,8,0,119,0,130,65,326,1053
ASSAM,GOLAGHAT,2004,71,11,9,91,62,0,62,124,91,70,21,182,14,1,34,91,310,29,281,760,4,30,27,0,23,323,479,0,31,0,79,0,110,72,231,1514
ASSAM,GUWAHATI CITY,2004,21,39,15,75,88,0,88,176,295,228,67,590,20,3,78,534,867,300,567,2369,504,99,158,3,13,576,1466,3,45,0,55,0,103,113,1545,5074
ASSAM,HAILAKANDI,2004,25,18,1,44,18,0,18,36,32,25,7,64,5,0,2,62,47,1,46,163,108,5,9,2,23,85,252,2,4,1,23,0,30,20,306,798
ASSAM,JORHAT,2004,38,8,0,46,32,0,32,64,34,32,2,68,2,0,12,62,150,52,98,376,53,16,13,2,12,118,265,0,32,0,35,0,67,51,283,953
ASSAM,KAMRUP,2004,15,13,6,34,59,0,59,118,193,110,83,386,20,2,54,170,298,69,229,842,417,55,72,3,8,321,930,3,26,0,67,0,96,54,703,2559
ASSAM,KARBI ANGLONG,2004,57,5,0,62,14,0,14,28,20,11,9,40,15,0,20,19,102,7,95,258,40,5,1,0,8,38,121,0,8,0,8,0,16,29,204,593
ASSAM,KARIMGANJ,2004,40,29,0,69,32,0,32,64,36,31,5,72,5,0,3,57,101,6,95,267,201,8,19,3,12,44,321,8,4,0,67,0,79,34,394,1097
ASSAM,KOKRAJHAR,2004,63,21,3,87,33,0,33,66,31,24,7,62,7,0,13,56,104,4,100,284,52,4,21,1,15,127,311,2,41,0,45,0,88,91,129,859
ASSAM,LAKHIMPUR,2004,31,20,2,53,56,0,56,112,97,94,3,194,10,0,13,2,291,3,288,607,81,13,40,10,17,348,590,1,46,0,112,0,159,81,207,1478
ASSAM,MORIGAON,2004,19,0,0,19,36,0,36,72,43,43,0,86,1,3,6,28,81,4,77,200,74,4,22,1,4,92,241,2,12,0,23,0,37,44,297,792
ASSAM,N.C.HILLS,2004,7,9,1,17,1,0,1,2,9,6,3,18,2,0,6,23,42,0,42,115,3,1,5,0,2,42,68,0,3,0,21,0,24,15,37,229
ASSAM,NAGAON,2004,79,44,1,124,91,0,91,182,139,134,5,278,61,3,32,237,433,68,365,1199,346,49,54,5,31,595,1318,6,69,5,203,0,283,238,756,3477
ASSAM,NALBARI,2004,37,24,2,63,29,0,29,58,61,48,13,122,8,0,19,81,129,3,126,366,10,10,20,1,15,290,389,3,48,0,23,0,74,43,280,1133
ASSAM,R.P.O.,2004,6,0,0,6,5,0,5,10,0,0,0,0,7,0,1,2,21,0,21,52,20,0,0,2,0,2,24,0,2,0,7,0,9,0,35,110
ASSAM,SIBSAGAR,2004,55,12,1,68,49,0,49,98,81,81,0,162,2,3,9,67,238,25,213,557,62,26,44,3,18,149,357,0,12,0,92,0,104,55,536,1514
ASSAM,SONITPUR,2004,87,30,2,119,87,0,87,174,108,101,7,216,23,0,33,181,392,5,387,1021,156,33,54,0,8,462,888,5,60,0,167,0,232,175,576,2639
ASSAM,TINSUKIA,2004,117,22,11,150,45,0,45,90,67,51,16,134,17,0,37,86,336,29,307,812,11,14,30,0,19,176,360,1,31,0,53,0,85,110,340,1523
BIHAR,ARARIA,2004,66,59,12,137,34,0,34,68,84,22,62,168,34,3,60,42,186,35,151,511,325,59,66,0,28,161,662,11,13,0,27,0,51,23,742,2035
BIHAR,ARWAL,2004,36,8,0,44,2,0,2,4,9,0,9,18,9,0,23,6,54,0,54,146,31,0,6,0,0,40,105,16,0,0,10,0,26,28,209,487
BIHAR,AURANGABAD,2004,77,0,0,77,18,0,18,36,31,27,4,62,41,0,46,80,214,17,197,595,235,0,23,0,0,0,258,40,0,0,33,0,73,0,1580,2418
BIHAR,BAGAHA,2004,49,92,3,144,23,0,23,46,88,15,73,176,7,0,15,24,66,1,65,178,153,12,32,0,10,301,521,5,12,0,7,0,24,13,65,977
BIHAR,BANKA,2004,71,12,4,87,44,0,44,88,40,22,18,80,44,2,26,65,99,4,95,335,175,14,19,0,11,9,267,25,5,0,15,0,45,39,659,1378
BIHAR,BEGUSARAI,2004,107,103,6,216,23,0,23,46,123,8,115,246,19,1,83,71,323,15,308,820,204,93,56,1,12,173,622,15,5,0,55,0,75,83,1554,3110
BIHAR,BETTIAH,2004,108,62,9,179,128,0,128,256,226,40,186,452,23,3,52,55,301,2,299,735,682,178,287,3,18,2642,3840,29,9,0,161,0,199,30,229,5235
BIHAR,BHABHUA,2004,59,14,3,76,20,1,19,40,47,13,34,94,15,1,26,85,146,12,134,419,165,32,55,1,35,201,541,28,8,0,24,0,60,52,415,1432
BIHAR,BHAGALPUR,2004,133,88,6,227,63,0,63,126,95,59,36,190,32,7,54,140,393,65,328,1019,239,71,106,0,20,50,555,12,13,0,226,0,251,69,1545,3362
BIHAR,BHOJPUR,2004,108,211,3,322,9,0,9,18,30,9,21,60,43,0,57,100,285,19,266,770,232,38,20,0,48,90,509,34,42,0,68,0,144,81,2296,3795
BIHAR,BUXAR,2004,70,65,2,137,13,0,13,26,51,5,46,102,41,2,36,88,235,4,231,637,223,63,60,1,20,401,929,21,13,0,37,1,72,161,700,2304
BIHAR,DARBHANGA,2004,55,20,11,86,59,0,59,118,60,15,45,120,28,1,53,33,138,4,134,391,420,91,75,0,16,2,668,33,0,0,70,6,109,64,1848,3083
BIHAR,GAYA,2004,163,178,15,356,19,0,19,38,70,30,40,140,104,7,168,127,461,161,300,1328,391,18,27,2,36,540,1122,36,42,0,58,0,136,108,966,3536
BIHAR,GOPALGANJ,2004,77,132,8,217,39,0,39,78,78,27,51,156,23,2,67,69,163,24,139,487,185,70,75,0,8,5,349,38,5,9,132,0,184,6,1533,2724
BIHAR,JAMALPUR RLY.,2004,10,6,0,16,0,0,0,0,1,1,0,2,25,2,4,3,171,2,169,376,5,5,4,0,0,3,17,3,1,0,0,0,4,0,85,328
BIHAR,JAMUI,2004,79,74,0,153,31,0,31,62,71,11,60,142,31,0,26,39,77,6,71,250,152,6,47,0,13,313,555,11,29,0,45,0,85,24,320,1388
BIHAR,JEHANABAD,2004,68,50,2,120,6,0,6,12,38,8,30,76,32,3,34,50,130,13,117,379,98,15,35,0,12,290,480,6,19,0,25,0,50,30,487,1430
BIHAR,KATIHAR,2004,71,22,7,100,79,0,79,158,71,34,37,142,26,2,27,55,159,26,133,428,171,44,38,1,19,175,514,19,9,0,34,0,62,66,804,1899
BIHAR,KATIHAR RLY.,2004,10,0,0,10,2,0,2,4,5,3,2,10,10,1,20,5,224,14,210,484,7,3,14,1,0,0,27,0,1,0,1,0,2,2,139,445
BIHAR,KHAGARIA,2004,50,88,5,143,18,0,18,36,43,10,33,86,23,9,36,16,117,13,104,318,199,11,10,6,17,160,473,9,10,0,27,0,46,70,630,1554
BIHAR,KISHANGANJ,2004,26,12,8,46,32,0,32,64,80,80,0,160,11,1,12,32,122,14,108,300,110,16,36,1,2,43,235,4,25,0,36,0,65,27,416,1052
BIHAR,LAKHISARAI,2004,63,87,4,154,13,0,13,26,50,13,37,100,9,3,38,35,62,8,54,209,90,10,15,0,3,31,193,10,4,0,9,0,23,44,334,914
BIHAR,MADHEPURA,2004,58,23,4,85,11,0,11,22,23,11,12,46,18,1,41,35,58,11,47,211,143,0,18,0,4,4,179,7,4,0,8,0,19,10,705,1175
BIHAR,MADHUBANI,2004,60,91,0,151,61,0,61,122,69,33,36,138,57,0,43,67,224,4,220,615,338,0,27,2,2,612,995,34,121,0,111,0,266,14,788,2721
BIHAR,MOTIHARI,2004,120,69,8,197,29,0,29,58,129,56,73,258,22,4,79,127,378,11,367,988,365,80,135,2,26,532,1221,45,15,0,93,0,153,81,1992,4331
BIHAR,MUNGER,2004,64,30,1,95,11,0,11,22,43,14,29,86,8,1,29,44,163,10,153,408,230,16,30,0,9,120,435,20,12,0,40,0,72,30,771,1672
BIHAR,MUZAFFARPUR,2004,180,17,18,215,166,0,166,332,300,42,258,600,52,3,146,202,779,65,714,1961,819,138,286,1,46,318,1772,72,11,0,206,0,289,164,2886,6810
BIHAR,MUZAFFARPUR RLY.,2004,20,3,1,24,2,0,2,4,10,3,7,20,8,0,18,6,395,23,372,822,18,1,34,0,0,73,127,0,1,0,1,0,2,1,93,685
BIHAR,NALANDA,2004,220,139,15,374,43,0,43,86,144,32,112,288,30,4,65,72,388,13,375,947,191,23,78,0,32,605,1058,68,43,0,110,3,224,129,1001,3403
BIHAR,NAUGACHIA,2004,50,37,1,88,7,0,7,14,27,4,23,54,13,0,36,15,66,3,63,196,118,2,6,1,2,6,185,8,1,0,11,0,20,50,602,1059
BIHAR,NAWADAH,2004,78,101,7,186,37,0,37,74,67,12,55,134,28,2,40,38,79,7,72,266,245,23,33,0,13,145,580,16,5,0,23,0,44,121,671,1772
BIHAR,PATNA,2004,542,188,46,776,46,0,46,92,270,39,231,540,123,35,751,584,1568,1066,502,4629,562,168,319,8,52,385,1774,44,28,3,147,0,222,280,4483,10632
BIHAR,PATNA RLY.,2004,21,14,4,39,2,0,2,4,5,0,5,10,29,16,30,1,744,70,674,1564,13,6,23,0,0,0,42,1,13,0,1,0,15,0,212,1135
BIHAR,PURNEA,2004,128,41,6,175,62,0,62,124,76,6,70,152,72,4,144,82,242,64,178,786,202,6,8,2,13,9,301,11,3,0,19,2,35,61,1082,2275
BIHAR,ROHTAS,2004,130,215,10,355,12,0,12,24,44,14,30,88,17,2,53,107,265,37,228,709,204,50,28,9,0,72,459,35,38,0,36,0,109,96,1431,2854
BIHAR,SAHARSA,2004,48,100,3,151,21,0,21,42,47,21,26,94,13,0,45,35,122,6,116,337,221,28,29,0,6,416,725,11,39,0,13,0,63,25,332,1554
BIHAR,SAMASTIPUR,2004,118,145,21,284,28,0,28,56,123,16,107,246,17,15,58,102,292,45,247,776,274,41,47,0,57,284,746,44,9,0,40,21,114,43,1380,3159
BIHAR,SARAN,2004,160,44,6,210,17,0,17,34,159,51,108,318,47,2,112,133,258,56,202,810,330,58,126,9,31,849,1451,38,12,0,258,2,310,48,2152,4851
BIHAR,SHEIKHPURA,2004,44,40,0,84,3,0,3,6,20,4,16,40,7,0,8,11,53,4,49,132,92,8,31,0,9,0,140,6,14,0,16,0,36,0,432,794
BIHAR,SHEOHAR,2004,9,31,1,41,13,0,13,26,8,6,2,16,7,0,13,11,19,0,19,69,44,12,8,2,6,49,128,5,9,0,6,0,20,7,129,389
BIHAR,SITAMARHI,2004,80,26,2,108,70,0,70,140,112,30,82,224,16,1,34,82,230,14,216,593,206,75,47,2,19,129,515,21,9,0,100,0,130,37,1436,2734
BIHAR,SIWAN,2004,125,57,9,191,7,0,7,14,104,39,65,208,54,2,146,77,165,32,133,609,223,30,42,1,21,487,889,33,6,0,74,0,113,85,546,2294
BIHAR,SUPAUL,2004,38,49,1,88,25,0,25,50,25,7,18,50,42,2,60,40,114,12,102,372,249,12,31,0,6,144,450,7,20,0,18,0,45,8,952,1843
BIHAR,VAISHALI,2004,99,152,8,259,42,0,42,84,217,105,112,434,9,1,72,84,385,71,314,936,214,75,272,1,25,362,1044,98,26,1,248,0,373,95,2546,5032
CHHATTISGARH,BALRAMPUR,2004,33,20,8,61,27,0,27,54,6,6,0,12,15,0,17,27,28,0,28,115,20,0,8,0,7,25,83,0,32,23,14,0,69,23,156,489
CHHATTISGARH,BILASPUR,2004,83,53,3,139,61,0,61,122,21,21,0,42,2,0,36,585,704,220,484,2031,164,9,47,4,34,288,712,9,179,8,102,0,298,166,2769,5327
CHHATTISGARH,BIZAPUR,2004,24,59,0,83,3,0,3,6,1,1,0,2,11,0,3,10,9,8,1,42,9,0,2,0,14,23,57,1,10,0,1,0,12,9,71,260
CHHATTISGARH,DANTEWARA,2004,70,51,0,121,11,0,11,22,8,3,5,16,4,0,0,45,70,9,61,189,13,0,5,0,5,72,134,1,8,3,1,0,13,39,296,702
CHHATTISGARH,DHAMTARI,2004,18,8,0,26,37,0,37,74,5,1,4,10,0,0,3,113,76,17,59,268,13,4,9,0,4,103,199,0,64,8,16,0,88,66,723,1270
CHHATTISGARH,DURG,2004,55,58,0,113,124,0,124,248,41,30,11,82,2,0,50,576,813,227,586,2254,53,19,73,7,31,563,987,10,253,23,114,0,400,241,3412,6518
CHHATTISGARH,GRP RAIPUR,2004,2,5,2,9,2,0,2,4,2,1,1,4,0,0,5,8,223,7,216,459,3,0,4,0,0,14,22,0,2,0,1,0,3,1,77,351
CHHATTISGARH,JAGDALPUR,2004,63,33,0,96,82,0,82,164,20,20,0,40,10,1,16,196,178,38,140,579,44,0,18,3,7,138,306,0,69,1,16,0,86,96,1206,2197
CHHATTISGARH,JANJGIR,2004,55,39,1,95,30,0,30,60,8,5,3,16,3,2,26,213,268,42,226,780,74,6,27,4,14,282,507,7,104,15,75,0,201,100,1045,2398
CHHATTISGARH,JASHPUR,2004,46,14,0,60,56,0,56,112,4,4,0,8,4,2,19,72,70,21,49,237,17,4,14,0,5,97,184,1,60,4,10,0,75,47,289,835
CHHATTISGARH,KABIRDHAM,2004,13,13,1,27,22,0,22,44,7,4,3,14,0,0,1,74,115,11,104,305,18,3,7,1,6,350,422,5,70,2,19,0,96,37,350,1114
CHHATTISGARH,KANKER,2004,48,45,0,93,22,0,22,44,12,10,2,24,23,0,14,57,69,15,54,232,32,2,5,0,7,56,145,0,43,2,10,0,55,43,476,966
CHHATTISGARH,KORBA,2004,46,15,4,65,34,0,34,68,6,6,0,12,0,0,13,194,308,77,231,823,35,2,15,4,7,342,528,5,49,7,32,0,93,123,969,2210
CHHATTISGARH,KORIYA,2004,33,18,0,51,50,0,50,100,4,4,0,8,2,1,16,159,137,26,111,452,20,2,20,1,11,191,311,2,109,1,36,0,148,66,607,1486
CHHATTISGARH,MAHASAMUND,2004,22,11,1,34,35,0,35,70,3,3,0,6,1,1,10,121,164,35,129,461,21,3,20,1,8,236,372,6,54,1,26,0,87,83,661,1489
CHHATTISGARH,NARAYANPUR,2004,21,26,0,47,1,0,1,2,1,0,1,2,12,0,0,9,18,5,13,57,2,1,3,0,6,22,40,0,2,0,0,0,2,6,35,165
CHHATTISGARH,RAIGARH,2004,55,25,0,80,45,0,45,90,17,13,4,34,1,1,36,203,321,89,232,883,49,13,25,0,9,240,426,7,78,5,30,0,120,90,785,2035
CHHATTISGARH,RAIPUR,2004,84,59,4,147,143,0,143,286,31,27,4,62,6,0,42,559,927,349,578,2461,77,24,71,13,24,492,1085,10,253,19,134,0,416,384,3614,6970
CHHATTISGARH,RAJNANDGAON,2004,45,20,0,65,61,0,61,122,4,2,2,8,2,0,12,192,210,56,154,626,15,4,24,1,14,115,270,5,74,8,40,0,127,97,1437,2380
CHHATTISGARH,SARGUJA,2004,111,47,1,159,123,0,123,246,13,13,0,26,8,0,44,307,306,64,242,971,111,5,27,3,29,250,425,2,148,1,64,0,215,0,1165,2765
GOA,NORTH GOA,2004,23,3,3,29,13,0,13,26,3,2,1,6,4,0,11,147,298,79,219,758,18,22,36,0,5,98,300,2,16,8,6,0,32,121,390,1227
GOA,SOUTH GOA,2004,17,3,2,22,24,0,24,48,10,8,2,20,1,0,7,114,205,41,164,532,15,27,25,0,2,72,236,0,7,7,11,0,25,95,256,900
GUJARAT,AHMEDABAD COMMR.,2004,92,62,5,159,40,0,40,80,215,122,93,430,33,4,271,931,5711,2153,3558,12661,162,275,333,7,10,1594,2546,10,63,20,768,0,861,165,6782,17553
GUJARAT,AHMEDABAD RURAL,2004,26,7,0,33,12,0,12,24,32,28,4,64,9,0,28,96,252,44,208,637,36,37,13,2,11,341,660,1,22,0,65,0,88,220,1603,2813
GUJARAT,AHWA-DANG,2004,4,0,0,4,2,0,2,4,0,0,0,0,0,0,1,3,5,0,5,14,4,3,2,1,1,27,55,0,3,0,3,0,6,17,48,124
GUJARAT,AMRELI,2004,28,14,1,43,5,0,5,10,26,23,3,52,4,0,11,118,158,43,115,449,38,15,29,12,18,362,555,1,26,3,116,0,146,81,1174,2240
GUJARAT,ANAND,2004,21,12,2,35,12,0,12,24,41,39,2,82,13,0,16,148,361,134,227,899,23,71,20,10,16,413,737,0,24,3,116,0,143,184,1710,3216
GUJARAT,BHARUCH,2004,38,7,1,46,14,0,14,28,21,16,5,42,4,0,14,144,370,144,226,902,42,90,17,5,29,384,732,0,27,4,65,0,96,165,1306,2747
GUJARAT,BHAVNAGAR,2004,53,21,0,74,22,0,22,44,71,60,11,142,20,0,87,319,718,219,499,1862,141,99,112,14,32,113,517,0,41,74,137,0,252,6,3261,5341
GUJARAT,DAHOD,2004,44,10,1,55,9,0,9,18,28,23,5,56,38,0,56,115,144,64,80,497,45,14,1,2,21,357,440,0,26,0,20,0,46,0,828,1759
GUJARAT,GANDHINAGAR,2004,25,14,0,39,8,0,8,16,15,11,4,30,2,1,31,134,416,186,230,1000,32,11,50,3,7,282,561,2,16,3,90,0,111,176,1438,2756
GUJARAT,HIMATNAGAR,2004,35,20,0,55,10,0,10,20,47,43,4,94,15,0,25,200,194,40,154,628,56,111,57,4,19,383,847,0,61,0,204,0,265,217,2395,4053
GUJARAT,JAMNAGAR,2004,42,13,3,58,8,0,8,16,32,27,5,64,4,0,24,176,372,144,228,948,41,35,30,6,14,447,576,0,26,4,171,0,201,3,2343,3794
GUJARAT,JUNAGADH,2004,40,31,0,71,9,0,9,18,57,41,16,114,12,0,44,259,476,179,297,1267,88,71,63,1,26,525,977,13,49,9,368,0,439,203,2420,4764
GUJARAT,KHEDA NORTH,2004,53,9,3,65,8,0,8,16,24,22,2,48,9,0,23,124,394,123,271,944,45,50,58,5,10,374,738,0,27,0,139,0,166,196,2092,3643
GUJARAT,KUTCH,2004,28,20,0,48,13,0,13,26,37,34,3,74,11,0,31,294,360,138,222,1056,48,37,64,1,11,407,802,1,26,0,217,0,244,234,1798,3638
GUJARAT,MEHSANA,2004,40,26,1,67,4,0,4,8,54,47,7,108,16,0,47,231,621,127,494,1536,99,33,103,0,9,1058,1456,2,25,0,185,0,212,154,1841,4549
GUJARAT,NARMADA,2004,15,3,0,18,6,0,6,12,8,7,1,16,0,0,6,20,29,6,23,84,10,8,6,0,6,108,186,0,2,0,10,0,12,48,305,590
GUJARAT,NAVSARI,2004,26,2,0,28,5,0,5,10,7,7,0,14,3,2,8,77,147,64,83,384,9,31,14,2,3,113,172,1,5,0,19,0,25,0,725,1199
GUJARAT,PALANPUR,2004,38,21,0,59,21,0,21,42,37,36,1,74,12,0,26,199,328,84,244,893,78,27,46,4,16,1082,1433,0,33,1,133,0,167,180,1262,3544
GUJARAT,PANCHMAHAL,2004,51,13,0,64,7,0,7,14,28,28,0,56,32,0,22,156,368,117,251,946,34,63,10,7,33,323,470,0,33,3,70,0,106,0,1053,2306
GUJARAT,PATAN,2004,19,16,0,35,6,0,6,12,29,27,2,58,0,0,9,79,233,29,204,554,44,25,43,4,3,350,545,0,19,0,103,0,122,76,1128,2186
GUJARAT,PORBANDAR,2004,11,9,0,20,1,0,1,2,7,4,3,14,0,0,7,45,74,37,37,200,13,46,25,2,6,137,266,0,5,0,41,0,46,37,542,1008
GUJARAT,RAJKOT COMMR.,2004,37,16,0,53,9,0,9,18,39,32,7,78,6,2,24,332,1216,613,603,2796,72,29,69,6,8,341,618,4,10,10,184,0,208,93,1832,4339
GUJARAT,RAJKOT RURAL,2004,36,22,0,58,17,0,17,34,41,41,0,82,10,1,24,256,326,91,235,943,66,64,15,1,15,526,942,3,47,4,265,0,319,255,2184,4178
GUJARAT,SURAT COMMR.,2004,74,8,5,87,24,0,24,48,72,47,25,144,31,1,61,317,1543,1063,480,3496,62,46,140,10,9,467,1117,17,21,6,102,0,146,383,732,4131
GUJARAT,SURAT RURAL,2004,47,12,0,59,14,0,14,28,13,13,0,26,23,1,24,78,154,98,56,434,18,20,26,0,3,248,713,3,11,2,33,0,49,398,1486,2614
GUJARAT,SURENDRANAGAR,2004,28,22,0,50,13,0,13,26,27,23,4,54,8,0,13,143,266,74,192,696,46,89,16,4,11,446,760,0,35,0,63,0,98,148,1472,2850
GUJARAT,VADODARA COMMR.,2004,28,33,0,61,6,0,6,12,44,34,10,88,14,0,40,488,1414,709,705,3370,164,88,268,3,16,305,969,0,10,8,140,0,158,125,2357,5551
GUJARAT,VADODARA RURAL,2004,85,9,5,99,22,0,22,44,56,54,2,112,12,0,20,101,296,58,238,725,38,77,18,0,13,496,836,0,43,0,84,0,127,194,1573,3142
GUJARAT,VALSAD,2004,36,13,0,49,9,0,9,18,22,16,6,44,13,3,34,229,346,150,196,971,35,35,45,4,10,230,359,0,12,0,40,0,52,0,1449,2565
GUJARAT,W.RLY,2004,13,4,0,17,3,0,3,6,3,0,3,6,6,0,109,16,1259,0,1259,2649,10,12,33,2,2,23,82,0,9,10,4,0,23,0,758,2276
HARYANA,AMBALA,2004,28,10,5,43,10,0,10,20,22,22,0,44,3,1,7,208,243,112,131,705,1,53,73,1,6,242,380,11,25,27,227,0,290,4,1018,2225
HARYANA,BHIWANI,2004,51,26,1,78,28,0,28,56,19,12,7,38,4,6,14,209,301,118,183,835,116,33,75,1,19,241,489,28,19,0,68,0,115,4,918,2181
HARYANA,FARIDABAD,2004,67,31,6,104,42,0,42,84,66,49,17,132,4,18,23,227,815,546,269,1902,156,95,30,4,4,346,650,28,45,585,157,0,815,15,2821,5585
HARYANA,FATEHABAD,2004,29,12,0,41,9,0,9,18,17,9,8,34,0,4,2,76,111,59,52,304,18,7,80,3,2,172,287,6,17,3,38,0,64,5,493,1104
HARYANA,GRP,2004,27,4,0,31,2,0,2,4,3,0,3,6,0,0,3,2,180,40,140,365,3,1,1,0,0,15,38,7,3,111,0,0,121,18,551,931
HARYANA,GURGAON,2004,66,40,6,112,36,0,36,72,55,34,21,110,16,22,33,283,1045,746,299,2444,67,47,42,3,7,226,403,21,21,18,115,0,175,11,1897,4077
HARYANA,HISSAR,2004,49,52,1,102,16,0,16,32,43,31,12,86,2,13,20,186,430,247,183,1081,33,14,130,0,2,277,456,12,18,9,127,0,166,0,1030,2464
HARYANA,JHAJJAR,2004,42,27,0,69,11,0,11,22,11,7,4,22,0,6,13,87,160,86,74,426,50,31,40,1,3,137,390,14,17,18,104,0,153,128,436,1336
HARYANA,JIND,2004,28,16,17,61,7,0,7,14,9,6,3,18,1,3,3,60,147,84,63,361,49,20,38,1,2,111,221,14,2,18,31,0,65,0,431,1008
HARYANA,KAITHAL,2004,25,16,2,43,18,0,18,36,13,9,4,26,0,6,9,84,200,93,107,499,0,67,15,2,8,166,261,9,13,0,136,0,158,3,434,1226
HARYANA,KARNAL,2004,40,28,3,71,31,0,31,62,15,12,3,30,4,5,19,159,386,210,176,959,34,16,104,3,4,660,1060,15,23,0,242,0,280,239,322,2352
HARYANA,KURUKSHETRA,2004,26,12,4,42,21,0,21,42,11,5,6,22,1,7,13,208,411,173,238,1051,0,9,160,3,5,190,367,15,28,20,120,0,183,0,786,2050
HARYANA,MAHENDRAGARH,2004,16,10,0,26,20,0,20,40,13,11,2,26,0,2,4,66,111,38,73,294,52,20,11,0,5,175,265,8,18,0,36,0,62,2,664,1233
HARYANA,PANCHKULA,2004,7,4,1,12,6,0,6,12,6,5,1,12,0,0,2,82,207,116,91,498,1,11,70,0,0,20,102,4,53,0,57,0,114,0,638,1169
HARYANA,PANIPAT,2004,37,22,6,65,38,0,38,76,19,8,11,38,6,12,13,131,433,289,144,1028,27,40,19,4,1,142,440,4,14,8,152,0,178,207,482,1817
HARYANA,REWARI,2004,17,14,0,31,16,0,16,32,24,21,3,48,2,9,10,89,223,109,114,556,35,26,16,1,4,142,228,8,24,0,48,0,80,4,846,1558
HARYANA,ROHTAK,2004,65,39,2,106,29,0,29,58,19,13,6,38,2,14,14,206,367,253,114,970,35,18,66,2,5,137,409,15,14,21,45,0,95,146,606,1867
HARYANA,SIRSA,2004,25,29,2,56,17,0,17,34,16,6,10,32,2,1,11,159,246,113,133,665,14,17,40,0,6,319,398,9,17,0,102,0,128,2,497,1531
HARYANA,SONIPAT,2004,67,34,4,105,13,0,13,26,25,20,5,50,3,12,20,159,377,201,176,948,8,8,45,0,5,315,574,16,22,12,88,0,138,193,625,2051
HARYANA,YAMUNANAGAR,2004,21,15,5,41,16,0,16,32,17,12,5,34,2,4,11,105,165,102,63,452,0,1,34,3,7,161,206,7,10,0,133,0,150,0,614,1331
HIMACHAL PRADESH,BILASPUR,2004,9,11,0,20,10,0,10,20,8,5,3,16,0,0,4,41,55,13,42,155,47,5,13,0,16,66,185,0,28,0,28,0,56,38,724,1103
HIMACHAL PRADESH,CHAMBA,2004,8,5,1,14,14,0,14,28,22,20,2,44,0,0,0,134,27,4,23,188,10,2,9,0,2,55,118,1,22,0,11,0,34,40,264,627
HIMACHAL PRADESH,G.R.P.,2004,0,0,0,0,0,0,0,0,0,0,0,0,0,0,0,0,2,0,2,4,0,0,0,0,0,0,0,0,0,0,0,0,0,0,6,8
HIMACHAL PRADESH,HAMIRPUR,2004,9,8,1,18,5,0,5,10,10,7,3,20,0,0,0,37,42,7,35,121,34,9,9,0,3,239,331,0,24,2,23,0,49,37,444,936
HIMACHAL PRADESH,KANGRA,2004,18,15,3,36,15,0,15,30,15,10,5,30,0,0,1,97,81,27,54,260,111,9,24,1,26,200,375,2,34,1,57,0,94,4,1343,2057
HIMACHAL PRADESH,KINNAUR,2004,3,1,0,4,8,0,8,16,3,3,0,6,0,0,0,38,10,1,9,58,5,2,2,0,1,14,45,0,4,0,4,0,8,21,74,190
HIMACHAL PRADESH,KULLU,2004,9,4,0,13,13,0,13,26,13,11,2,26,0,0,7,50,40,8,32,137,40,4,9,0,6,56,162,1,11,1,10,0,23,47,469,790
HIMACHAL PRADESH,LAHAUL-SPITI,2004,2,0,0,2,0,0,0,0,0,0,0,0,0,0,0,1,1,0,1,3,2,2,1,0,0,3,20,0,0,0,1,0,1,12,27,52
HIMACHAL PRADESH,MANDI,2004,19,7,1,27,15,0,15,30,7,6,1,14,0,0,2,97,63,15,48,225,45,6,30,0,29,194,365,1,56,2,29,0,88,61,1071,1735
HIMACHAL PRADESH,SHIMLA,2004,10,10,2,22,34,0,34,68,16,14,2,32,1,0,5,139,154,43,111,453,114,32,42,1,10,84,360,1,43,6,24,0,74,77,1187,1992
HIMACHAL PRADESH,SIRMAUR,2004,9,3,1,13,9,0,9,18,13,10,3,26,0,0,3,36,27,7,20,93,58,7,12,0,7,46,168,1,23,4,15,0,43,38,380,692
HIMACHAL PRADESH,SOLAN,2004,4,7,3,14,20,0,20,40,9,8,1,18,0,0,2,49,89,45,44,229,64,13,12,3,6,362,503,0,27,0,28,0,55,43,603,1344
HIMACHAL PRADESH,UNA,2004,10,6,0,16,10,0,10,20,7,5,2,14,0,0,1,47,52,22,30,152,32,6,11,1,6,102,209,1,12,0,22,0,35,51,423,800
JAMMU & KASHMIR,ANANTNAG,2004,70,109,1,180,17,0,17,34,60,49,11,120,7,0,30,151,92,32,60,372,55,11,20,5,39,24,178,0,88,24,0,0,112,24,646,1473
JAMMU & KASHMIR,AWANTIPORA,2004,18,3,0,21,8,0,8,16,12,10,2,24,0,0,1,32,37,7,30,107,10,4,12,0,0,1,43,0,23,2,0,0,25,16,205,384
JAMMU & KASHMIR,BARAMULLA,2004,86,83,2,171,15,0,15,30,87,74,13,174,0,0,6,139,197,29,168,539,116,6,17,1,32,18,190,1,167,36,0,0,204,0,806,1815
JAMMU & KASHMIR,BORDER,2004,7,12,0,19,4,0,4,8,11,10,1,22,0,0,0,14,19,1,18,52,13,1,8,3,1,15,79,0,10,7,2,0,19,38,548,713
JAMMU & KASHMIR,BUDGAM,2004,60,38,3,101,6,0,6,12,61,54,7,122,0,0,7,61,147,19,128,362,92,2,5,1,8,3,129,0,87,14,0,0,101,18,376,989
JAMMU & KASHMIR,CRIME JAMMU,2004,0,0,0,0,0,0,0,0,0,0,0,0,0,0,0,0,0,0,0,0,0,0,52,0,0,0,52,0,0,0,0,0,0,0,0,52
JAMMU & KASHMIR,CRIME SRINAGAR,2004,0,0,0,0,0,0,0,0,0,0,0,0,0,0,0,0,0,0,0,0,0,9,99,0,0,0,108,0,0,0,0,0,0,0,0,108
JAMMU & KASHMIR,DODA,2004,83,83,0,166,4,0,4,8,20,20,0,40,9,0,3,33,28,0,28,101,19,11,5,0,28,35,137,0,13,3,1,0,17,39,334,751
JAMMU & KASHMIR,GANDERBAL,2004,15,7,2,24,12,0,12,24,34,29,5,68,0,0,1,56,63,4,59,183,56,2,14,2,12,4,108,0,80,7,0,0,87,18,223,608
JAMMU & KASHMIR,HANDWARA,2004,25,38,0,63,7,0,7,14,34,30,4,68,0,0,3,30,32,1,31,97,52,0,4,1,4,9,71,0,43,4,0,0,47,1,147,434
JAMMU & KASHMIR,JAMMU,2004,28,61,8,97,19,0,19,38,54,54,0,108,0,0,6,267,383,196,187,1039,89,22,71,4,13,37,339,5,24,65,38,0,132,103,2329,3626
JAMMU & KASHMIR,KARGIL,2004,1,2,0,3,1,0,1,2,1,1,0,2,0,0,0,6,1,0,1,8,7,0,1,0,2,0,10,0,1,0,0,0,1,0,74,97
JAMMU & KASHMIR,KATHUA,2004,17,30,0,47,10,0,10,20,24,15,9,48,0,0,2,65,30,6,24,127,25,1,4,0,10,8,96,0,11,7,6,0,24,48,669,967
JAMMU & KASHMIR,KULGAM,2004,48,4,2,54,11,0,11,22,42,37,5,84,0,0,5,45,26,5,21,102,64,4,4,1,9,3,108,0,23,3,0,0,26,23,260,577
JAMMU & KASHMIR,KUPWARA,2004,31,84,1,116,20,0,20,40,46,40,6,92,0,0,0,44,62,3,59,168,75,1,6,4,9,9,104,0,61,7,0,0,68,0,272,732
JAMMU & KASHMIR,LEH,2004,2,0,0,2,3,0,3,6,4,4,0,8,0,0,0,15,4,0,4,23,5,0,2,0,0,1,8,0,3,0,1,0,4,0,113,153
JAMMU & KASHMIR,POONCH,2004,80,121,0,201,11,0,11,22,18,18,0,36,0,0,0,9,41,0,41,91,13,1,5,0,20,32,82,0,7,3,2,0,12,11,212,586
JAMMU & KASHMIR,PULWAMA,2004,54,97,0,151,0,0,0,0,47,39,8,94,7,0,17,51,104,22,82,283,152,1,3,0,17,61,252,1,35,4,1,0,41,18,233,903
JAMMU & KASHMIR,RAILWAYS,2004,1,0,0,1,1,0,1,2,0,0,0,0,0,0,0,0,9,0,9,18,0,0,0,0,0,0,0,0,0,0,0,0,0,0,5,16
JAMMU & KASHMIR,RAJOURI,2004,54,96,3,153,22,0,22,44,34,27,7,68,0,0,0,47,96,8,88,239,57,7,13,0,47,33,173,2,23,2,7,0,34,16,638,1197
JAMMU & KASHMIR,RAMBAN,2004,48,57,1,106,7,0,7,14,12,12,0,24,0,0,0,27,36,1,35,99,25,0,4,0,18,8,61,0,8,1,0,0,9,6,340,598
JAMMU & KASHMIR,REASI,2004,34,37,3,74,5,0,5,10,11,9,2,22,1,0,0,16,12,1,11,41,0,5,0,0,9,2,16,0,5,7,4,0,16,0,142,293
JAMMU & KASHMIR,SRINAGAR,2004,45,130,2,177,24,0,24,48,115,92,23,230,3,0,48,223,430,229,201,1134,153,17,56,9,33,24,332,0,261,55,16,0,332,40,1153,2837
JAMMU & KASHMIR,UDHAMPUR,2004,9,20,1,30,11,0,11,22,8,8,0,16,1,0,0,89,90,9,81,270,38,0,9,1,9,7,67,0,17,13,4,0,34,3,952,1282
JHARKHAND,BOKARO,2004,58,108,2,168,48,0,48,96,40,26,14,80,40,5,64,132,445,95,350,1131,180,28,24,2,10,432,794,29,32,0,16,0,77,118,381,2194
JHARKHAND,CHAIBASA,2004,134,42,38,214,37,0,37,74,19,9,10,38,7,0,14,34,98,5,93,251,34,15,2,0,9,17,78,0,17,0,8,0,25,1,204,730
JHARKHAND,CHATRA,2004,31,4,0,35,18,0,18,36,4,1,3,8,31,0,19,19,83,24,59,235,123,0,3,0,3,2,131,15,0,0,4,0,19,0,481,840
JHARKHAND,DEOGHAR,2004,36,34,4,74,37,0,37,74,5,2,3,10,13,2,25,53,98,20,78,289,145,0,0,0,7,18,172,16,7,0,17,0,40,2,764,1283
JHARKHAND,DHANBAD,2004,88,42,13,143,38,0,38,76,72,25,47,144,69,14,64,149,493,31,462,1282,237,40,61,1,9,135,487,36,53,3,19,0,111,4,1561,3201
JHARKHAND,DHANBAD RLY.,2004,5,0,0,5,2,0,2,4,2,1,1,4,21,0,32,8,240,0,240,541,11,0,4,0,0,1,19,0,2,0,0,0,2,3,77,408
JHARKHAND,DUMKA,2004,67,149,4,220,50,0,50,100,15,3,12,30,7,1,13,54,88,0,88,251,99,45,10,0,7,57,264,8,31,0,37,0,76,46,220,1008
JHARKHAND,GARHWA,2004,39,17,3,59,32,0,32,64,9,2,7,18,17,2,20,29,68,0,68,204,107,9,10,0,9,225,367,14,2,0,19,2,37,7,229,869
JHARKHAND,GIRIDIH,2004,72,27,4,103,39,0,39,78,23,8,15,46,49,2,42,91,128,2,126,440,108,6,27,0,22,73,334,52,48,0,36,0,136,98,1008,1955
JHARKHAND,GODDA,2004,31,36,0,67,86,0,86,172,21,6,15,42,9,0,10,46,128,0,128,321,125,7,17,0,0,314,466,4,0,0,56,0,60,3,1310,2203
JHARKHAND,GUMLA,2004,108,32,8,148,31,0,31,62,9,8,1,18,23,2,41,37,58,7,51,219,32,10,6,0,0,2,56,1,4,0,14,0,19,6,265,689
JHARKHAND,HAZARIBAGH,2004,86,59,11,156,71,0,71,142,33,18,15,66,60,9,66,103,537,44,493,1312,198,16,73,0,14,102,403,31,27,0,90,0,148,0,1035,2621
JHARKHAND,JAMSHEDPUR,2004,81,180,9,270,76,0,76,152,50,18,32,100,8,1,29,156,539,135,404,1272,114,60,64,0,19,93,353,12,40,0,72,0,124,3,1149,2755
JHARKHAND,JAMSHEDPUR RLY.,2004,2,0,0,2,1,0,1,2,1,1,0,2,5,0,6,6,114,4,110,245,3,0,1,0,0,0,5,0,5,0,0,0,5,1,56,201
JHARKHAND,JAMTARA,2004,18,33,2,53,25,0,25,50,13,2,11,26,4,0,6,30,69,4,65,178,39,0,5,1,2,116,164,3,14,0,18,0,35,1,135,534
JHARKHAND,KODERMA,2004,30,25,0,55,6,0,6,12,13,4,9,26,39,0,24,13,50,6,44,176,103,8,15,0,4,187,355,7,8,0,37,0,52,38,178,785
JHARKHAND,LATEHAR,2004,43,14,2,59,12,0,12,24,8,2,6,16,27,4,13,12,33,0,33,122,20,1,4,0,5,39,105,3,4,0,3,0,10,36,173,456
JHARKHAND,LOHARDAGGA,2004,44,9,1,54,14,0,14,28,2,1,1,4,3,0,22,16,29,1,28,99,23,6,4,2,3,8,46,0,4,0,12,0,16,0,230,432
JHARKHAND,PAKUR,2004,37,7,4,48,37,0,37,74,6,1,5,12,5,1,13,16,32,2,30,99,44,2,11,0,3,6,67,2,3,0,5,0,10,1,349,584
JHARKHAND,PALAMU,2004,69,48,3,120,14,0,14,28,16,8,8,32,31,0,40,111,99,4,95,380,167,4,4,0,27,327,532,24,11,0,18,34,87,3,499,1549
JHARKHAND,RANCHI,2004,270,161,0,431,55,0,55,110,67,22,45,134,85,9,181,222,729,159,570,1955,263,64,51,0,7,2,391,9,73,0,62,0,144,4,1992,4306
JHARKHAND,SAHEBGANJ,2004,45,58,2,105,26,0,26,52,22,5,17,44,5,0,17,21,98,6,92,239,65,4,19,0,4,28,148,5,22,0,19,0,46,28,242,730
JHARKHAND,SARAIKELA,2004,51,36,2,89,26,0,26,52,16,4,12,32,12,3,7,45,115,8,107,297,31,8,16,0,0,109,171,3,4,0,25,0,32,7,308,824
JHARKHAND,SIMDEGA,2004,43,22,3,68,16,0,16,32,2,1,1,4,10,0,12,16,3,3,0,44,10,0,10,0,3,1,30,1,0,0,1,0,2,6,123,282
KARNATAKA,BAGALKOT,2004,38,39,1,78,3,0,3,6,24,14,10,48,7,12,11,89,134,37,97,387,189,12,23,0,15,336,575,2,40,0,54,0,96,0,1009,2038
KARNATAKA,BANGALORE COMMR.,2004,214,285,2,501,32,0,32,64,175,61,114,350,37,73,455,1874,8241,3205,5036,18921,323,145,1534,22,3,3542,5673,44,151,35,227,0,457,104,11008,28526
KARNATAKA,BANGALORE RURAL,2004,152,88,2,242,29,0,29,58,42,20,22,84,17,0,42,539,1038,249,789,2674,477,21,142,3,17,1128,1788,31,104,0,94,0,229,0,4118,8084
KARNATAKA,BELGAUM,2004,106,81,2,189,5,0,5,10,26,12,14,52,14,1,30,188,291,114,177,815,255,14,144,0,19,773,1238,6,56,0,109,0,171,33,2504,4657
KARNATAKA,BELLARY,2004,42,31,1,74,5,0,5,10,17,12,5,34,3,1,13,118,295,70,225,725,219,6,43,1,8,518,803,5,38,1,44,0,88,8,2433,3850
KARNATAKA,BIDAR,2004,40,94,1,135,8,0,8,16,25,16,9,50,9,1,20,155,246,47,199,677,187,7,37,2,14,1112,1359,8,27,2,47,0,84,0,2003,4045
KARNATAKA,BIJAPUR,2004,66,49,4,119,8,0,8,16,21,11,10,42,6,1,16,123,121,45,76,388,242,5,29,0,19,621,916,2,96,0,73,0,171,0,1607,3109
KARNATAKA,CHAMARAJNAGAR,2004,23,16,3,42,7,0,7,14,9,2,7,18,2,0,6,99,151,9,142,409,106,5,22,1,0,520,654,4,42,0,19,0,65,0,592,1627
KARNATAKA,CHICKMAGALUR,2004,29,37,3,69,7,0,7,14,13,7,6,26,4,1,14,141,237,55,182,634,161,10,29,0,9,864,1083,5,55,4,59,0,123,10,1131,2823
KARNATAKA,CHITRADURGA,2004,32,32,4,68,16,0,16,32,7,5,2,14,5,1,10,119,252,51,201,639,315,9,23,0,6,911,1264,6,63,0,39,0,108,0,1822,3672
KARNATAKA,DAKSHIN KANNADA,2004,24,25,2,51,12,0,12,24,13,8,5,26,8,0,50,218,259,120,139,794,277,11,66,6,24,565,962,1,25,4,26,0,56,13,2504,4133
KARNATAKA,DAVANAGERE,2004,38,14,4,56,8,0,8,16,10,7,3,20,5,2,19,143,273,69,204,715,266,10,60,4,4,525,870,11,61,0,59,0,131,1,1433,2950
KARNATAKA,DHARWAD COMMR.,2004,17,17,0,34,1,0,1,2,10,6,4,20,0,0,8,101,251,106,145,611,67,11,143,2,3,201,430,3,8,1,10,0,22,3,841,1698
KARNATAKA,DHARWAD RURAL,2004,26,15,2,43,3,0,3,6,3,3,0,6,3,1,0,26,80,3,77,190,102,2,8,0,1,124,237,2,13,0,4,0,19,0,503,918
KARNATAKA,GADAG,2004,16,17,2,35,1,0,1,2,5,3,2,10,4,0,4,54,65,22,43,192,101,6,19,0,2,178,306,2,21,0,16,0,39,0,434,947
KARNATAKA,GULBARGA,2004,102,133,4,239,23,1,22,46,40,35,5,80,7,9,27,203,251,89,162,748,513,15,60,0,45,1221,1869,7,122,0,98,0,227,15,1789,4684
KARNATAKA,HASSAN,2004,61,57,0,118,16,0,16,32,19,8,11,38,4,0,49,241,413,98,315,1120,186,16,38,0,14,1252,1506,9,49,0,72,0,130,0,1802,4298
KARNATAKA,HAVERI,2004,25,11,0,36,9,0,9,18,7,0,7,14,1,0,4,66,115,24,91,301,252,9,17,1,0,284,563,2,28,0,25,0,55,0,1114,1970
KARNATAKA,K.G.F.,2004,16,11,1,28,2,0,2,4,8,7,1,16,0,0,7,58,94,35,59,253,67,1,16,0,0,251,335,7,9,0,13,0,29,0,272,833
KARNATAKA,KODAGU,2004,21,22,0,43,8,0,8,16,3,1,2,6,1,0,9,140,111,15,96,372,52,4,15,2,5,473,552,2,18,2,11,0,33,1,559,1459
KARNATAKA,KOLAR,2004,59,41,0,100,16,0,16,32,28,16,12,56,3,0,23,149,365,69,296,905,412,17,35,2,0,592,1058,28,32,0,43,0,103,0,1284,3129
KARNATAKA,KOPPAL,2004,25,9,1,35,8,0,8,16,4,4,0,8,3,0,4,66,54,12,42,181,85,13,20,1,2,160,281,6,16,0,47,0,69,0,579,1103
KARNATAKA,MANDYA,2004,58,50,0,108,15,0,15,30,8,0,8,16,3,0,17,169,302,61,241,793,270,6,20,3,0,825,1124,19,46,2,43,0,110,0,1524,3380
KARNATAKA,MYSORE COMMR.,2004,29,24,1,54,4,0,4,8,7,5,2,14,1,0,63,136,485,228,257,1170,31,8,43,3,0,319,404,4,6,0,49,0,59,0,946,2159
KARNATAKA,MYSORE RURAL,2004,44,19,2,65,11,0,11,22,11,4,7,22,3,0,12,156,233,32,201,637,191,6,20,0,0,843,1060,14,79,0,53,0,146,0,903,2600
KARNATAKA,RAICHUR,2004,43,34,11,88,6,0,6,12,11,7,4,22,3,1,13,91,110,39,71,328,194,11,51,0,6,523,801,5,57,1,67,0,130,16,1079,2333
KARNATAKA,RAILWAYS,2004,20,2,0,22,0,0,0,0,4,0,4,8,1,0,6,5,643,5,638,1298,11,2,2,7,0,25,47,0,3,0,0,0,3,0,148,879
KARNATAKA,SHIMOGA,2004,48,40,1,89,11,0,11,22,22,9,13,44,3,4,31,148,330,119,211,846,246,22,45,1,4,939,1259,5,60,2,107,0,174,2,1678,3749
KARNATAKA,TUMKUR,2004,65,56,1,122,15,0,15,30,8,0,8,16,7,1,31,285,477,97,380,1278,210,10,25,1,18,954,1289,16,61,1,33,0,111,71,1905,4251
KARNATAKA,UDUPI,2004,16,22,2,40,0,0,0,0,8,1,7,16,10,0,11,111,103,36,67,338,136,8,21,2,4,265,436,0,21,2,22,0,45,0,1476,2240
KARNATAKA,UTTAR KANNADA,2004,24,16,0,40,2,0,2,4,4,2,2,8,3,0,19,82,73,24,49,250,94,1,9,1,6,388,499,3,28,0,25,0,56,0,1518,2296
KERALA,ALAPUZHA,2004,18,15,2,35,12,0,12,24,11,6,5,22,5,0,31,191,173,82,91,573,312,25,163,2,16,1170,1688,0,132,5,213,0,350,0,4586,7082
KERALA,CBCID,2004,22,4,3,29,0,0,0,0,0,0,0,0,4,0,1,14,19,16,3,57,3,11,75,56,6,1,156,0,0,0,3,0,3,4,0,226
KERALA,ERNAKULAM COMMR.,2004,13,21,11,45,7,0,7,14,18,8,10,36,8,0,56,307,486,169,317,1343,189,15,377,0,4,555,1141,1,64,5,79,0,149,1,4539,6756
KERALA,ERNAKULAM RURAL,2004,31,24,17,72,21,0,21,42,10,5,5,20,4,0,28,232,332,98,234,928,305,11,131,1,14,152,621,5,136,2,110,0,253,7,7204,8777
KERALA,IDUKKI,2004,34,13,5,52,15,0,15,30,10,9,1,20,2,0,20,153,195,25,170,565,220,17,76,0,9,1183,1507,0,101,10,111,0,222,2,2053,4229
KERALA,KANNUR,2004,23,21,12,56,33,0,33,66,4,2,2,8,4,0,14,205,175,62,113,573,519,16,96,4,20,909,1568,0,92,7,193,0,292,4,2270,4621
KERALA,KASARGOD,2004,14,19,11,44,29,0,29,58,4,3,1,8,3,0,14,187,165,80,85,534,308,6,69,1,37,1090,1513,1,73,2,92,0,168,2,542,2669
KERALA,KOLLAM,2004,46,26,148,220,55,0,55,110,20,12,8,40,7,0,58,365,330,123,207,1090,575,11,198,5,50,2138,2978,3,287,24,337,0,651,1,4764,9448
KERALA,KOTTAYAM,2004,18,7,6,31,28,0,28,56,13,8,5,26,5,0,36,345,319,68,251,1024,272,28,368,4,14,1595,2281,1,159,12,139,0,311,0,4550,7919
KERALA,KOZHIKODE COMMR.,2004,8,20,24,52,13,0,13,26,15,5,10,30,11,0,26,307,361,162,199,1066,394,18,221,3,19,539,1194,3,65,7,147,0,222,0,1963,4164
KERALA,KOZHIKODE RURAL,2004,9,22,46,77,30,0,30,60,10,7,3,20,3,3,15,216,201,88,113,639,408,11,164,2,53,675,1313,5,96,9,241,0,351,0,2019,4238
KERALA,MALAPPURAM,2004,23,25,31,79,57,0,57,114,10,6,4,20,6,0,29,361,341,123,218,1078,584,17,293,3,23,891,1813,0,133,10,516,0,659,2,3422,6777
KERALA,PALAKKAD,2004,34,45,43,122,36,0,36,72,13,5,8,26,7,0,33,276,292,76,216,900,463,60,231,6,32,1109,1905,1,102,3,233,0,339,4,2645,5668
KERALA,PATHANAMTHITTA,2004,18,16,12,46,18,0,18,36,19,18,1,38,3,0,28,166,161,58,103,519,188,11,144,2,16,1681,2043,1,139,6,138,0,284,1,1641,4409
KERALA,RAILWAYS,2004,3,0,0,3,0,0,0,0,1,1,0,2,2,3,4,3,120,1,119,252,14,0,1,0,0,18,33,0,3,1,0,0,4,0,12,185
KERALA,THRISSUR,2004,41,52,56,149,41,0,41,82,22,10,12,44,24,0,66,387,547,226,321,1571,685,25,472,2,2,2801,3999,2,175,10,244,0,431,12,4477,10143
KERALA,TRIVANDRUM COMMR.,2004,15,27,8,50,18,0,18,36,21,17,4,42,12,4,94,349,487,139,348,1433,290,24,315,6,12,1029,1677,0,172,4,95,0,271,1,2594,5577
KERALA,TRIVANDRUM RURAL,2004,36,27,32,95,42,0,42,84,28,17,11,56,13,4,70,398,367,97,270,1219,475,17,261,0,35,1896,2684,5,273,11,268,0,557,0,4484,8742
KERALA,WAYANADU,2004,11,7,6,24,25,0,25,50,3,3,0,6,6,1,16,118,169,24,145,479,257,13,100,2,12,1178,1563,3,58,5,63,0,129,1,341,2395
MADHYA PRADESH,ANUPPUR,2004,24,4,0,28,28,0,28,56,4,3,1,8,0,1,10,106,131,25,106,379,8,3,0,0,4,177,192,4,74,7,35,0,120,0,838,1458
MADHYA PRADESH,ASHOK NAGAR,2004,22,28,5,55,35,0,35,70,3,3,0,6,1,1,11,109,152,23,129,426,25,5,4,1,15,860,949,4,89,11,14,0,118,39,520,1954
MADHYA PRADESH,BALAGHAT,2004,74,22,2,98,86,0,86,172,10,6,4,20,2,0,20,166,204,31,173,596,40,8,10,0,12,501,633,13,175,19,69,0,276,62,1558,3053
MADHYA PRADESH,BARWANI,2004,29,31,3,63,30,0,30,60,1,1,0,2,1,1,4,101,209,46,163,525,28,6,5,0,10,328,470,4,83,7,22,0,116,93,1259,2255
MADHYA PRADESH,BETUL,2004,59,43,2,104,110,0,110,220,17,15,2,34,3,2,9,149,179,37,142,521,15,0,31,2,16,461,623,18,125,16,76,0,235,98,1587,3018
MADHYA PRADESH,BHIND,2004,57,126,3,186,29,0,29,58,33,13,20,66,2,9,43,197,273,30,243,797,104,6,44,1,11,716,978,35,75,2,75,0,187,96,1865,3802
MADHYA PRADESH,BHOPAL,2004,71,91,0,162,84,0,84,168,43,38,5,86,2,4,106,950,2110,890,1220,5282,129,28,114,8,22,751,1223,29,251,30,152,0,462,171,10572,15718
MADHYA PRADESH,BHOPAL RLY.,2004,6,5,0,11,1,0,1,2,1,0,1,2,0,0,24,10,1295,19,1276,2624,3,1,11,1,0,19,37,0,9,1,1,0,11,2,283,1673
MADHYA PRADESH,BURHANPUR,2004,22,18,3,43,18,0,18,36,2,2,0,4,9,0,3,66,133,28,105,344,15,2,6,0,4,113,163,3,64,11,0,0,78,23,1008,1523
MADHYA PRADESH,CHHATARPUR,2004,56,44,2,102,62,0,62,124,19,14,5,38,3,2,36,244,206,0,206,697,40,9,16,0,27,482,644,17,160,20,55,0,252,70,1958,3528
MADHYA PRADESH,CHHINDWARA,2004,66,28,2,96,132,0,132,264,15,12,3,30,2,2,15,195,278,91,187,770,47,10,30,1,12,1149,1366,8,204,31,138,0,381,117,1644,4126
MADHYA PRADESH,DAMOH,2004,49,58,0,107,54,0,54,108,9,2,7,18,2,1,24,151,164,35,129,506,13,6,9,0,18,1041,1143,23,150,0,52,0,225,56,765,2645
MADHYA PRADESH,DATIYA,2004,60,54,0,114,25,0,25,50,18,11,7,36,1,3,29,107,156,27,129,452,34,4,13,0,13,415,528,6,71,0,32,0,109,49,999,2089
MADHYA PRADESH,DEWAS,2004,48,93,0,141,82,0,82,164,30,21,9,60,10,7,70,315,853,165,688,2108,107,14,47,0,40,459,817,16,193,55,216,0,480,150,4392,7197
MADHYA PRADESH,DHAR,2004,100,78,0,178,109,0,109,218,30,29,1,60,5,1,38,249,535,139,396,1363,69,30,12,0,28,688,978,48,154,18,112,0,332,151,2590,5045
MADHYA PRADESH,DINDORI,2004,14,13,1,28,34,0,34,68,3,3,0,6,0,0,4,46,38,9,29,126,6,4,9,0,2,100,144,1,61,4,11,0,77,23,452,826
MADHYA PRADESH,GUNA,2004,45,32,8,85,78,0,78,156,6,4,2,12,1,10,21,238,271,63,208,812,68,5,9,0,17,968,1181,10,161,13,42,0,226,114,1304,3421
MADHYA PRADESH,GWALIOR,2004,86,145,13,244,58,0,58,116,52,34,18,104,8,6,109,882,1350,643,707,3705,140,23,82,6,19,961,1436,31,180,9,147,0,367,205,3916,8428
MADHYA PRADESH,HARDA,2004,15,17,0,32,31,0,31,62,3,3,0,6,0,0,15,83,95,33,62,288,18,2,11,0,2,393,426,5,30,3,14,0,52,0,355,1092
MADHYA PRADESH,HOSHANGABAD,2004,50,63,76,189,51,0,51,102,20,14,6,40,2,7,29,264,371,95,276,1044,33,7,47,1,15,515,618,8,132,11,71,0,222,0,1711,3484
MADHYA PRADESH,INDORE,2004,107,136,6,249,97,0,97,194,47,30,17,94,10,4,121,838,2610,1337,1273,6193,117,97,149,1,30,1270,2031,35,269,69,294,0,667,367,8676,15350
MADHYA PRADESH,INDORE RLY.,2004,3,0,2,5,1,0,1,2,0,0,0,0,0,0,5,3,149,0,149,306,0,0,2,0,0,11,13,0,5,0,0,0,5,0,107,288
MADHYA PRADESH,JABALPUR,2004,84,178,0,262,102,0,102,204,39,26,13,78,4,8,79,596,1048,539,509,2783,82,27,119,4,46,3487,3974,42,227,113,115,0,497,209,2915,9524
MADHYA PRADESH,JABALPUR RLY.,2004,4,3,0,7,7,0,7,14,0,0,0,0,0,3,15,4,289,5,284,600,1,0,3,0,0,10,14,0,5,2,0,0,7,0,169,515
MADHYA PRADESH,JHABUA,2004,139,87,2,228,22,0,22,44,43,42,1,86,2,1,12,89,183,37,146,470,27,2,3,0,42,574,648,1,73,0,12,0,86,0,1252,2566
MADHYA PRADESH,KATNI,2004,33,18,2,53,30,0,30,60,4,3,1,8,0,4,14,172,186,68,118,562,29,5,24,1,8,959,1121,19,130,11,67,0,227,95,705,2516
MADHYA PRADESH,KHANDWA,2004,36,38,0,74,57,0,57,114,14,12,2,28,6,1,26,281,290,76,214,894,39,16,23,0,9,41,207,12,188,37,49,0,286,79,2549,3791
MADHYA PRADESH,KHARGON,2004,32,39,4,75,63,0,63,126,18,15,3,36,4,5,22,263,755,63,692,1804,76,19,27,0,16,1298,1523,12,194,25,77,0,308,87,1331,4367
MADHYA PRADESH,MANDLA,2004,22,11,0,33,44,0,44,88,4,2,2,8,0,1,10,85,65,4,61,226,16,1,14,0,5,357,453,6,110,16,30,0,162,60,1128,1985
MADHYA PRADESH,MANDSAUR,2004,27,35,0,62,40,0,40,80,17,9,8,34,0,4,35,199,503,114,389,1244,34,18,18,1,17,360,516,8,128,20,68,0,224,68,1397,2997
MADHYA PRADESH,MORENA,2004,66,144,3,213,55,0,55,110,15,11,4,30,7,9,42,208,375,78,297,1016,168,6,31,0,15,1048,1397,33,89,3,62,0,187,129,2468,4976
MADHYA PRADESH,NARSINGHPUR,2004,33,49,0,82,42,0,42,84,4,4,0,8,1,1,6,110,136,22,114,390,21,4,13,0,15,1020,1160,18,130,10,48,0,206,87,601,2349
MADHYA PRADESH,NEEMUCH,2004,18,23,1,42,23,0,23,46,6,5,1,12,2,2,15,201,319,95,224,858,50,43,17,0,9,403,573,4,62,10,60,0,136,51,885,2204
MADHYA PRADESH,PANNA,2004,41,37,1,79,34,0,34,68,10,0,10,20,4,1,13,110,84,10,74,296,7,1,4,1,13,68,125,15,65,0,28,0,108,31,816,1384
MADHYA PRADESH,RAISEN,2004,44,55,0,99,67,0,67,134,11,8,3,22,0,0,12,115,208,45,163,543,38,3,20,0,1,312,503,15,198,0,66,0,279,129,2064,3358
MADHYA PRADESH,RAJGARH,2004,30,45,2,77,98,0,98,196,19,14,5,38,13,1,41,281,458,68,390,1252,119,4,11,0,85,415,723,4,193,31,126,0,354,89,3033,5098
MADHYA PRADESH,RATLAM,2004,42,35,2,79,71,0,71,142,19,16,3,38,1,5,11,148,392,99,293,949,40,18,37,3,20,307,502,5,109,30,60,0,204,77,2229,3661
MADHYA PRADESH,REWA,2004,65,28,0,93,52,0,52,104,36,18,18,72,3,3,74,707,486,155,331,1759,76,4,23,1,31,630,909,39,123,3,50,0,215,144,1900,4478
MADHYA PRADESH,SAGAR,2004,69,89,0,158,141,0,141,282,30,23,7,60,0,0,40,348,449,75,374,1286,87,12,20,0,28,2591,2843,40,338,26,161,0,565,105,2569,7143
MADHYA PRADESH,SATNA,2004,60,65,2,127,64,0,64,128,17,3,14,34,4,5,43,421,407,149,258,1287,35,14,22,0,27,998,1283,33,180,6,64,0,283,187,2223,4877
MADHYA PRADESH,SEONI,2004,21,24,3,48,74,0,74,148,10,10,0,20,0,0,8,126,111,21,90,356,22,7,13,0,10,405,529,17,117,11,23,0,168,72,1204,2278
MADHYA PRADESH,SHAHDOL,2004,36,18,0,54,47,0,47,94,10,9,1,20,0,3,19,230,227,33,194,706,12,1,8,0,11,266,298,8,135,0,72,0,215,0,1415,2518
MADHYA PRADESH,SHAJAPUR,2004,40,53,1,94,74,0,74,148,15,11,4,30,6,1,63,277,639,93,546,1625,114,20,15,1,35,1166,1426,15,180,28,96,0,319,75,1081,3995
MADHYA PRADESH,SHEOPUR,2004,12,14,0,26,21,0,21,42,5,3,2,10,0,3,4,53,90,12,78,240,27,2,4,0,4,309,359,3,51,0,22,0,76,13,416,1053
MADHYA PRADESH,SHIVPURI,2004,78,49,0,127,61,0,61,122,28,13,15,56,7,4,32,196,304,68,236,847,53,1,14,0,22,390,581,7,113,0,36,0,156,101,2328,3824
MADHYA PRADESH,SIDHI,2004,61,19,2,82,51,0,51,102,27,22,5,54,1,0,29,358,263,29,234,914,31,14,20,1,13,565,759,17,161,2,59,0,239,115,1910,3719
MADHYA PRADESH,SIHORE,2004,31,30,1,62,62,0,62,124,5,4,1,10,6,0,11,129,384,56,328,914,18,6,15,0,17,405,558,6,90,14,46,0,156,97,1669,3042
MADHYA PRADESH,TIKAMGARH,2004,59,42,0,101,43,0,43,86,11,5,6,22,0,6,22,189,214,26,188,645,27,3,18,0,22,897,1013,24,133,7,37,0,201,46,1123,2923
MADHYA PRADESH,UJJAIN,2004,62,136,0,198,65,0,65,130,36,27,9,72,10,2,58,617,1592,278,1314,3871,100,20,48,1,29,709,1024,13,187,36,192,0,428,117,4655,8685
MADHYA PRADESH,UMARIYA,2004,23,14,32,69,30,0,30,60,2,1,1,4,2,0,10,115,95,0,95,317,14,0,18,0,5,193,235,6,63,8,24,0,101,5,553,1212
MADHYA PRADESH,VIDISHA,2004,48,56,2,106,100,0,100,200,11,10,1,22,0,0,14,211,272,64,208,769,57,7,24,0,21,724,888,11,203,18,58,0,290,55,1964,3856
MAHARASHTRA,AHMEDNAGAR,2004,98,57,0,155,41,0,41,82,25,13,12,50,30,10,108,309,969,289,680,2395,175,25,114,1,35,618,1420,0,73,0,277,0,350,452,1321,4738
MAHARASHTRA,AKOLA,2004,55,45,0,100,38,0,38,76,23,21,2,46,15,1,57,314,957,99,858,2301,108,23,88,6,30,843,1200,6,94,15,147,0,262,102,1387,4354
MAHARASHTRA,AMRAVATI COMMR.,2004,19,20,4,43,17,0,17,34,21,18,3,42,0,1,45,242,838,172,666,1964,95,19,37,3,20,417,654,1,40,20,54,0,115,63,764,2740
MAHARASHTRA,AMRAVATI RURAL,2004,60,28,7,95,56,0,56,112,20,19,1,40,7,8,21,305,888,40,848,2117,95,10,26,0,62,832,1149,9,127,24,104,0,264,124,847,3660
MAHARASHTRA,AURANGABAD COMMR.,2004,31,17,0,48,12,0,12,24,15,14,1,30,13,7,36,194,603,192,411,1456,114,8,106,1,3,324,683,5,21,7,132,0,165,127,550,2326
MAHARASHTRA,AURANGABAD RURAL,2004,41,21,0,62,10,0,10,20,11,6,5,22,22,15,44,123,330,39,291,864,157,10,28,1,33,761,1195,20,57,16,225,0,318,205,647,2777
MAHARASHTRA,BEED,2004,57,42,1,100,24,0,24,48,19,16,3,38,41,5,59,294,727,143,584,1853,391,21,45,1,39,960,1644,4,82,13,246,0,345,187,678,3936
MAHARASHTRA,BHANDARA,2004,22,11,6,39,36,0,36,72,16,16,0,32,1,0,12,206,492,51,441,1203,77,5,15,7,49,458,724,1,66,39,52,0,158,113,866,2550
MAHARASHTRA,BULDHANA,2004,48,35,2,85,39,0,39,78,20,16,4,40,23,2,38,183,745,93,652,1736,131,23,57,6,71,778,1232,18,106,33,195,0,352,166,986,3705
MAHARASHTRA,CHANDRAPUR,2004,59,19,5,83,31,0,31,62,18,17,1,36,11,3,24,326,673,75,598,1710,126,18,59,3,39,625,1075,3,93,27,94,0,217,205,1078,3539
MAHARASHTRA,DHULE,2004,32,16,3,51,11,0,11,22,3,3,0,6,10,2,8,98,266,57,209,650,88,25,42,0,1,336,715,1,24,9,96,0,130,223,748,2042
MAHARASHTRA,GADCHIROLI,2004,47,49,1,97,31,0,31,62,8,8,0,16,5,0,11,126,152,15,137,446,26,18,18,3,49,270,442,3,44,11,46,0,104,58,391,1367
MAHARASHTRA,GONDIA,2004,27,11,1,39,30,0,30,60,21,19,2,42,5,0,23,179,317,36,281,841,47,6,18,8,20,352,545,2,85,10,54,0,151,94,588,1898
MAHARASHTRA,HINGOLI,2004,35,25,2,62,13,0,13,26,15,12,3,30,10,0,34,113,202,19,183,561,83,10,27,2,29,481,723,1,29,11,85,0,126,91,391,1689
MAHARASHTRA,JALGAON,2004,83,39,2,124,36,0,36,72,12,12,0,24,13,1,40,218,652,121,531,1576,169,57,211,4,20,771,1548,6,83,38,323,0,450,316,1242,4336
MAHARASHTRA,JALNA,2004,53,30,0,83,10,0,10,20,10,6,4,20,15,1,39,199,338,67,271,930,151,10,52,2,36,632,1014,24,49,12,226,0,311,131,583,2603
MAHARASHTRA,KOLHAPUR,2004,54,54,4,112,15,0,15,30,20,14,6,40,6,1,28,215,621,202,419,1492,127,53,70,5,19,523,1035,29,34,15,78,0,156,238,923,3132
MAHARASHTRA,LATUR,2004,61,31,4,96,22,0,22,44,19,19,0,38,7,5,31,224,366,57,309,999,188,21,50,1,30,1077,1529,39,36,0,82,0,157,162,926,3382
MAHARASHTRA,MUMBAI,2004,253,127,4,384,187,0,187,374,178,113,65,356,42,68,302,2978,11510,3247,8263,26410,213,510,1427,96,10,3702,6693,13,321,78,248,0,660,735,6451,29453
MAHARASHTRA,MUMBAI RLY.,2004,7,4,2,13,1,0,1,2,2,1,1,4,2,2,29,5,1772,2,1770,3582,8,13,31,3,0,32,89,0,9,3,0,0,12,2,93,2020
MAHARASHTRA,NAGPUR COMMR.,2004,112,56,2,170,41,0,41,82,49,38,11,98,21,33,178,1107,2447,919,1528,6233,199,37,194,6,22,915,1601,9,41,52,156,0,258,228,2613,8518
MAHARASHTRA,NAGPUR RLY.,2004,5,1,0,6,2,0,2,4,2,0,2,4,2,0,13,1,1024,8,1016,2064,10,4,4,10,0,26,56,0,5,1,0,0,6,2,137,1249
MAHARASHTRA,NAGPUR RURAL,2004,71,27,7,105,48,0,48,96,27,22,5,54,5,7,49,321,1075,93,982,2532,128,20,49,2,54,829,1435,8,104,44,83,0,239,353,1573,4884
MAHARASHTRA,NANDED,2004,91,82,3,176,31,0,31,62,23,16,7,46,24,17,68,395,619,96,523,1742,235,23,79,3,72,1492,2056,16,78,12,198,0,304,152,1974,5687
MAHARASHTRA,NANDURBAR,2004,35,17,0,52,20,0,20,40,9,8,1,18,5,1,5,78,197,33,164,483,68,12,29,1,5,237,441,1,30,6,82,0,119,89,320,1247
MAHARASHTRA,NASIK COMMR.,2004,19,13,4,36,15,0,15,30,17,12,5,34,6,2,17,350,808,295,513,1991,80,15,148,0,6,228,621,4,26,15,126,0,171,144,563,2606
MAHARASHTRA,NASIK RURAL,2004,97,41,2,140,33,0,33,66,24,18,6,48,13,11,29,240,462,97,365,1217,293,37,130,5,17,808,1759,11,86,43,371,0,511,469,1122,4344
MAHARASHTRA,NAVI MUMBAI,2004,61,32,0,93,17,0,17,34,19,14,5,38,30,24,99,323,1086,518,568,2648,97,41,174,1,4,444,1130,2,33,5,51,0,91,369,776,3688
MAHARASHTRA,OSMANABAD,2004,46,15,1,62,26,0,26,52,12,11,1,24,9,1,22,168,331,44,287,862,134,9,58,1,8,617,997,1,35,9,105,0,150,170,640,2418
MAHARASHTRA,PARBHANI,2004,42,31,1,74,13,0,13,26,12,8,4,24,12,3,51,171,292,50,242,821,109,14,44,2,24,982,1270,4,45,7,132,0,188,95,358,2444
MAHARASHTRA,PUNE COMMR.,2004,100,76,3,179,63,0,63,126,70,51,19,140,24,13,130,843,3905,2076,1829,8820,524,67,433,2,9,1153,2615,0,67,98,174,0,339,427,2573,10754
MAHARASHTRA,PUNE RLY.,2004,4,0,0,4,0,0,0,0,0,0,0,0,1,1,4,0,132,0,132,270,3,1,0,0,0,4,9,0,0,1,0,0,1,1,34,186
MAHARASHTRA,PUNE RURAL,2004,132,31,7,170,31,0,31,62,26,18,8,52,32,10,70,360,854,310,544,2180,137,42,120,1,20,503,1551,10,72,13,154,0,249,728,1477,4830
MAHARASHTRA,RAIGAD,2004,61,14,0,75,19,0,19,38,13,6,7,26,24,7,19,148,253,41,212,704,146,37,46,1,12,268,774,2,50,3,47,0,102,264,693,2127
MAHARASHTRA,RATNAGIRI,2004,16,8,1,25,23,0,23,46,6,5,1,12,2,0,12,154,196,27,169,560,76,20,34,0,23,189,468,1,40,12,44,0,97,126,318,1301
MAHARASHTRA,SANGLI,2004,69,26,0,95,30,0,30,60,14,9,5,28,15,5,21,240,566,117,449,1413,122,32,158,3,18,380,918,3,31,11,85,0,130,205,554,2588
MAHARASHTRA,SATARA,2004,59,28,1,88,22,0,22,44,20,14,6,40,15,2,36,242,589,166,423,1473,111,26,48,3,23,431,958,7,38,8,169,0,222,316,1094,3288
MAHARASHTRA,SINDHUDURG,2004,10,4,2,16,5,0,5,10,5,5,0,10,0,0,11,74,105,15,90,295,45,4,12,0,11,133,285,0,18,5,6,0,29,80,261,791
MAHARASHTRA,SOLAPUR COMMR.,2004,20,13,0,33,19,0,19,38,10,7,3,20,6,3,39,207,360,103,257,975,55,8,121,1,3,197,466,2,13,2,60,0,77,81,517,1737
MAHARASHTRA,SOLAPUR RURAL,2004,96,43,9,148,41,0,41,82,18,10,8,36,16,5,34,166,435,113,322,1091,140,24,23,1,14,565,1104,10,55,20,124,0,209,337,814,2990
MAHARASHTRA,THANE COMMR.,2004,115,72,1,188,57,0,57,114,67,46,21,134,33,18,159,1089,2114,831,1283,5527,244,76,523,8,12,1657,2791,7,87,36,190,0,320,271,450,7286
MAHARASHTRA,THANE RURAL,2004,144,44,5,193,60,0,60,120,42,26,16,84,37,12,83,494,623,184,439,1872,193,54,112,2,25,760,1632,10,100,41,105,0,256,486,818,4250
MAHARASHTRA,WARDHA,2004,42,25,3,70,31,0,31,62,25,25,0,50,6,5,41,241,619,39,580,1531,65,18,43,1,63,840,1165,5,104,7,70,0,186,135,1303,3692
MAHARASHTRA,WASHIM,2004,28,21,2,51,19,0,19,38,17,16,1,34,6,0,17,121,418,24,394,980,111,9,19,4,46,495,753,5,71,7,144,0,227,69,604,2233
MAHARASHTRA,YAVATMAL,2004,79,62,13,154,62,0,62,124,42,39,3,84,7,3,33,275,1024,92,932,2366,86,13,45,7,63,1177,1574,11,129,23,206,0,369,183,1374,4917
MANIPUR,BISHNUPUR,2004,19,48,0,67,3,0,3,6,14,8,6,28,0,2,0,5,26,0,26,59,14,0,3,0,29,36,82,0,7,0,1,0,8,0,76,283
MANIPUR,CHANDEL,2004,6,13,0,19,1,0,1,2,1,0,1,2,0,0,0,5,4,0,4,13,0,0,0,1,0,1,2,0,0,0,0,0,0,0,32,64
MANIPUR,CHURACHANDPUR,2004,26,18,2,46,0,0,0,0,7,1,6,14,0,0,0,3,8,0,8,19,0,0,1,1,0,0,2,0,0,0,0,0,0,0,54,120
MANIPUR,IMPHAL(EAST),2004,24,30,0,54,7,0,7,14,23,16,7,46,0,0,1,7,27,9,18,62,28,1,85,0,21,47,182,0,2,0,0,0,2,0,164,467
MANIPUR,IMPHAL(WEST),2004,28,58,1,87,9,0,9,18,38,26,12,76,1,0,1,40,142,98,44,326,55,13,42,2,25,106,277,0,19,0,0,0,19,34,439,1053
MANIPUR,SENAPATI,2004,7,11,0,18,0,0,0,0,7,0,7,14,0,0,1,1,8,0,8,18,5,6,2,0,0,0,13,0,0,0,0,0,0,0,69,117
MANIPUR,TAMENGLONG,2004,1,1,0,2,0,0,0,0,5,0,5,10,0,0,0,0,7,0,7,14,0,1,1,0,0,0,2,0,0,0,0,0,0,0,21,37
MANIPUR,THOUBAL,2004,38,46,0,84,11,0,11,22,32,20,12,64,0,0,0,3,14,1,13,31,10,3,7,0,10,43,74,0,2,0,1,0,3,1,125,346
MANIPUR,UKHRUL,2004,10,2,0,12,0,0,0,0,1,0,1,2,1,0,0,2,8,0,8,19,3,1,1,0,0,0,5,0,0,0,0,0,0,0,19,48
MEGHALAYA,GARO HILLS EAST,2004,7,9,1,17,0,0,0,0,3,0,3,6,5,0,10,18,18,0,18,69,0,1,1,0,2,2,6,0,1,0,0,0,1,0,20,98
MEGHALAYA,GARO HILLS SOUTH,2004,5,2,0,7,1,0,1,2,2,0,2,4,4,0,1,0,9,0,9,23,0,0,0,0,0,2,2,0,0,0,0,0,0,0,7,33
MEGHALAYA,GARO HILLS WEST,2004,17,13,2,32,12,0,12,24,10,4,6,20,14,0,3,16,31,0,31,95,2,4,3,2,0,36,56,1,10,0,0,0,11,9,27,212
MEGHALAYA,JAINTIA HILLS,2004,32,3,2,37,11,0,11,22,6,1,5,12,14,1,5,20,61,14,47,162,0,2,2,0,8,38,62,0,5,0,0,0,5,12,83,305
MEGHALAYA,KHASI HILLS EAST,2004,33,12,1,46,17,0,17,34,29,12,17,58,28,0,46,75,228,115,113,605,0,16,34,0,2,16,82,1,13,0,5,0,19,14,192,762
MEGHALAYA,KHASI HILLS WEST,2004,14,1,0,15,9,0,9,18,2,0,2,4,6,0,6,12,25,0,25,74,0,1,2,0,0,12,15,0,3,0,0,0,3,0,30,123
MEGHALAYA,RI-BHOI,2004,16,2,1,19,4,0,4,8,2,1,1,4,20,1,10,1,46,9,37,124,0,1,2,0,3,17,39,0,2,0,0,0,2,16,75,219
MIZORAM,AIZAWL,2004,10,7,1,18,6,0,6,12,6,0,6,12,3,0,2,70,350,0,350,775,1,6,5,2,6,15,35,0,30,0,0,0,30,0,150,670
MIZORAM,CHAMPHAI,2004,6,4,0,10,3,0,3,6,2,0,2,4,1,0,1,50,50,0,50,152,0,4,2,0,3,10,19,0,5,0,0,0,5,0,20,161
MIZORAM,KOLASIB,2004,4,2,0,6,2,0,2,4,1,0,1,2,1,0,1,5,5,0,5,17,0,1,2,0,1,15,19,0,2,0,0,0,2,0,5,47
MIZORAM,LAWNGTLAI,2004,3,1,0,4,1,0,1,2,1,0,1,2,1,0,1,20,30,0,30,82,0,4,3,1,3,5,16,0,5,0,0,0,5,0,20,99
MIZORAM,LUNGLEI,2004,4,3,1,8,2,0,2,4,2,0,2,4,2,0,1,30,100,0,100,233,1,5,4,1,4,10,25,0,10,0,0,0,10,0,70,250
MIZORAM,MAMIT,2004,3,1,0,4,2,0,2,4,1,0,1,2,1,0,0,5,5,0,5,16,0,1,1,0,1,10,13,0,2,0,0,0,2,0,5,38
MIZORAM,SAIHA,2004,3,2,0,5,1,0,1,2,1,0,1,2,1,0,0,20,50,0,50,121,0,4,1,1,3,5,14,0,10,0,0,0,10,0,40,142
MIZORAM,SERCHHIP,2004,2,1,0,3,3,0,3,6,1,0,1,2,0,0,0,50,20,0,20,90,0,5,2,1,1,10,19,0,2,0,0,0,2,0,10,108
NAGALAND,DIMAPUR,2004,22,5,0,27,2,0,2,4,9,4,5,18,4,0,93,23,85,7,78,290,0,1,8,0,0,3,12,0,0,0,0,0,0,0,78,333
NAGALAND,KIPHIRE,2004,0,1,0,1,0,0,0,0,0,0,0,0,2,0,1,0,10,0,10,23,0,0,0,0,0,1,1,0,0,0,0,0,0,0,6,21
NAGALAND,KOHIMA,2004,12,5,0,17,10,0,10,20,9,0,9,18,3,0,14,16,36,11,25,105,0,4,8,0,1,8,44,0,2,0,0,0,2,23,51,202
NAGALAND,MOKOKCHUNG,2004,6,3,0,9,1,0,1,2,1,0,1,2,0,0,1,8,9,2,7,27,0,0,2,0,2,11,20,0,0,1,0,0,1,5,12,62
NAGALAND,MON,2004,6,6,0,12,0,0,0,0,2,0,2,4,3,0,4,2,33,2,31,75,0,1,6,0,0,10,19,0,0,0,0,0,0,2,21,96
NAGALAND,PEREN,2004,3,1,1,5,2,0,2,4,0,0,0,0,0,0,0,1,3,0,3,7,0,0,1,0,0,0,1,0,0,0,0,0,0,0,2,14
NAGALAND,PHEK,2004,6,2,2,10,1,0,1,2,0,0,0,0,0,0,0,5,4,0,4,13,0,1,2,0,1,6,10,0,1,0,0,0,1,0,13,44
NAGALAND,TUENSANG,2004,10,3,0,13,1,0,1,2,0,0,0,0,0,0,2,5,9,0,9,25,5,1,0,0,0,1,7,0,0,0,0,0,0,0,21,58
NAGALAND,WOKHA,2004,4,4,1,9,0,0,0,0,2,0,2,4,0,0,0,2,41,2,39,84,1,2,1,0,1,5,11,0,0,0,0,0,0,1,20,85
NAGALAND,ZUNHEBOTO,2004,1,3,1,5,1,0,1,2,0,0,0,0,2,0,2,8,25,2,23,62,0,1,0,0,0,7,11,0,0,0,0,0,0,3,15,69
ODISHA,ANGUL,2004,51,40,0,91,27,0,27,54,10,10,0,20,12,0,19,92,222,12,210,567,94,14,36,0,13,24,378,13,81,0,63,0,157,197,881,1889
ODISHA,BALASORE,2004,29,21,0,50,44,0,44,88,35,31,4,70,7,0,32,138,197,34,163,571,46,10,21,5,23,191,296,41,129,19,28,0,217,0,1488,2504
ODISHA,BARAGARH,2004,33,40,2,75,22,0,22,44,14,14,0,28,6,0,19,58,155,27,128,393,81,4,32,1,12,44,267,8,63,11,90,0,172,93,611,1399
ODISHA,BERHAMPUR,2004,18,47,3,68,16,0,16,32,13,12,1,26,4,0,43,56,164,45,119,431,36,8,31,0,3,9,157,6,54,0,53,0,113,70,518,1152
ODISHA,BHADRAK,2004,23,39,0,62,31,0,31,62,17,17,0,34,5,0,13,56,95,13,82,264,39,8,22,0,14,10,148,8,63,15,70,0,156,55,1079,1662
ODISHA,BOLANGIR,2004,32,58,0,90,33,0,33,66,6,1,5,12,0,0,31,83,146,22,124,406,92,6,17,0,7,53,228,6,94,6,43,0,149,53,901,1667
ODISHA,BOUDH,2004,9,4,1,14,7,0,7,14,4,4,0,8,2,0,3,28,42,0,42,117,22,0,2,0,9,161,194,2,41,1,19,0,63,0,40,397
ODISHA,CUTTACK,2004,41,120,0,161,45,0,45,90,51,38,13,102,29,0,129,296,729,303,426,1912,77,20,84,0,17,189,560,50,64,4,126,0,244,173,1729,3973
ODISHA,DEOGARH,2004,15,10,0,25,13,0,13,26,3,3,0,6,3,0,9,17,40,4,36,109,18,3,4,0,5,130,181,1,37,1,17,0,56,21,123,470
ODISHA,DHENKANAL,2004,35,50,0,85,19,0,19,38,20,17,3,40,9,0,24,67,112,11,101,324,95,8,19,0,23,84,336,12,97,18,25,0,152,107,645,1469
ODISHA,GAJAPATI,2004,17,6,1,24,5,0,5,10,7,7,0,14,1,0,1,25,26,5,21,79,21,7,7,0,4,10,84,0,23,4,8,0,35,35,194,402
ODISHA,GANJAM,2004,62,77,3,142,15,0,15,30,18,11,7,36,13,0,37,116,182,30,152,530,95,6,22,0,24,180,538,21,155,4,30,0,210,211,651,1922
ODISHA,JAGATSINGHPUR,2004,27,32,3,62,19,0,19,38,29,18,11,58,4,0,31,73,129,13,116,366,24,4,13,0,13,117,319,14,10,2,32,0,58,148,623,1347
ODISHA,JAJPUR,2004,27,25,0,52,15,0,15,30,21,21,0,42,10,0,42,102,168,0,168,490,72,7,11,0,13,272,473,21,25,4,64,0,114,98,781,1778
ODISHA,JHARSUGUDA,2004,15,14,0,29,12,0,12,24,9,7,2,18,4,0,4,39,91,21,70,229,22,7,7,1,7,5,267,0,41,2,4,0,47,218,385,887
ODISHA,KALAHANDI,2004,21,19,2,42,22,0,22,44,11,7,4,22,5,0,26,58,81,20,61,251,59,2,58,1,6,56,220,2,33,6,20,0,61,38,344,870
ODISHA,KANDHAMAL,2004,23,14,0,37,26,0,26,52,17,12,5,34,1,0,13,70,62,6,56,208,22,3,2,0,12,431,470,2,67,4,42,0,115,0,12,823
ODISHA,KENDRAPARA,2004,31,24,0,55,19,0,19,38,8,7,1,16,7,0,19,56,76,5,71,234,18,2,7,3,11,42,83,29,9,0,10,0,48,0,623,994
ODISHA,KEONJHAR,2004,60,39,0,99,39,0,39,78,14,14,0,28,1,0,24,56,172,26,146,425,56,11,14,0,25,144,539,16,87,6,15,0,124,289,865,1933
ODISHA,KHURDA,2004,61,62,1,124,44,0,44,88,57,42,15,114,39,0,174,561,1130,541,589,3034,69,43,188,0,20,1198,1685,20,49,7,64,0,140,167,1383,5337
ODISHA,KORAPUT,2004,56,29,0,85,40,0,40,80,20,16,4,40,20,0,28,112,109,16,93,378,72,13,20,0,7,58,242,1,82,2,46,0,131,72,800,1587
ODISHA,MALKANGIR,2004,43,34,2,79,19,0,19,38,2,2,0,4,2,0,4,22,42,1,41,112,7,5,3,0,8,61,105,1,28,3,12,0,44,21,188,507
ODISHA,MAYURBHANJ,2004,77,66,1,144,84,0,84,168,26,25,1,52,5,0,29,115,229,21,208,607,25,17,24,0,12,23,253,21,102,0,125,0,248,152,1101,2234
ODISHA,NAYAGARH,2004,30,19,1,50,17,0,17,34,20,14,6,40,5,0,20,48,110,12,98,293,11,8,13,0,8,253,321,1,11,3,10,0,25,28,226,842
ODISHA,NOWRANGPUR,2004,14,19,1,34,16,0,16,32,13,11,2,26,8,0,14,53,51,5,46,177,40,5,11,0,6,54,138,0,33,4,24,0,61,22,295,683
ODISHA,NUAPADA,2004,6,5,1,12,10,0,10,20,7,6,1,14,1,0,7,24,56,9,47,144,36,9,8,0,1,38,109,1,22,4,10,0,37,17,441,704
ODISHA,PURI,2004,40,116,0,156,36,0,36,72,30,24,6,60,6,0,49,134,282,47,235,753,44,7,25,0,16,89,260,19,22,8,17,0,66,79,1508,2527
ODISHA,RAYAGADA,2004,25,20,1,46,19,0,19,38,4,0,4,8,5,0,5,35,69,3,66,183,47,5,17,0,5,50,173,0,59,2,36,0,97,49,498,951
ODISHA,ROURKELA,2004,14,30,1,45,10,0,10,20,9,8,1,18,2,0,19,118,212,75,137,563,10,7,29,2,3,21,111,1,56,6,39,0,102,39,643,1271
ODISHA,SAMBALPUR,2004,43,49,0,92,22,0,22,44,16,10,6,32,9,0,38,151,233,37,196,664,37,7,19,1,5,173,242,0,57,8,25,0,90,0,948,1841
ODISHA,SONEPUR,2004,9,14,0,23,5,0,5,10,1,1,0,2,1,0,8,21,40,2,38,110,9,1,5,0,2,17,39,0,29,3,7,0,39,5,198,375
ODISHA,SRP(CUTTACK),2004,4,0,0,4,0,0,0,0,3,3,0,6,1,0,8,4,269,18,251,551,1,0,2,0,0,16,19,0,3,0,1,0,4,0,90,402
ODISHA,SRP(ROURKELA),2004,7,3,0,10,2,0,2,4,0,0,0,0,1,0,5,16,86,2,84,194,3,0,2,0,0,6,14,0,2,0,0,0,2,3,92,228
ODISHA,SUNDARGARH,2004,68,52,1,121,17,0,17,34,11,10,1,22,10,0,25,92,160,15,145,447,33,14,30,0,9,729,1007,2,83,13,17,0,115,192,154,1712
PUNJAB,AMRITSAR,2004,48,50,4,102,25,0,25,50,31,23,8,62,1,3,6,102,181,122,59,474,0,24,206,6,4,189,507,7,9,0,54,0,70,78,416,1444
PUNJAB,BARNALA,2004,12,18,11,41,13,0,13,26,8,2,6,16,1,5,5,40,49,13,36,149,0,11,60,0,0,59,171,0,5,0,18,0,23,41,118,474
PUNJAB,BATALA,2004,27,33,1,61,8,0,8,16,8,5,3,16,0,1,0,36,50,17,33,137,0,6,64,2,0,110,223,2,5,0,14,0,21,41,157,565
PUNJAB,BHATINDA,2004,36,33,17,86,22,0,22,44,26,16,10,52,0,1,0,138,124,68,56,387,0,17,161,0,1,236,417,5,23,0,40,0,68,2,437,1319
PUNJAB,FARIDKOT,2004,19,18,0,37,13,0,13,26,15,13,2,30,0,0,2,48,47,20,27,144,0,2,75,0,0,155,232,1,9,1,19,0,30,0,187,611
PUNJAB,FATEHGARH SAHIB,2004,26,6,4,36,4,0,4,8,10,4,6,20,0,5,1,31,46,18,28,129,0,15,61,1,0,85,250,4,10,1,14,0,29,88,145,557
PUNJAB,FEROZEPUR,2004,50,44,1,95,30,0,30,60,19,13,6,38,1,4,2,102,165,58,107,439,0,20,113,5,5,385,629,6,16,0,49,0,71,101,364,1482
PUNJAB,G.R.P,2004,9,2,1,12,0,0,0,0,0,0,0,0,0,0,1,0,30,4,26,61,16,2,20,2,0,11,51,1,6,0,0,0,7,0,260,361
PUNJAB,GURDASPUR,2004,19,15,10,44,16,0,16,32,8,6,2,16,0,0,2,56,59,23,36,176,0,10,28,3,2,101,258,3,6,0,18,0,27,114,254,724
PUNJAB,HOSHIARPUR,2004,35,27,8,70,23,0,23,46,21,13,8,42,3,4,3,67,75,23,52,227,0,9,119,4,5,263,568,13,11,0,39,0,63,168,278,1175
PUNJAB,JAGRAON,2004,29,28,7,64,20,0,20,40,28,18,10,56,0,0,4,91,100,24,76,295,0,8,68,3,2,142,287,3,11,2,14,0,30,64,318,942
PUNJAB,JALANDHAR,2004,74,85,13,172,31,0,31,62,53,39,14,106,1,14,6,212,254,118,136,741,0,13,364,7,9,510,1079,14,26,0,109,0,149,176,782,2753
PUNJAB,KAPURTHALA,2004,22,23,6,51,12,0,12,24,12,8,4,24,0,3,1,38,62,23,39,166,0,4,166,3,3,122,389,5,2,0,32,0,39,91,200,807
PUNJAB,KHANNA,2004,20,17,7,44,8,0,8,16,14,7,7,28,0,0,3,46,65,24,41,179,0,8,24,1,0,21,54,4,5,0,10,0,19,0,104,357
PUNJAB,LUDHIANA,2004,53,55,12,120,48,0,48,96,70,46,24,140,0,18,8,145,369,208,161,909,0,31,333,2,2,232,888,5,33,23,104,0,165,288,1046,2877
PUNJAB,MAJITHA,2004,34,23,8,65,14,0,14,28,16,14,2,32,0,1,5,30,58,11,47,152,0,10,58,5,2,142,293,4,6,0,13,0,23,76,147,652
PUNJAB,MANSA,2004,28,36,6,70,8,0,8,16,5,2,3,10,0,1,2,40,32,12,20,107,0,13,61,0,0,142,216,3,1,0,21,0,25,0,188,587
PUNJAB,MOGA,2004,35,22,2,59,11,0,11,22,14,9,5,28,1,1,0,55,61,31,30,179,0,20,68,1,2,200,356,7,5,0,18,0,30,65,161,749
PUNJAB,MUKTSAR,2004,16,22,7,45,7,0,7,14,10,7,3,20,1,3,1,44,56,24,32,161,0,37,53,1,2,107,248,1,6,0,24,0,31,48,125,571
PUNJAB,NAWAN SHAHR,2004,23,20,1,44,14,0,14,28,16,11,5,32,1,2,11,39,108,34,74,269,0,0,60,1,3,257,390,3,7,2,14,0,26,69,115,766
PUNJAB,PATIALA,2004,49,45,9,103,20,0,20,40,45,32,13,90,0,5,10,197,304,140,164,820,0,10,289,4,2,444,1058,9,24,2,96,0,131,309,941,2814
PUNJAB,ROPAR,2004,25,14,3,42,8,0,8,16,12,8,4,24,3,3,1,72,137,70,67,353,0,7,92,0,3,145,433,0,12,3,29,0,44,186,397,1152
PUNJAB,SANGRUR,2004,44,50,9,103,21,0,21,42,16,10,6,32,3,4,7,103,111,37,74,339,0,26,141,3,5,191,487,3,13,4,42,0,62,121,350,1267
PUNJAB,TARN TARAN,2004,42,30,1,73,14,0,14,28,6,5,1,12,1,1,5,34,44,10,34,129,0,10,45,6,0,153,269,10,10,0,10,0,30,55,147,624
RAJASTHAN,AJMER,2004,41,82,2,125,48,0,48,96,101,101,0,202,6,1,47,378,817,304,513,2066,60,19,347,3,18,611,1395,8,78,0,371,0,457,337,3400,6775
RAJASTHAN,ALWAR,2004,60,98,0,158,43,0,43,86,86,67,19,172,0,3,31,203,1138,459,679,2513,85,23,327,4,29,2036,2852,30,98,0,276,0,404,348,2245,7163
RAJASTHAN,BANSWARA,2004,26,22,1,49,20,0,20,40,54,51,3,108,1,0,9,86,92,20,72,280,142,3,49,0,28,1370,1681,7,92,4,86,0,189,89,803,2984
RAJASTHAN,BARAN,2004,35,95,4,134,50,0,50,100,63,63,0,126,0,1,11,114,283,49,234,692,25,15,119,0,18,274,533,3,164,5,163,0,335,82,1777,3301
RAJASTHAN,BARMER,2004,15,22,3,40,14,0,14,28,21,15,6,42,0,0,7,122,194,73,121,517,28,3,138,4,33,678,969,9,95,0,69,0,173,85,1019,2559
RAJASTHAN,BHARATPUR,2004,92,134,1,227,44,0,44,88,128,91,37,256,7,10,26,99,821,198,623,1784,3,40,322,2,44,1186,1808,16,52,0,295,0,363,211,3995,7528
RAJASTHAN,BHILWARA,2004,37,43,4,84,44,0,44,88,157,118,39,314,2,1,55,292,846,319,527,2042,186,15,383,2,23,106,964,11,121,6,342,0,480,249,3372,6297
RAJASTHAN,BIKANER,2004,52,98,0,150,41,0,41,82,31,25,6,62,2,0,8,152,513,133,380,1188,1,20,292,0,21,523,1021,23,48,0,190,0,261,164,1758,3937
RAJASTHAN,BUNDI,2004,17,102,0,119,47,0,47,94,99,84,15,198,0,0,17,128,366,96,270,877,88,13,128,1,23,992,1344,4,141,3,228,0,376,99,1658,4154
RAJASTHAN,CHITTORGARH,2004,51,46,1,98,67,0,67,134,184,144,40,368,2,2,40,298,673,225,448,1688,138,44,284,4,40,2313,3018,7,165,4,501,0,677,195,1802,6861
RAJASTHAN,CHURU,2004,32,34,1,67,15,0,15,30,31,19,12,62,2,0,1,118,204,29,175,529,34,16,219,0,16,894,1259,7,44,0,198,0,249,80,767,2713
RAJASTHAN,DAUSA,2004,30,15,0,45,14,0,14,28,50,30,20,100,0,0,5,97,479,168,311,1060,87,8,172,0,17,45,496,14,30,0,89,0,133,167,2734,4053
RAJASTHAN,DHOLPUR,2004,32,50,0,82,31,0,31,62,44,27,17,88,4,0,22,88,278,64,214,670,65,11,92,0,14,1389,1654,12,50,0,127,0,189,83,651,3043
RAJASTHAN,DUNGARPUR,2004,26,8,0,34,17,0,17,34,40,37,3,80,1,0,13,58,76,21,55,224,132,8,35,0,21,113,404,5,44,0,72,0,121,95,1146,1910
RAJASTHAN,G.R.P.,2004,3,4,0,7,1,0,1,2,3,1,2,6,0,2,3,1,554,13,541,1114,8,3,6,0,0,4,24,1,13,0,1,0,15,3,362,972
RAJASTHAN,GANGANAGAR,2004,58,106,2,166,50,0,50,100,69,61,8,138,0,2,12,233,480,129,351,1207,20,58,532,6,16,1215,1988,20,46,2,450,0,518,141,1994,5512
RAJASTHAN,HANUMANGARH,2004,49,96,3,148,38,0,38,76,35,28,7,70,3,6,15,104,336,50,286,800,11,15,319,1,11,519,973,12,91,0,291,1,395,97,1793,3846
RAJASTHAN,JAIPUR,2004,83,116,10,209,81,0,81,162,227,182,45,454,10,4,63,939,4032,1886,2146,9080,821,265,1581,16,35,1707,5315,39,240,3,536,0,818,890,8511,20209
RAJASTHAN,JAISALMER,2004,5,0,0,5,2,0,2,4,10,4,6,20,0,0,0,57,156,20,136,369,20,2,17,0,7,0,80,3,14,0,27,0,44,34,467,821
RAJASTHAN,JALORE,2004,30,20,0,50,5,0,5,10,27,20,7,54,0,0,8,75,124,31,93,331,11,8,82,1,17,57,240,8,45,0,75,0,128,64,1754,2411
RAJASTHAN,JHALAWAR,2004,46,98,4,148,40,0,40,80,88,61,27,176,0,6,38,179,438,140,298,1099,90,8,78,2,49,1102,1404,4,167,5,258,0,434,75,1063,3838
RAJASTHAN,JHUNJHUNU,2004,32,12,0,44,26,0,26,52,40,22,18,80,1,1,8,109,330,57,273,779,86,12,169,1,31,180,610,14,55,0,132,0,201,131,2547,3917
RAJASTHAN,JODHPUR,2004,49,114,0,163,19,0,19,38,66,53,13,132,3,0,23,330,1200,620,580,2756,77,76,570,6,52,2200,3234,15,101,2,270,0,388,253,1457,6883
RAJASTHAN,KARAULI,2004,26,26,0,52,45,0,45,90,75,46,29,150,0,1,14,33,339,96,243,726,3,24,119,0,25,192,448,11,70,0,87,0,168,85,2198,3373
RAJASTHAN,KOTA,2004,47,300,4,351,42,0,42,84,137,124,13,274,1,2,50,325,1201,600,601,2780,59,43,409,3,39,497,1225,10,186,1,400,0,597,175,3290,7221
RAJASTHAN,NAGAUR,2004,54,35,0,89,25,0,25,50,40,29,11,80,2,0,7,208,400,91,309,1017,20,6,209,3,28,275,708,16,160,0,154,0,330,167,2502,4311
RAJASTHAN,PALI,2004,42,59,9,110,31,0,31,62,90,83,7,180,0,0,19,223,453,143,310,1148,39,31,221,1,35,38,594,12,127,0,239,0,378,229,3431,5329
RAJASTHAN,RAJSAMAND,2004,18,15,0,33,7,0,7,14,38,27,11,76,0,1,7,72,165,51,114,410,58,10,113,0,10,1256,1582,3,29,1,131,0,164,135,430,2499
RAJASTHAN,SAWAI MADHOPUR,2004,22,21,1,44,28,0,28,56,50,38,12,100,0,2,6,83,377,128,249,845,4,5,156,0,20,40,291,13,45,0,113,0,171,66,2165,3217
RAJASTHAN,SIKAR,2004,39,27,1,67,18,0,18,36,66,39,27,132,1,0,6,178,353,72,281,891,239,14,165,2,30,436,1087,17,38,0,120,0,175,201,2078,4029
RAJASTHAN,SIROHI,2004,44,28,1,73,14,0,14,28,33,31,2,66,6,0,18,113,188,39,149,513,40,15,91,2,17,657,936,6,44,1,86,0,137,114,689,2207
RAJASTHAN,TONK,2004,27,28,4,59,14,0,14,28,67,45,22,134,1,0,9,108,318,105,213,754,127,18,152,0,16,1288,1730,5,30,2,205,0,242,129,1255,3803
RAJASTHAN,UDAIPUR,2004,59,76,3,138,57,0,57,114,134,115,19,268,3,1,75,308,618,219,399,1623,294,34,437,1,52,1754,2878,14,102,2,199,0,317,306,2654,7183
SIKKIM,EAST,2004,4,3,2,9,1,0,1,2,1,1,0,2,0,0,4,42,58,6,52,162,22,4,15,0,3,37,99,0,15,0,0,0,15,18,103,332
SIKKIM,NORTH,2004,3,0,0,3,0,0,0,0,0,0,0,0,0,0,0,2,0,0,0,2,2,0,1,0,1,4,11,0,1,0,0,0,1,3,7,24
SIKKIM,SOUTH,2004,4,4,1,9,2,0,2,4,4,3,1,8,0,0,0,15,11,0,11,37,15,0,4,1,0,15,39,0,12,0,1,0,13,4,44,137
SIKKIM,WEST,2004,5,1,0,6,0,0,0,0,0,0,0,0,0,0,1,5,4,0,4,14,37,0,2,0,3,22,68,0,12,0,0,0,12,4,42,138
TAMIL NADU,CHENGAI,2004,79,56,0,135,33,0,33,66,36,24,12,72,2,0,26,342,991,157,834,2352,87,21,104,1,9,733,1597,32,102,29,94,0,257,642,9141,12560
TAMIL NADU,CHENNAI,2004,67,210,4,281,30,0,30,60,37,20,17,74,4,0,47,430,3263,784,2479,7007,33,25,359,3,0,667,1657,23,55,189,154,0,421,570,6266,12436
TAMIL NADU,CHENNAI RLY.,2004,1,4,0,5,0,0,0,0,1,1,0,2,0,0,5,2,222,4,218,451,7,6,9,0,0,16,44,1,0,2,1,0,4,6,362,645
TAMIL NADU,COIMBATORE RURAL,2004,64,43,0,107,23,0,23,46,25,25,0,50,6,2,31,256,1171,383,788,2637,295,20,100,2,18,3012,4175,7,65,51,67,0,190,728,3854,9840
TAMIL NADU,COIMBATORE URBAN,2004,17,15,0,32,4,0,4,8,8,4,4,16,3,0,17,148,1064,410,654,2296,194,33,66,1,4,144,627,4,16,21,29,0,70,185,1858,3831
TAMIL NADU,CUDDALORE,2004,55,102,4,161,18,0,18,36,41,22,19,82,2,0,17,93,474,150,324,1060,223,4,22,2,45,2739,3374,6,53,53,25,0,137,339,2792,7109
TAMIL NADU,DHARMAPURI,2004,39,16,0,55,22,0,22,44,23,14,9,46,4,0,10,62,163,66,97,402,173,5,38,0,23,821,1188,2,57,14,23,0,96,128,1166,2789
TAMIL NADU,DINDIGUL,2004,52,48,1,101,18,0,18,36,26,18,8,52,0,0,20,116,504,96,408,1144,35,15,56,0,29,463,927,7,30,4,38,0,79,329,3256,5047
TAMIL NADU,ERODE,2004,59,23,0,82,13,0,13,26,22,20,2,44,1,0,20,150,666,215,451,1503,24,7,149,0,25,2105,2759,7,35,5,21,0,68,449,2264,6045
TAMIL NADU,KANCHIPURAM,2004,48,52,0,100,17,0,17,34,12,11,1,24,3,0,9,109,376,57,319,873,76,0,5,1,0,570,1161,5,65,41,6,0,117,509,4903,6807
TAMIL NADU,KANYAKUMARI,2004,30,43,2,75,3,0,3,6,12,12,0,24,0,0,7,139,314,45,269,774,4,8,46,1,19,356,611,0,22,19,54,0,95,177,1857,3113
TAMIL NADU,KARUR,2004,19,18,1,38,4,0,4,8,6,6,0,12,1,0,6,35,212,53,159,466,26,2,11,0,6,140,361,3,12,6,13,0,34,176,1738,2435
TAMIL NADU,KRISHNAGIRI,2004,46,28,0,74,9,0,9,18,27,21,6,54,4,0,9,80,292,124,168,677,170,5,70,0,29,665,1245,8,38,74,31,0,151,306,2999,4890
TAMIL NADU,MADURAI RURAL,2004,57,45,0,102,29,0,29,58,29,29,0,58,2,17,35,131,526,62,464,1237,102,8,68,3,15,1329,1837,7,70,9,26,0,112,312,1433,4253
TAMIL NADU,MADURAI URBAN,2004,16,32,0,48,8,0,8,16,27,23,4,54,2,0,18,79,529,185,344,1157,71,10,143,1,7,143,478,5,34,40,38,0,117,103,1858,3164
TAMIL NADU,NAGAPATTINAM,2004,32,44,0,76,9,0,9,18,21,14,7,42,0,0,3,73,265,49,216,606,44,1,24,0,34,1308,1522,5,28,3,9,0,45,111,1466,3480
TAMIL NADU,NAMAKKAL,2004,31,20,0,51,7,0,7,14,18,18,0,36,4,0,3,42,196,61,135,441,87,1,29,0,12,1334,1738,8,35,17,39,0,99,275,1450,3608
TAMIL NADU,NILGIRIS,2004,14,26,0,40,14,0,14,28,3,3,0,6,0,0,6,86,150,13,137,392,26,3,14,3,0,273,348,2,45,14,4,0,65,29,995,1707
TAMIL NADU,PERAMBALUR,2004,33,33,0,66,15,0,15,30,31,24,7,62,1,0,8,73,162,66,96,406,56,3,25,2,27,669,921,4,44,16,39,0,103,139,1125,2505
TAMIL NADU,PUDUKOTTAI,2004,30,30,0,60,11,0,11,22,22,16,6,44,0,0,5,71,219,56,163,514,161,5,39,2,18,309,674,2,60,4,35,0,101,140,2160,3323
TAMIL NADU,RAMNATHAPURAM,2004,37,42,0,79,10,0,10,20,19,12,7,38,3,0,6,86,209,27,182,513,122,9,26,0,29,418,722,2,48,7,5,0,62,118,1669,2865
TAMIL NADU,SALEM RURAL,2004,73,178,1,252,56,0,56,112,102,101,1,204,6,8,28,92,245,30,215,624,160,4,113,2,53,2153,2807,12,337,17,254,0,620,322,1692,5908
TAMIL NADU,SALEM URBAN,2004,22,14,0,36,11,0,11,22,6,4,2,12,0,3,3,49,258,66,192,571,12,2,42,2,2,134,309,9,5,27,18,0,59,115,2131,2865
TAMIL NADU,SIVAGANGAI,2004,29,30,0,59,13,0,13,26,21,16,5,42,0,0,7,91,308,38,270,714,31,2,31,0,5,320,498,7,16,23,40,0,86,109,1537,2620
TAMIL NADU,THANJAVUR,2004,48,67,1,116,12,0,12,24,29,29,0,58,1,20,10,149,475,122,353,1130,111,4,21,1,19,732,1143,5,75,1,21,0,102,255,1873,3930
TAMIL NADU,THENI,2004,31,62,2,95,5,0,5,10,10,10,0,20,0,0,8,79,287,46,241,661,93,1,56,4,10,1107,1413,1,64,13,27,0,105,142,1365,3367
TAMIL NADU,THIRUNELVELI RURAL,2004,63,92,0,155,30,0,30,60,21,18,3,42,2,0,13,94,460,28,432,1029,4,5,34,2,26,752,1070,5,88,18,57,0,168,247,2821,4834
TAMIL NADU,THIRUNELVELI URBAN,2004,19,40,0,59,3,0,3,6,6,4,2,12,1,0,7,27,161,12,149,357,12,0,26,0,8,52,155,2,13,18,13,0,46,57,840,1305
TAMIL NADU,THIRUVALLUR,2004,20,11,1,32,16,0,16,32,14,14,0,28,2,0,5,71,195,20,175,468,97,3,10,0,11,1202,1539,14,46,15,29,0,104,216,1185,3163
TAMIL NADU,THIRUVANNAMALAI,2004,30,20,0,50,27,0,27,54,25,25,0,50,2,0,9,101,394,73,321,900,172,9,30,0,21,530,953,3,27,16,4,0,50,191,2231,3842
TAMIL NADU,THIRUVARUR,2004,24,25,0,49,7,0,7,14,10,8,2,20,0,0,2,50,215,44,171,482,55,4,12,0,24,988,1165,2,68,13,10,0,93,82,1359,2950
TAMIL NADU,THOOTHUGUDI,2004,59,93,1,153,35,0,35,70,31,18,13,62,3,0,15,162,516,60,456,1212,6,8,74,1,35,422,747,2,16,84,62,0,164,201,3124,4950
TAMIL NADU,TRICHY RLY.,2004,0,1,0,1,0,0,0,0,0,0,0,0,1,0,3,0,66,0,66,136,3,1,3,0,0,9,18,0,2,0,0,0,2,2,119,210
TAMIL NADU,TRICHY RURAL,2004,58,29,0,87,16,0,16,32,30,16,14,60,3,0,5,62,157,53,104,384,71,4,35,0,9,967,1373,5,9,5,0,0,19,287,1887,3639
TAMIL NADU,TRICHY URBAN,2004,13,14,1,28,0,0,0,0,6,3,3,12,3,0,1,82,374,61,313,834,5,3,49,0,2,55,222,4,8,102,32,0,146,108,1753,2615
TAMIL NADU,VELLORE,2004,60,36,3,99,17,0,17,34,30,22,8,60,0,0,6,173,575,117,458,1329,244,9,66,3,31,2087,2809,6,46,28,11,0,91,369,2960,6760
TAMIL NADU,VILLUPURAM,2004,68,78,4,150,55,0,55,110,56,44,12,112,5,4,21,111,390,109,281,921,275,9,30,3,31,620,1448,5,87,13,59,0,164,480,4155,6559
TAMIL NADU,VIRUDHUNAGAR,2004,36,52,0,88,18,0,18,36,27,23,4,54,1,0,13,151,486,54,432,1137,66,9,86,0,26,511,896,3,40,70,49,0,162,198,2795,4637
TRIPURA,DHALAI,2004,24,4,0,28,15,0,15,30,16,7,9,32,3,2,7,20,30,0,30,92,35,0,3,2,4,34,90,1,5,0,19,0,25,12,65,301
TRIPURA,NORTH,2004,26,18,0,44,46,0,46,92,30,22,8,60,6,0,14,33,56,3,53,165,25,4,2,2,7,95,159,0,37,0,63,0,100,24,145,633
TRIPURA,SOUTH,2004,42,1,0,43,51,0,51,102,28,17,11,56,6,0,12,50,63,9,54,194,30,10,22,2,10,163,286,8,66,0,117,0,191,49,241,971
TRIPURA,WEST,2004,97,13,0,110,48,0,48,96,25,8,17,50,12,0,13,63,111,37,74,310,58,3,7,6,3,160,237,11,26,0,103,0,140,0,417,1176
UTTAR PRADESH,AGRA,2004,125,153,21,299,32,0,32,64,156,106,50,312,10,1,61,196,1053,570,483,2374,217,134,174,17,10,528,1439,70,87,89,282,0,528,359,1265,5040
UTTAR PRADESH,ALIGARH,2004,193,218,26,437,58,0,58,116,128,87,41,256,18,0,111,114,804,345,459,1851,192,87,148,1,72,322,1129,36,45,31,228,0,340,307,745,3884
UTTAR PRADESH,ALLAHABAD,2004,144,148,40,332,23,0,23,46,79,53,26,158,6,1,55,238,579,260,319,1458,174,83,155,7,26,346,1092,57,24,35,148,0,264,301,1294,3963
UTTAR PRADESH,AMBEDKAR NAGAR,2004,37,47,6,90,10,0,10,20,28,26,2,56,0,0,28,35,108,22,86,279,20,15,20,3,10,125,234,4,6,5,26,0,41,41,219,793
UTTAR PRADESH,AURAIYA,2004,47,40,13,100,4,0,4,8,45,21,24,90,2,1,10,23,56,15,41,148,22,7,18,0,11,140,282,20,11,2,16,0,49,84,242,814
UTTAR PRADESH,AZAMGARH,2004,110,63,24,197,16,0,16,32,47,37,10,94,8,0,90,96,141,44,97,476,109,26,69,8,3,321,540,27,23,10,150,0,210,4,694,2039
UTTAR PRADESH,BADAUN,2004,212,215,39,466,35,0,35,70,96,43,53,192,13,0,60,86,262,30,232,683,39,17,33,1,22,242,359,50,47,19,37,0,153,5,962,2492
UTTAR PRADESH,BAGHPAT,2004,85,101,14,200,11,0,11,22,29,18,11,58,6,0,33,23,118,41,77,298,32,18,32,3,4,31,161,16,12,22,56,0,106,41,287,974
UTTAR PRADESH,BAHRAICH,2004,45,44,19,108,16,0,16,32,30,26,4,60,4,20,12,76,126,25,101,364,29,18,40,2,8,112,283,16,12,35,24,0,87,74,504,1266
UTTAR PRADESH,BALLIA,2004,49,68,20,137,6,0,6,12,19,12,7,38,3,0,12,56,135,40,95,341,75,17,45,5,6,205,399,11,15,13,33,0,72,46,294,1133
UTTAR PRADESH,BALRAMPUR,2004,22,13,11,46,5,0,5,10,7,5,2,14,0,0,2,20,28,11,17,78,9,10,22,0,0,48,110,3,8,13,8,0,32,21,62,312
UTTAR PRADESH,BANDA,2004,66,32,19,117,21,0,21,42,19,8,11,38,2,1,16,61,96,20,76,272,21,15,29,0,8,93,166,27,37,8,17,0,89,0,472,1060
UTTAR PRADESH,BARABANKI,2004,49,77,17,143,25,0,25,50,41,37,4,82,3,0,19,86,211,55,156,530,39,42,33,2,3,219,485,25,27,12,48,0,112,147,536,1661
UTTAR PRADESH,BAREILLY,2004,214,200,23,437,41,0,41,82,117,84,33,234,27,4,97,158,609,188,421,1504,113,63,187,10,2,587,1258,44,76,73,201,3,397,296,972,4117
UTTAR PRADESH,BASTI,2004,34,30,11,75,7,0,7,14,21,21,0,42,0,0,12,40,136,40,96,324,35,21,25,3,3,151,346,17,12,28,21,0,78,108,260,975
UTTAR PRADESH,BIJNOR,2004,86,68,22,176,25,0,25,50,34,29,5,68,3,1,26,47,211,53,158,499,55,16,92,2,1,47,327,21,23,47,132,0,223,114,474,1547
UTTAR PRADESH,BULANDSHAHAR,2004,199,140,31,370,40,0,40,80,90,69,21,180,3,1,78,78,411,108,303,982,74,32,60,2,6,32,358,36,51,114,106,0,307,152,1075,2811
UTTAR PRADESH,CHANDOLI,2004,23,14,12,49,5,0,5,10,7,3,4,14,2,0,14,19,54,14,40,143,12,20,13,0,1,56,130,10,2,12,18,0,42,28,286,608
UTTAR PRADESH,CHITRAKOOT DHAM,2004,25,11,11,47,10,0,10,20,9,4,5,18,1,0,1,18,25,11,14,70,7,6,5,0,2,49,106,8,9,2,5,0,24,37,165,406
UTTAR PRADESH,DEORIA,2004,44,60,20,124,12,0,12,24,29,23,6,58,2,1,16,65,86,20,66,256,78,29,19,2,8,123,375,16,10,13,31,0,70,116,437,1217
UTTAR PRADESH,ETAH,2004,148,216,29,393,26,0,26,52,63,26,37,126,10,0,40,67,224,106,118,565,67,37,52,2,19,306,621,47,44,7,61,0,159,138,632,2235
UTTAR PRADESH,ETAWAH,2004,71,75,14,160,9,0,9,18,63,25,38,126,1,0,27,40,114,52,62,296,29,17,27,1,3,75,284,13,15,10,46,0,84,132,624,1406
UTTAR PRADESH,FAIZABAD,2004,50,31,12,93,12,0,12,24,19,17,2,38,0,1,15,61,131,37,94,339,28,60,8,0,5,151,353,14,18,25,24,0,81,101,313,1079
UTTAR PRADESH,FATEHGARH,2004,89,85,12,186,10,0,10,20,40,27,13,80,3,2,34,31,80,36,44,230,21,14,35,2,1,60,144,21,13,14,35,0,83,11,216,829
UTTAR PRADESH,FATEHPUR,2004,87,34,34,155,10,0,10,20,20,16,4,40,0,1,14,33,89,21,68,226,7,12,27,0,0,172,372,23,19,19,17,0,78,154,421,1193
UTTAR PRADESH,FIROZABAD,2004,123,127,21,271,10,0,10,20,89,37,52,178,11,1,70,73,411,177,234,977,65,31,42,0,9,362,509,48,33,33,89,0,203,0,677,2325
UTTAR PRADESH,G.R.P.,2004,15,12,2,29,2,0,2,4,5,2,3,10,14,2,40,1,1966,90,1876,3989,8,48,42,3,1,10,114,0,15,38,0,0,53,2,690,2916
UTTAR PRADESH,GAUTAMBUDH NAGAR,2004,63,60,14,137,20,0,20,40,32,26,6,64,10,0,39,47,826,442,384,1748,45,23,89,4,0,23,384,14,24,56,39,0,133,200,662,2290
UTTAR PRADESH,GHAZIABAD,2004,190,160,36,386,25,0,25,50,118,88,30,236,3,16,65,135,1523,893,630,3265,65,95,174,4,3,76,806,35,31,94,142,0,302,389,1234,4613
UTTAR PRADESH,GHAZIPUR,2004,61,54,24,139,4,0,4,8,9,8,1,18,4,1,25,57,101,28,73,289,52,22,7,3,5,185,276,17,19,15,49,0,100,2,321,1037
UTTAR PRADESH,GONDA,2004,52,57,25,134,14,0,14,28,23,21,2,46,2,0,11,72,120,37,83,325,30,17,29,0,1,108,249,15,12,63,2,0,92,64,259,976
UTTAR PRADESH,GORAKHPUR,2004,98,84,38,220,24,0,24,48,51,37,14,102,8,0,47,191,357,181,176,960,115,59,84,0,0,266,795,25,26,43,79,0,173,271,662,2528
UTTAR PRADESH,HAMIRPUR,2004,50,33,16,99,12,0,12,24,13,9,4,26,1,0,12,35,55,9,46,158,13,16,9,0,0,41,79,16,23,6,7,0,52,0,288,646
UTTAR PRADESH,HARDOI,2004,116,72,28,216,37,0,37,74,58,50,8,116,1,0,35,71,229,25,204,565,19,22,43,1,0,327,563,44,68,76,64,0,252,151,632,2094
UTTAR PRADESH,HATHRAS,2004,66,90,14,170,16,0,16,32,40,26,14,80,17,0,56,70,228,56,172,599,99,34,43,0,0,180,362,24,39,21,134,0,218,6,606,1783
UTTAR PRADESH,J.P.NAGAR,2004,76,59,12,147,27,0,27,54,24,19,5,48,8,0,44,57,111,29,82,331,44,14,38,3,1,60,349,6,26,30,66,0,128,189,406,1301
UTTAR PRADESH,JALAUN,2004,88,55,11,154,7,0,7,14,49,13,36,98,4,1,21,44,125,44,81,320,23,12,23,1,5,11,162,28,17,22,20,0,87,87,430,1084
UTTAR PRADESH,JAUNPUR,2004,53,73,26,152,19,0,19,38,22,17,5,44,2,3,40,77,160,66,94,442,55,20,73,1,0,253,428,29,9,21,63,0,122,26,561,1586
UTTAR PRADESH,JHANSI,2004,70,31,26,127,16,0,16,32,39,29,10,78,4,1,19,63,158,67,91,403,46,17,42,0,0,92,317,25,21,36,53,0,135,120,793,1672
UTTAR PRADESH,KANNAUJ,2004,66,39,10,115,5,0,5,10,17,17,0,34,1,0,19,32,69,18,51,190,26,18,36,1,0,16,149,22,22,10,63,0,117,52,469,993
UTTAR PRADESH,KANPUR DEHAT,2004,46,37,19,102,13,0,13,26,49,36,13,98,4,0,12,37,141,17,124,335,48,21,37,0,8,198,447,25,45,19,39,0,128,135,454,1387
UTTAR PRADESH,KANPUR NAGAR,2004,149,126,36,311,20,0,20,40,109,83,26,218,5,5,62,161,938,634,304,2109,96,98,211,7,6,402,1181,46,40,239,202,0,527,361,1207,4526
UTTAR PRADESH,KAUSHAMBI,2004,65,31,15,111,14,0,14,28,12,8,4,24,3,1,17,30,74,14,60,199,9,6,18,0,0,113,155,19,9,9,43,0,80,9,265,762
UTTAR PRADESH,KHIRI,2004,113,118,24,255,43,0,43,86,76,64,12,152,3,4,34,84,350,80,270,825,58,23,93,1,3,487,689,58,52,105,121,0,336,24,796,2670
UTTAR PRADESH,KUSHI NAGAR,2004,46,47,22,115,13,0,13,26,28,15,13,56,1,0,23,57,107,19,88,295,77,35,35,2,8,203,464,21,14,37,17,0,89,104,307,1204
UTTAR PRADESH,LALITPUR,2004,16,16,12,44,4,0,4,8,4,3,1,8,0,0,2,16,54,19,35,126,19,11,7,0,1,17,97,6,11,23,10,0,50,42,177,448
UTTAR PRADESH,LUCKNOW,2004,173,135,27,335,46,0,46,92,164,135,29,328,12,3,109,479,2279,1042,1237,5161,150,199,325,19,7,71,1129,48,64,152,272,0,536,358,2320,7412
UTTAR PRADESH,MAHARAJGANJ,2004,25,22,11,58,8,0,8,16,11,11,0,22,1,1,7,30,39,13,26,117,27,11,14,4,1,52,176,8,11,31,7,0,57,67,189,577
UTTAR PRADESH,MAHOBA,2004,36,17,10,63,6,0,6,12,9,7,2,18,0,0,4,24,29,5,24,86,6,4,10,0,6,38,92,5,14,9,3,0,31,28,182,440
UTTAR PRADESH,MAINPURI,2004,127,117,14,258,8,0,8,16,49,36,13,98,8,0,47,44,176,66,110,451,64,13,39,3,0,216,343,35,13,3,34,0,85,8,569,1587
UTTAR PRADESH,MATHURA,2004,96,95,16,207,24,0,24,48,34,24,10,68,7,1,51,52,388,188,200,887,80,66,76,7,10,129,580,22,35,42,57,0,156,212,727,2227
UTTAR PRADESH,MAU,2004,42,54,19,115,3,0,3,6,19,15,4,38,1,0,27,52,92,24,68,264,69,11,16,3,1,109,261,9,11,22,24,0,66,52,142,778
UTTAR PRADESH,MEERUT,2004,225,179,19,423,33,0,33,66,137,87,50,274,21,5,146,149,1192,598,594,2705,131,80,128,7,3,61,619,19,52,153,279,0,503,209,1070,4298
UTTAR PRADESH,MIRZAPUR,2004,36,37,10,83,12,0,12,24,13,5,8,26,4,0,24,44,80,27,53,232,23,18,30,1,0,158,358,20,18,13,26,0,77,128,183,878
UTTAR PRADESH,MORADABAD,2004,194,153,26,373,57,0,57,114,98,83,15,196,18,4,89,140,527,194,333,1305,89,55,148,10,5,62,484,27,66,126,265,0,484,115,1390,3664
UTTAR PRADESH,MUZAFFARNAGAR,2004,253,163,21,437,44,0,44,88,90,59,31,180,8,3,93,95,563,207,356,1325,91,50,88,0,0,10,351,23,34,103,73,0,233,112,976,2893
UTTAR PRADESH,PILIBHIT,2004,74,60,17,151,28,0,28,56,54,39,15,108,11,0,27,35,165,32,133,403,37,19,83,2,1,7,192,21,37,52,163,0,273,43,701,1637
UTTAR PRADESH,PRATAPGARH,2004,63,71,21,155,18,0,18,36,31,30,1,62,1,0,18,89,177,36,141,462,75,30,39,0,11,387,613,22,19,5,37,0,83,71,547,1732
UTTAR PRADESH,RAIBAREILLY,2004,74,62,32,168,42,0,42,84,52,43,9,104,4,1,26,66,220,38,182,537,52,32,50,1,0,341,486,23,54,33,101,0,211,10,578,1854
UTTAR PRADESH,RAMPUR,2004,74,82,20,176,22,0,22,44,39,30,9,78,2,1,23,47,225,49,176,523,38,36,99,5,2,24,273,14,23,6,9,0,52,69,619,1479
UTTAR PRADESH,SAHARANPUR,2004,93,117,24,234,22,0,22,44,52,1,51,104,4,0,47,89,477,171,306,1094,84,46,154,4,0,3,291,19,28,70,173,0,290,0,971,2477
UTTAR PRADESH,SANT KABIRNAGAR,2004,19,21,6,46,6,0,6,12,10,10,0,20,1,0,6,20,50,13,37,127,40,6,11,2,0,70,145,4,1,12,15,0,32,16,114,430
UTTAR PRADESH,SHAHJAHANPUR,2004,137,166,34,337,31,0,31,62,89,53,36,178,10,2,48,82,216,49,167,574,34,38,55,1,9,200,401,41,49,24,21,0,135,64,815,2166
UTTAR PRADESH,SHRAWASTI,2004,17,12,7,36,4,0,4,8,9,9,0,18,0,3,6,21,32,5,27,94,11,1,13,0,3,88,138,6,7,4,0,0,17,22,100,366
UTTAR PRADESH,SIDHARTHNAGAR,2004,23,12,11,46,10,0,10,20,17,17,0,34,9,0,8,61,91,26,65,260,25,16,33,2,0,100,183,16,13,4,27,0,60,7,362,847
UTTAR PRADESH,SITAPUR,2004,152,131,35,318,72,0,72,144,104,83,21,208,2,0,73,140,460,53,407,1135,97,57,81,3,23,292,635,71,73,34,79,0,257,82,978,3039
UTTAR PRADESH,SONBHADRA,2004,34,24,13,71,6,0,6,12,15,12,3,30,6,1,6,28,52,18,34,145,18,18,27,0,5,100,258,11,9,14,9,0,43,90,73,559
UTTAR PRADESH,ST.RAVIDASNAGAR,2004,21,35,12,68,3,0,3,6,5,1,4,10,9,0,21,43,63,18,45,199,29,8,18,0,6,96,205,13,2,5,21,0,41,48,121,579
UTTAR PRADESH,SULTANPUR,2004,59,78,41,178,18,0,18,36,36,31,5,72,1,1,32,111,220,69,151,585,18,29,34,3,0,211,406,17,21,32,53,0,123,111,315,1441
UTTAR PRADESH,UNNAO,2004,123,107,23,253,45,0,45,90,62,52,10,124,3,0,36,49,151,30,121,390,59,25,24,1,2,308,582,29,37,26,78,0,170,163,566,1917
UTTAR PRADESH,VARANASI,2004,80,66,36,182,15,0,15,30,35,20,15,70,2,2,56,132,570,372,198,1332,52,51,46,6,1,161,317,30,7,53,52,0,142,0,756,2209
UTTARAKHAND,ALMORA,2004,10,11,0,21,1,0,1,2,5,4,1,10,0,0,6,21,27,0,27,81,9,3,3,0,2,48,79,7,7,4,9,0,27,14,34,221
UTTARAKHAND,BAGESHWAR,2004,4,1,0,5,5,0,5,10,4,0,4,8,0,0,4,11,6,0,6,27,1,2,2,0,1,7,17,4,0,0,2,0,6,4,32,90
UTTARAKHAND,CHAMOLI,2004,5,14,1,20,4,0,4,8,7,6,1,14,0,0,1,20,13,1,12,47,14,3,10,0,6,23,71,1,12,1,3,0,17,15,90,243
UTTARAKHAND,CHAMPAWAT,2004,6,2,2,10,2,0,2,4,2,1,1,4,1,0,1,10,8,0,8,28,2,1,4,0,0,16,31,0,5,0,4,0,9,8,54,128
UTTARAKHAND,DEHRADUN,2004,42,35,2,79,21,0,21,42,37,22,15,74,2,0,24,141,426,204,222,1019,78,47,144,4,4,68,489,6,16,46,119,0,187,144,549,1955
UTTARAKHAND,HARIDWAR,2004,56,66,3,125,33,0,33,66,54,37,17,108,13,1,41,106,401,136,265,963,87,40,97,2,3,273,623,10,28,43,118,0,199,121,313,1909
UTTARAKHAND,NAINITAL,2004,43,26,8,77,6,0,6,12,28,26,2,56,4,0,23,46,219,42,177,511,29,11,21,4,1,145,278,6,18,15,25,0,64,67,147,892
UTTARAKHAND,PAURI GARHWAL,2004,19,13,2,34,6,0,6,12,10,9,1,20,2,0,7,62,47,6,41,165,28,9,10,1,5,66,161,7,11,0,11,0,29,42,81,439
UTTARAKHAND,PITHORAGARH,2004,5,9,5,19,9,0,9,18,3,0,3,6,2,0,7,24,21,3,18,75,15,3,5,0,1,24,51,8,4,0,6,0,18,3,152,306
UTTARAKHAND,RUDRA PRAYAG,2004,4,1,0,5,4,0,4,8,3,3,0,6,0,0,4,21,6,2,4,37,23,3,4,0,1,14,58,6,5,0,2,0,13,13,18,132
UTTARAKHAND,TEHRI GARHWAL,2004,11,18,0,29,4,0,4,8,14,14,0,28,0,0,0,22,33,5,28,88,14,2,10,0,0,27,76,4,2,0,12,0,18,23,135,331
UTTARAKHAND,UDHAMSINGH NAGAR,2004,53,45,4,102,15,0,15,30,41,0,41,82,13,0,47,68,359,99,260,846,127,29,55,2,2,151,376,21,32,0,85,0,138,10,612,1771
UTTARAKHAND,UTTARKASHI,2004,4,6,2,12,5,0,5,10,5,5,0,10,0,0,0,14,31,2,29,76,17,4,7,0,2,3,33,2,3,1,9,0,15,0,102,217
WEST BENGAL,24 PARGANAS NORTH,2004,177,43,50,270,176,0,176,352,180,124,56,360,32,72,72,60,2196,701,1495,4628,208,37,130,19,0,121,518,55,154,4,810,0,1023,3,4228,8827
WEST BENGAL,24 PARGANAS SOUTH,2004,130,3,54,187,122,0,122,244,103,100,3,206,13,8,33,12,1597,288,1309,3260,231,1,114,3,16,36,428,43,101,3,966,0,1113,27,3507,7123
WEST BENGAL,ASANSOL,2004,28,6,8,42,9,0,9,18,10,1,9,20,3,23,7,19,112,34,78,276,62,7,13,0,1,40,228,7,37,2,247,0,293,105,316,1062
WEST BENGAL,BANKURA,2004,37,0,6,43,49,0,49,98,24,24,0,48,10,15,21,10,374,7,367,804,60,0,14,7,5,170,390,22,40,0,123,0,185,134,497,1618
WEST BENGAL,BIRBHUM,2004,51,16,25,92,58,0,58,116,31,24,7,62,6,26,16,32,221,61,160,522,187,4,27,1,11,150,542,9,37,0,139,0,185,162,403,1612
WEST BENGAL,BURDWAN,2004,110,10,26,146,92,0,92,184,56,52,4,112,10,79,22,45,382,60,322,920,209,12,62,4,6,98,651,40,56,2,230,0,328,260,2329,4140
WEST BENGAL,COOCHBEHAR,2004,20,4,8,32,92,0,92,184,41,38,3,82,0,0,3,11,151,38,113,316,15,6,13,6,1,107,228,6,69,3,173,0,251,80,455,1264
WEST BENGAL,DAKSHIN DINAJPUR,2004,16,4,8,28,33,0,33,66,27,26,1,54,1,39,3,2,85,14,71,215,24,3,2,2,0,27,121,8,36,0,97,0,141,63,380,860
WEST BENGAL,DARJEELING,2004,43,1,31,75,21,0,21,42,17,17,0,34,7,62,5,5,393,97,296,865,19,0,12,5,2,155,241,8,24,3,56,0,91,48,344,1261
WEST BENGAL,HOOGHLY,2004,82,12,23,117,56,0,56,112,38,38,0,76,12,137,39,83,645,80,565,1561,399,5,46,5,8,259,925,23,37,3,501,0,564,203,1047,3663
WEST BENGAL,HOWRAH,2004,31,4,13,48,21,0,21,42,19,11,8,38,12,32,13,4,206,34,172,473,98,7,68,1,12,109,424,15,32,0,122,0,169,129,812,1760
WEST BENGAL,HOWRAH CITY,2004,30,4,8,42,15,0,15,30,17,13,4,34,10,67,22,5,402,142,260,908,33,15,102,2,5,122,413,5,16,2,120,0,143,134,856,1992
WEST BENGAL,HOWRAH G.R.P.,2004,10,5,2,17,1,0,1,2,8,5,3,16,1,39,5,0,275,0,275,595,12,3,13,1,0,14,45,0,4,1,0,0,5,2,102,498
WEST BENGAL,JALPAIGURI,2004,118,31,45,194,83,0,83,166,59,49,10,118,6,18,14,21,661,72,589,1381,37,28,2,7,9,208,559,8,112,2,229,0,351,268,900,2866
WEST BENGAL,KHARAGPUR G.R.P.,2004,8,2,0,10,0,0,0,0,2,0,2,4,6,2,5,0,115,0,115,243,3,1,3,1,0,15,23,0,2,1,1,0,4,0,0,167
WEST BENGAL,KOLKATA,2004,37,78,16,131,27,0,27,54,119,95,24,238,19,53,117,140,3695,763,2932,7719,227,225,922,12,0,1228,3045,10,174,34,252,1,471,431,2940,10757
WEST BENGAL,MALDA,2004,63,55,27,145,97,0,97,194,65,46,19,130,8,11,17,10,363,74,289,772,43,0,7,14,0,79,500,4,112,0,245,0,361,357,890,2467
WEST BENGAL,MURSHIDABAD,2004,111,7,44,162,197,0,197,394,126,106,20,252,8,82,23,14,429,82,347,985,173,5,21,12,0,225,713,32,201,0,761,0,994,277,1535,4283
WEST BENGAL,NADIA,2004,99,0,21,120,108,0,108,216,80,80,0,160,7,63,14,17,757,23,734,1615,168,0,6,13,7,502,864,30,128,0,393,11,562,168,1626,4218
WEST BENGAL,PASCHIM MIDNAPUR,2004,81,58,20,159,74,0,74,148,65,65,0,130,26,38,30,38,437,33,404,1006,212,47,38,1,14,48,362,16,67,2,334,0,419,2,1657,3305
WEST BENGAL,PURAB MIDNAPUR,2004,50,10,14,74,49,0,49,98,54,54,0,108,4,38,15,11,217,24,193,502,201,8,23,1,0,35,268,36,38,1,269,0,344,0,1277,2351
WEST BENGAL,PURULIA,2004,40,0,9,49,43,0,43,86,11,11,0,22,3,22,14,5,145,3,142,334,44,10,30,0,2,42,128,8,39,0,118,0,165,0,540,1125
WEST BENGAL,SEALDAH G.R.P.,2004,14,2,1,17,5,0,5,10,6,1,5,12,1,8,14,0,279,0,279,581,8,1,4,0,0,0,13,0,6,0,0,0,6,0,75,424
WEST BENGAL,SILIGURI G.R.P.,2004,3,0,0,3,0,0,0,0,2,2,0,4,1,0,3,0,81,0,81,166,1,0,1,1,0,0,3,2,4,0,0,0,6,0,42,141
WEST BENGAL,UTTAR DINAJPUR,2004,36,35,9,80,47,0,47,94,40,36,4,80,6,9,8,3,247,38,209,520,17,0,13,7,4,77,260,9,40,1,148,0,198,142,668,1566
A & N ISLANDS,ANDAMAN,2004,13,1,2,16,10,0,10,20,3,3,0,6,0,0,3,67,100,9,91,270,9,0,11,0,8,102,136,0,5,3,5,0,13,6,373,721
A & N ISLANDS,NICOBAR,2004,2,0,0,2,0,0,0,0,0,0,0,0,0,0,0,2,3,0,3,8,0,0,1,0,1,3,5,0,1,0,0,0,1,0,14,27
CHANDIGARH,CHANDIGARH,2004,22,19,10,51,19,0,19,38,54,43,11,108,0,2,6,186,1459,653,806,3112,43,23,135,4,0,65,275,6,20,18,73,0,117,5,720,2889
D & N HAVELI,D and N HAVELI,2004,11,4,0,15,7,0,7,14,12,7,5,24,3,0,2,20,53,20,33,131,17,12,22,0,2,35,96,0,5,0,3,0,8,8,193,409
DAMAN & DIU,DAMAN,2004,2,1,0,3,1,0,1,2,2,0,2,4,0,0,1,35,27,12,15,90,19,3,4,0,2,12,60,0,1,0,4,0,5,20,37,171
DAMAN & DIU,DIU,2004,1,0,0,1,0,0,0,0,0,0,0,0,0,0,0,0,0,0,0,0,0,1,1,0,0,5,12,0,0,0,0,0,0,5,14,27
DELHI UT,CENTRAL,2004,16,17,6,39,27,0,27,54,57,41,16,114,1,11,18,84,1324,513,811,2762,8,49,140,5,3,112,326,1,44,12,44,0,101,9,1347,3335
DELHI UT,EAST,2004,52,39,13,104,62,0,62,124,172,125,47,344,6,15,52,137,2275,1194,1081,4760,6,42,141,3,5,246,460,13,82,6,212,0,313,17,1932,5528
DELHI UT,G.R.P.(RLY),2004,6,6,1,13,5,0,5,10,5,2,3,10,1,3,6,4,1071,15,1056,2156,0,13,17,0,3,13,47,2,2,1,0,0,5,1,75,1235
DELHI UT,I.G.I. AIRPORT,2004,1,3,0,4,1,0,1,2,5,2,3,10,0,0,6,1,88,17,71,183,2,1,466,1,0,2,472,0,7,0,1,0,8,0,98,683
DELHI UT,NEW DELHI,2004,6,15,5,26,8,0,8,16,20,11,9,40,0,4,9,79,1166,366,800,2424,2,38,319,0,1,43,487,1,34,15,11,0,61,84,791,2651
DELHI UT,NORTH,2004,25,23,8,56,23,0,23,46,85,55,30,170,5,6,30,99,1155,429,726,2450,6,56,115,11,9,125,322,6,21,5,55,0,87,0,1550,3418
DELHI UT,NORTH EAST,2004,54,69,3,126,67,0,67,134,157,120,37,314,4,20,65,153,1033,595,438,2308,4,19,105,7,1,240,487,18,46,6,144,0,214,111,1570,3896
DELHI UT,NORTH WEST,2004,129,137,19,285,124,0,124,248,285,203,82,570,4,22,120,443,2594,1522,1072,5777,11,67,182,7,4,335,649,29,129,23,267,0,448,43,4866,9840
DELHI UT,S.T.F.,2004,1,15,0,16,1,0,1,2,0,0,0,0,0,5,0,0,2,0,2,9,0,1,37,2,0,0,40,0,1,0,0,0,1,0,25,90
DELHI UT,SOUTH,2004,80,74,13,167,96,0,96,192,216,175,41,432,5,27,54,274,4000,2053,1947,8360,10,88,417,4,2,233,833,21,130,40,179,0,370,79,3630,9672
DELHI UT,SOUTH WEST,2004,44,49,6,99,79,0,79,158,97,68,29,194,3,12,51,366,1774,749,1025,3980,13,38,227,2,5,146,464,11,59,13,126,0,209,33,2778,5932
DELHI UT,WEST,2004,67,72,6,145,58,0,58,116,110,79,31,220,1,10,50,235,2512,1420,1092,5320,5,33,156,2,5,285,542,24,46,9,215,0,294,56,3386,7343
LAKSHADWEEP,LAKSHADWEEP,2004,0,0,0,0,0,0,0,0,0,0,0,0,0,0,0,2,5,0,5,12,37,0,0,1,0,6,44,0,0,0,1,0,1,0,18,70
PUDUCHERRY,PONDICHERRY,2004,25,18,14,57,4,0,4,8,10,8,2,20,0,0,1,86,634,322,312,1355,147,7,35,2,9,974,1350,6,50,30,2,0,88,176,2390,4620
ANDHRA PRADESH,ADILABAD,2005,108,48,13,169,53,0,53,106,65,46,19,130,9,0,20,191,329,53,276,878,68,13,173,4,30,1273,1837,21,144,77,280,0,522,276,1838,5033
ANDHRA PRADESH,ANANTAPUR,2005,172,125,3,300,16,0,16,32,60,30,30,120,17,0,21,178,439,203,236,1094,102,15,96,7,59,1007,1635,12,173,57,137,0,379,349,1500,4545
ANDHRA PRADESH,CHITTOOR,2005,105,40,0,145,35,0,35,70,72,58,14,144,9,0,24,281,1269,87,1182,2852,87,32,222,10,30,891,1813,9,91,223,202,0,525,541,2573,6746
ANDHRA PRADESH,CUDDAPAH,2005,96,0,0,96,21,0,21,42,36,31,5,72,9,0,11,152,297,79,218,766,66,21,114,7,34,783,1368,7,116,18,95,0,236,343,1846,4072
ANDHRA PRADESH,CYBERABAD,2005,150,88,10,248,44,0,44,88,151,58,93,302,26,0,95,1139,2287,563,1724,5834,44,83,950,5,37,3033,5050,34,119,96,701,3,953,898,2086,12079
ANDHRA PRADESH,EAST GODAVARI,2005,110,130,0,240,27,0,27,54,69,3,66,138,3,0,28,403,1286,210,1076,3006,98,119,265,24,35,2530,3616,15,102,119,368,0,604,545,1986,8262
ANDHRA PRADESH,GUNTAKAL RLY.,2005,12,0,0,12,0,0,0,0,1,1,0,2,1,0,4,0,129,0,129,263,1,0,5,0,0,5,12,4,1,0,0,0,5,1,61,225
ANDHRA PRADESH,GUNTUR,2005,165,88,1,254,55,0,55,110,87,56,31,174,14,0,35,293,1266,267,999,2874,110,47,412,14,61,1480,2619,16,166,203,366,0,751,495,2362,7736
ANDHRA PRADESH,HYDERABAD CITY,2005,108,130,4,242,67,0,67,134,137,70,67,274,8,3,125,1161,5022,2012,3010,11341,96,94,1880,17,40,4227,6868,27,119,348,1309,0,1803,514,1840,17276
ANDHRA PRADESH,KARIMNAGAR,2005,164,96,1,261,84,0,84,168,131,91,40,262,10,0,37,310,740,16,724,1837,174,61,630,3,65,2936,4226,52,328,143,839,0,1362,357,1714,8875
ANDHRA PRADESH,KHAMMAM,2005,110,69,3,182,21,0,21,42,66,40,26,132,9,0,25,208,567,96,471,1376,151,30,166,5,48,1065,1859,14,150,240,313,0,717,394,2103,5757
ANDHRA PRADESH,KRISHNA,2005,69,74,0,143,27,0,27,54,45,26,19,90,3,0,17,155,653,64,589,1481,44,17,202,4,45,2176,2806,11,209,104,337,0,661,318,825,5335
ANDHRA PRADESH,KURNOOL,2005,140,95,6,241,29,0,29,58,42,30,12,84,16,0,16,179,373,87,286,957,125,13,242,12,28,1159,1948,9,221,124,233,0,587,369,1835,5266
ANDHRA PRADESH,MAHABOOBNAGAR,2005,212,102,16,330,62,0,62,124,59,47,12,118,21,0,43,277,575,56,519,1491,112,20,107,8,57,1713,2553,17,140,7,237,0,401,536,1303,5624
ANDHRA PRADESH,MEDAK,2005,133,45,10,188,36,0,36,72,38,27,11,76,15,0,24,213,424,77,347,1100,32,22,108,14,35,1478,2151,28,88,35,209,0,360,462,575,4024
ANDHRA PRADESH,NALGONDA,2005,138,46,6,190,49,0,49,98,51,31,20,102,13,0,37,248,480,78,402,1258,102,40,243,6,62,1274,2330,30,223,95,344,0,692,603,2480,6570
ANDHRA PRADESH,NELLORE,2005,86,73,3,162,33,0,33,66,74,65,9,148,6,0,26,205,759,152,607,1755,66,31,166,7,39,1961,2580,11,205,84,166,0,466,310,972,5283
ANDHRA PRADESH,NIZAMABAD,2005,88,38,16,142,26,0,26,52,57,32,25,114,15,0,41,292,494,90,404,1336,49,21,183,10,36,2025,2607,16,88,41,410,0,555,283,830,5059
ANDHRA PRADESH,PRAKASHAM,2005,106,82,6,194,27,0,27,54,52,43,9,104,10,0,19,181,406,71,335,1022,56,22,188,10,28,1317,1941,7,169,27,156,0,359,320,1154,4343
ANDHRA PRADESH,RANGA REDDY,2005,62,26,4,92,15,0,15,30,16,14,2,32,7,0,9,138,160,63,97,474,23,13,51,3,42,867,1125,22,45,13,119,0,199,126,366,2127
ANDHRA PRADESH,SECUNDERABAD RLY.,2005,11,1,0,12,0,0,0,0,4,0,4,8,2,0,2,0,407,0,407,818,0,0,6,10,0,16,34,2,1,1,0,0,4,2,43,508
ANDHRA PRADESH,SRIKAKULAM,2005,36,0,2,38,15,1,14,30,17,16,1,34,1,0,11,101,211,5,206,535,18,18,58,11,28,1200,1524,9,51,40,137,0,237,191,531,2686
ANDHRA PRADESH,VIJAYAWADA,2005,41,40,4,85,32,0,32,64,87,49,38,174,3,0,31,456,1724,419,1305,3938,9,23,443,8,22,1513,2260,8,64,122,296,0,490,242,623,5791
ANDHRA PRADESH,VIJAYAWADA RLY.,2005,5,2,0,7,0,0,0,0,1,0,1,2,0,0,0,0,261,0,261,522,0,0,3,0,0,5,12,0,2,0,0,0,2,4,33,316
ANDHRA PRADESH,VISAKHA RURAL,2005,55,17,0,72,18,0,18,36,8,8,0,16,2,0,12,95,162,0,162,433,47,14,47,5,17,1331,1770,7,36,9,153,0,205,309,343,2687
ANDHRA PRADESH,VISAKHAPATNAM,2005,27,48,0,75,28,0,28,56,37,15,22,74,6,1,19,393,987,298,689,2393,31,58,279,24,8,495,1079,2,45,86,361,0,494,184,1336,4455
ANDHRA PRADESH,VIZIANAGARAM,2005,43,9,1,53,12,0,12,24,9,9,0,18,6,0,6,87,217,2,215,533,12,10,58,2,3,400,679,7,41,28,186,0,262,194,1229,2560
ANDHRA PRADESH,WARANGAL,2005,117,93,2,212,34,0,34,68,82,64,18,164,7,0,29,318,650,181,469,1654,249,15,300,17,45,1615,2594,29,226,50,332,0,637,353,2120,6683
ANDHRA PRADESH,WEST GODAVARI,2005,81,119,0,200,69,0,69,138,58,35,23,116,2,0,27,300,1204,236,968,2737,54,96,312,10,33,2404,3363,17,232,118,410,0,777,454,1200,7200
ARUNACHAL PRADESH,CHANGLANG,2005,9,6,4,19,2,0,2,4,8,5,3,16,0,0,4,17,25,0,25,71,0,0,0,0,2,26,31,0,1,0,1,0,2,3,40,148
ARUNACHAL PRADESH,DIBANG VALLEY,2005,4,4,0,8,0,0,0,0,5,4,1,10,3,0,1,13,37,1,36,91,0,0,0,0,1,18,24,0,5,0,0,0,5,5,32,128
ARUNACHAL PRADESH,K/KUMEY,2005,4,7,0,11,1,0,1,2,2,2,0,4,0,0,0,9,8,0,8,25,0,4,2,0,0,4,11,0,0,0,0,0,0,1,11,53
ARUNACHAL PRADESH,KAMENG EAST,2005,4,2,0,6,2,0,2,4,4,3,1,8,3,0,3,12,18,5,13,54,0,2,1,0,0,13,18,0,5,0,2,0,7,2,31,104
ARUNACHAL PRADESH,KAMENG WEST,2005,6,0,0,6,0,0,0,0,1,1,0,2,1,0,4,10,25,0,25,65,0,3,2,0,0,21,36,0,2,0,0,0,2,10,26,111
ARUNACHAL PRADESH,LOHIT,2005,14,5,0,19,3,0,3,6,7,4,3,14,1,0,5,20,22,0,22,70,0,3,2,1,1,20,38,0,7,0,1,0,8,11,35,158
ARUNACHAL PRADESH,PAPUM PARE,2005,10,4,0,14,6,0,6,12,10,7,3,20,3,0,16,47,180,85,95,426,11,12,10,2,2,70,118,0,4,0,2,0,6,11,96,496
ARUNACHAL PRADESH,SIANG EAST,2005,3,3,0,6,13,0,13,26,6,5,1,12,3,0,19,34,66,18,48,188,2,1,5,0,0,64,75,0,15,0,1,0,16,3,75,313
ARUNACHAL PRADESH,SIANG UPPER,2005,5,0,0,5,2,0,2,4,1,1,0,2,0,0,0,8,16,2,14,40,0,2,2,0,2,22,29,0,8,0,0,0,8,1,11,80
ARUNACHAL PRADESH,SIANG WEST,2005,4,1,1,6,3,0,3,6,5,4,1,10,2,0,6,31,51,6,45,141,4,3,2,0,1,33,46,0,5,0,0,0,5,3,75,230
ARUNACHAL PRADESH,SUBANSIRI LOWER,2005,5,0,0,5,0,0,0,0,3,3,0,6,0,0,4,19,12,2,10,47,0,1,0,0,1,15,23,0,4,0,0,0,4,6,49,119
ARUNACHAL PRADESH,SUBANSIRI UPPER,2005,4,3,0,7,2,0,2,4,3,0,3,6,3,0,10,16,28,0,28,85,5,2,2,0,3,55,75,0,5,0,1,0,6,8,30,180
ARUNACHAL PRADESH,TAWANG,2005,2,0,0,2,1,0,1,2,0,0,0,0,0,0,1,8,18,0,18,45,0,1,0,0,0,6,9,0,1,0,1,0,2,2,7,48
ARUNACHAL PRADESH,TIRAP,2005,3,2,0,5,0,0,0,0,2,0,2,4,4,0,3,17,17,0,17,58,1,2,0,1,0,12,18,0,5,0,0,0,5,2,43,114
ARUNACHAL PRADESH,UPPER DIBANG VALLEY,2005,4,0,0,4,0,0,0,0,1,0,1,2,0,0,1,2,8,0,8,19,0,0,0,0,0,4,5,0,0,0,0,0,0,1,1,22
ASSAM,BARPETA,2005,38,4,0,42,56,0,56,112,69,66,3,138,27,2,17,145,137,2,135,465,178,9,20,2,4,265,525,8,25,0,105,0,138,47,823,1981
ASSAM,BASKA,2005,21,11,0,32,9,0,9,18,24,15,9,48,5,1,8,11,32,1,31,89,6,3,3,1,8,76,107,0,8,0,8,0,16,10,61,306
ASSAM,BONGAIGAON,2005,19,3,0,22,38,0,38,76,31,28,3,62,7,0,6,48,80,4,76,221,32,5,9,3,1,100,175,3,15,0,66,0,84,25,334,825
ASSAM,C.I.D.,2005,0,0,0,0,0,0,0,0,0,0,0,0,0,0,0,0,0,0,0,0,0,0,7,0,0,0,7,0,0,0,0,0,0,0,8,15
ASSAM,CACHAR,2005,51,44,2,97,51,0,51,102,110,99,11,220,19,2,20,193,406,4,402,1046,377,38,72,4,57,240,1161,4,165,0,334,0,503,373,1368,3930
ASSAM,CHIRANG,2005,17,0,0,17,17,0,17,34,16,16,0,32,4,0,3,14,22,0,22,65,6,0,3,0,0,23,41,7,6,0,16,0,29,9,160,323
ASSAM,DARRANG,2005,25,17,0,42,47,0,47,94,33,30,3,66,20,0,8,79,105,2,103,317,20,6,14,8,11,243,377,4,65,0,45,0,114,75,331,1156
ASSAM,DHEMAJI,2005,20,16,1,37,52,0,52,104,45,20,25,90,3,0,9,22,121,3,118,276,22,0,18,3,10,207,290,4,31,0,67,0,102,30,262,943
ASSAM,DHUBRI,2005,40,22,1,63,101,0,101,202,84,63,21,168,14,3,10,60,145,6,139,377,571,29,65,4,22,358,1290,10,56,0,201,0,267,241,248,2285
ASSAM,DIBRUGARH,2005,113,24,7,144,57,0,57,114,75,51,24,150,6,0,23,93,402,28,374,926,38,25,44,1,21,422,770,4,41,0,53,0,98,219,427,2095
ASSAM,G.R.P.,2005,4,1,0,5,2,0,2,4,5,2,3,10,4,0,5,4,105,0,105,223,9,2,3,0,0,17,35,0,4,0,0,0,4,4,121,290
ASSAM,GOALPARA,2005,31,5,0,36,40,0,40,80,73,69,4,146,14,0,12,50,127,2,125,330,93,13,10,3,7,241,413,3,2,0,142,2,149,46,248,1162
ASSAM,GOLAGHAT,2005,61,18,3,82,54,0,54,108,87,70,17,174,10,2,28,69,261,25,236,631,0,15,55,13,19,329,527,0,27,0,91,0,118,96,183,1421
ASSAM,GUWAHATI CITY,2005,39,129,71,239,38,0,38,76,147,93,54,294,6,8,96,462,1389,491,898,3350,60,90,172,15,15,969,1691,6,37,0,114,0,157,370,1418,5651
ASSAM,HAILAKANDI,2005,18,4,5,27,18,0,18,36,35,33,2,70,12,1,6,54,66,1,65,205,134,5,20,0,14,37,234,1,6,1,32,0,40,24,395,888
ASSAM,JORHAT,2005,51,10,3,64,29,0,29,58,44,40,4,88,0,0,10,54,195,44,151,454,17,19,19,5,12,123,261,0,40,0,42,0,82,66,242,981
ASSAM,KAMRUP,2005,31,18,16,65,73,0,73,146,86,53,33,172,20,0,13,96,210,103,107,549,70,40,27,3,15,40,261,0,26,0,0,0,26,66,41,891
ASSAM,KARBI ANGLONG,2005,76,15,0,91,8,0,8,16,39,15,24,78,12,0,11,26,92,8,84,233,37,5,6,1,48,50,199,2,4,1,10,0,17,52,190,685
ASSAM,KARIMGANJ,2005,30,25,0,55,28,0,28,56,31,29,2,62,4,1,5,70,156,11,145,392,209,14,14,3,19,128,429,9,8,0,71,0,88,42,216,1083
ASSAM,KOKRAJHAR,2005,46,2,0,48,36,0,36,72,44,29,15,88,8,0,14,32,83,6,77,220,87,6,25,1,4,196,408,2,17,0,53,0,72,89,183,928
ASSAM,LAKHIMPUR,2005,36,8,1,45,69,0,69,138,112,110,2,224,4,0,6,1,280,61,219,571,61,14,52,5,21,423,692,4,34,0,125,0,163,116,243,1615
ASSAM,MORIGAON,2005,22,6,1,29,52,0,52,104,47,47,0,94,1,0,6,16,139,2,137,301,72,4,25,2,5,125,276,3,67,9,65,0,144,43,271,981
ASSAM,N.C.HILLS,2005,11,7,0,18,1,0,1,2,10,8,2,20,1,0,11,16,50,1,49,128,5,5,3,0,1,23,54,0,2,0,1,0,3,17,56,220
ASSAM,NAGAON,2005,88,59,5,152,149,0,149,298,185,181,4,370,56,2,42,203,405,83,322,1113,286,59,68,9,41,606,1378,2,27,8,291,0,328,309,645,3545
ASSAM,NALBARI,2005,17,9,0,26,27,0,27,54,38,29,9,76,7,0,6,44,97,4,93,251,10,4,10,0,12,185,259,2,39,0,19,0,60,38,186,750
ASSAM,R.P.O.,2005,10,4,0,14,8,0,8,16,5,5,0,10,4,0,3,0,13,0,13,33,18,0,1,0,0,3,22,0,0,0,0,0,0,0,74,143
ASSAM,SIBSAGAR,2005,61,21,0,82,38,0,38,76,73,73,0,146,12,0,9,78,277,22,255,653,59,22,39,2,17,119,327,2,68,0,81,0,151,69,588,1635
ASSAM,SONITPUR,2005,87,7,0,94,77,0,77,154,108,106,2,216,26,0,27,177,494,17,477,1218,258,32,54,11,8,222,745,3,2,0,145,1,151,160,906,2805
ASSAM,TINSUKIA,2005,92,9,1,102,42,0,42,84,75,61,14,150,17,0,25,89,374,20,354,879,9,20,11,0,15,38,131,10,20,0,16,0,46,38,858,1759
ASSAM,UDALGURI,2005,39,5,0,44,21,0,21,42,20,15,5,40,11,0,12,49,106,4,102,284,16,3,4,4,16,98,162,6,57,0,13,0,76,21,213,714
BIHAR,ARARIA,2005,68,12,3,83,29,0,29,58,43,39,4,86,37,3,42,25,138,23,115,383,300,19,51,1,4,114,513,9,6,0,19,1,35,24,795,1743
BIHAR,ARWAL,2005,28,0,0,28,1,0,1,2,9,0,9,18,10,0,14,9,47,0,47,127,30,3,7,0,0,55,125,11,0,0,1,0,12,30,257,512
BIHAR,AURANGABAD,2005,60,164,4,228,17,0,17,34,33,23,10,66,19,0,27,104,243,5,238,636,193,0,9,0,8,1091,1319,29,0,0,9,0,38,18,255,2283
BIHAR,BAGAHA,2005,40,91,12,143,8,0,8,16,85,13,72,170,1,0,4,20,99,1,98,223,141,13,30,0,9,298,502,3,11,0,6,0,20,11,63,945
BIHAR,BANKA,2005,58,34,3,95,43,0,43,86,44,25,19,88,32,3,15,54,114,10,104,332,196,19,13,2,8,12,278,13,1,0,10,0,24,28,651,1353
BIHAR,BEGUSARAI,2005,128,53,3,184,20,0,20,40,65,20,45,130,11,3,56,53,253,9,244,629,160,53,53,4,9,259,658,25,13,2,39,0,79,120,1062,2444
BIHAR,BETTIAH,2005,76,107,6,189,51,0,51,102,114,24,90,228,33,2,33,80,306,13,293,760,304,33,93,0,20,1389,1879,19,6,0,41,0,66,40,322,3075
BIHAR,BHABHUA,2005,58,64,5,127,14,0,14,28,41,14,27,82,21,0,21,39,151,9,142,383,82,33,36,1,33,130,380,16,1,0,5,0,22,65,439,1255
BIHAR,BHAGALPUR,2005,93,52,8,153,75,0,75,150,101,52,49,202,14,0,58,119,394,83,311,979,254,66,67,4,25,29,532,18,15,0,55,0,88,87,1570,3104
BIHAR,BHOJPUR,2005,158,188,0,346,14,0,14,28,38,36,2,76,32,1,46,118,293,49,244,783,194,52,14,0,46,512,887,38,34,0,44,0,116,69,962,2853
BIHAR,BUXAR,2005,68,108,2,178,6,0,6,12,30,14,16,60,35,0,35,53,312,14,298,747,153,26,78,0,23,362,680,30,14,0,58,7,109,38,206,1644
BIHAR,DARBHANGA,2005,44,78,6,128,65,0,65,130,54,22,32,108,27,1,20,66,285,14,271,684,211,63,96,0,27,89,552,33,31,0,137,0,201,66,1741,3140
BIHAR,GAYA,2005,158,175,6,339,22,0,22,44,77,20,57,154,112,16,129,145,410,39,371,1222,405,20,23,0,32,532,1052,8,28,0,11,0,47,40,1069,3418
BIHAR,GOPALGANJ,2005,74,209,6,289,24,0,24,48,65,51,14,130,10,3,53,64,205,16,189,540,188,77,81,0,9,4,411,25,2,6,49,0,82,52,1337,2543
BIHAR,JAMALPUR RLY.,2005,7,1,0,8,0,0,0,0,3,1,2,6,13,1,7,0,108,6,102,237,3,0,7,0,0,0,10,0,1,0,0,0,1,0,44,195
BIHAR,JAMUI,2005,93,52,2,147,33,0,33,66,46,13,33,92,39,3,44,49,102,4,98,339,109,6,29,0,59,205,429,22,20,0,48,0,90,21,427,1409
BIHAR,JEHANABAD,2005,52,52,2,106,16,0,16,32,19,2,17,38,35,0,35,60,150,18,132,430,95,3,14,0,13,81,237,7,14,0,17,0,38,31,495,1191
BIHAR,KATIHAR,2005,78,41,1,120,88,0,88,176,61,53,8,122,19,4,34,36,146,19,127,385,124,15,34,2,16,129,370,26,10,0,55,0,91,50,816,1785
BIHAR,KATIHAR RLY.,2005,11,0,0,11,2,0,2,4,7,4,3,14,2,2,13,4,214,5,209,449,8,0,20,0,0,0,28,1,7,0,0,0,8,0,141,432
BIHAR,KHAGARIA,2005,48,41,0,89,14,0,14,28,35,15,20,70,12,0,39,20,14,5,9,99,140,5,4,0,10,120,379,12,5,0,12,0,29,100,808,1439
BIHAR,KISHANGANJ,2005,17,23,2,42,61,0,61,122,84,81,3,168,10,8,10,36,122,17,105,308,95,27,24,1,7,102,271,3,2,0,30,0,35,15,338,1017
BIHAR,LAKHISARAI,2005,57,26,1,84,3,0,3,6,38,17,21,76,8,3,33,22,81,5,76,228,56,8,13,0,10,36,166,8,6,0,6,0,20,43,382,840
BIHAR,MADHEPURA,2005,52,24,2,78,15,0,15,30,13,9,4,26,17,1,38,24,50,6,44,180,100,6,16,1,5,119,285,10,6,0,11,0,27,38,589,1137
BIHAR,MADHUBANI,2005,69,108,7,184,42,0,42,84,66,0,66,132,45,2,31,99,196,0,196,569,313,54,19,0,23,867,1303,17,35,0,26,0,78,27,789,2835
BIHAR,MOTIHARI,2005,111,159,15,285,24,0,24,48,134,38,96,268,52,8,67,108,437,21,416,1109,366,87,71,0,30,1043,1673,51,13,0,43,8,115,76,1661,4564
BIHAR,MUNGER,2005,95,29,1,125,18,0,18,36,54,11,43,108,19,0,64,38,219,37,182,559,154,9,32,1,8,70,315,11,10,0,16,0,37,41,860,1749
BIHAR,MUZAFFARPUR,2005,131,22,11,164,80,0,80,160,225,14,211,450,48,4,95,248,763,170,593,1921,407,126,107,4,47,685,1529,67,17,0,104,0,188,153,2019,5363
BIHAR,MUZAFFARPUR RLY.,2005,26,0,0,26,1,0,1,2,11,2,9,22,10,0,15,9,275,18,257,584,19,0,14,0,0,13,54,0,0,0,0,0,0,8,182,583
BIHAR,NALANDA,2005,150,100,19,269,25,0,25,50,94,21,73,188,39,10,89,68,312,22,290,830,169,47,67,3,21,661,1110,65,10,1,92,4,172,142,812,3000
BIHAR,NAUGACHIA,2005,43,29,1,73,6,0,6,12,36,5,31,72,12,2,40,18,65,2,63,202,109,2,18,2,0,0,131,9,0,0,6,0,15,0,601,999
BIHAR,NAWADAH,2005,83,87,5,175,23,0,23,46,41,11,30,82,16,7,30,54,117,20,97,341,266,17,40,4,10,149,563,22,13,0,32,0,67,77,639,1732
BIHAR,PATNA,2005,436,87,25,548,57,0,57,114,275,59,216,550,127,39,633,521,1356,1127,229,4032,484,47,199,3,46,392,1623,85,5,2,189,0,281,452,6380,11840
BIHAR,PATNA RLY.,2005,15,6,2,23,0,0,0,0,2,0,2,4,15,5,27,3,601,62,539,1252,6,1,21,2,0,0,30,2,6,0,0,0,8,0,236,950
BIHAR,PURNEA,2005,113,35,6,154,39,0,39,78,60,7,53,120,38,6,95,72,218,34,184,647,152,8,20,0,9,22,266,6,6,0,16,0,28,55,1193,2169
BIHAR,ROHTAS,2005,107,218,13,338,18,0,18,36,29,7,22,58,23,0,26,111,315,21,294,790,137,2,14,10,23,85,476,37,12,0,7,0,56,205,1992,3384
BIHAR,SAHARSA,2005,17,88,3,108,11,0,11,22,40,2,38,80,6,3,28,46,112,4,108,307,185,26,34,1,10,102,391,5,19,0,12,6,42,33,654,1441
BIHAR,SAMASTIPUR,2005,121,184,30,335,28,0,28,56,97,4,93,194,19,17,61,88,291,46,245,767,302,46,57,0,59,306,824,40,10,0,73,48,171,54,1521,3452
BIHAR,SARAN,2005,125,345,21,491,32,0,32,64,85,43,42,170,52,0,24,165,321,51,270,883,170,12,70,1,26,1198,1584,76,4,1,58,0,139,107,340,3233
BIHAR,SHEIKHPURA,2005,33,0,0,33,1,0,1,2,23,3,20,46,4,0,14,9,51,2,49,129,58,0,11,0,0,0,69,12,0,0,17,0,29,0,450,683
BIHAR,SHEOHAR,2005,11,7,1,19,9,0,9,18,26,14,12,52,15,0,6,12,28,1,27,89,78,5,6,0,3,23,122,1,2,0,10,0,13,7,243,493
BIHAR,SITAMARHI,2005,63,25,4,92,32,0,32,64,74,51,23,148,21,1,18,64,206,26,180,516,245,51,29,1,12,93,470,32,12,0,64,0,108,39,1601,2687
BIHAR,SIWAN,2005,93,43,3,139,27,0,27,54,59,33,26,118,50,1,119,71,212,37,175,665,182,15,70,0,23,253,609,31,8,1,60,0,100,66,803,2190
BIHAR,SUPAUL,2005,34,32,8,74,40,0,40,80,24,5,19,48,38,2,36,19,103,10,93,301,223,7,9,0,5,3,262,7,0,0,12,0,19,15,607,1224
BIHAR,VAISHALI,2005,69,108,10,187,13,0,13,26,133,51,82,266,14,4,50,94,377,53,324,916,105,72,109,2,32,306,763,72,36,0,74,0,182,137,1705,3522
CHHATTISGARH,BALRAMPUR,2005,29,16,5,50,36,0,36,72,5,1,4,10,16,2,14,44,19,4,15,114,24,2,0,0,6,40,91,0,20,5,13,0,38,19,206,521
CHHATTISGARH,BILASPUR,2005,94,54,11,159,77,0,77,154,36,36,0,72,4,2,50,530,779,235,544,2144,152,8,56,14,19,368,814,18,154,19,117,0,308,197,2718,5477
CHHATTISGARH,BIZAPUR,2005,76,122,0,198,5,0,5,10,1,0,1,2,61,0,4,10,6,0,6,87,13,1,3,0,10,22,56,0,3,0,0,0,3,7,57,401
CHHATTISGARH,DANTEWARA,2005,73,36,0,109,15,0,15,30,6,5,1,12,13,0,3,57,58,10,48,189,12,1,4,1,4,56,119,0,12,0,2,0,14,41,304,698
CHHATTISGARH,DHAMTARI,2005,11,7,0,18,26,0,26,52,9,9,0,18,0,0,3,136,128,25,103,395,20,3,5,2,6,90,207,2,80,11,15,0,108,81,674,1309
CHHATTISGARH,DURG,2005,90,65,0,155,128,0,128,256,28,19,9,56,1,2,71,508,950,285,665,2482,54,12,76,5,32,494,949,14,216,23,107,0,360,276,3495,6647
CHHATTISGARH,GRP RAIPUR,2005,5,5,0,10,2,0,2,4,1,1,0,2,0,0,6,11,238,17,221,493,5,0,1,2,1,17,28,2,6,0,2,0,10,2,79,385
CHHATTISGARH,JAGDALPUR,2005,63,44,0,107,74,0,74,148,9,0,9,18,8,4,12,177,173,29,144,547,54,1,31,3,7,170,393,3,50,2,24,0,79,127,1051,2087
CHHATTISGARH,JANJGIR,2005,50,20,2,72,43,0,43,86,10,5,5,20,3,0,8,223,301,77,224,836,102,8,25,7,6,273,527,12,77,8,104,0,201,106,1317,2705
CHHATTISGARH,JASHPUR,2005,63,20,4,87,68,0,68,136,19,18,1,38,7,2,34,78,72,26,46,265,16,3,22,1,5,145,238,3,45,10,6,0,64,46,290,959
CHHATTISGARH,KABIRDHAM,2005,16,8,2,26,24,0,24,48,4,4,0,8,0,1,1,92,119,15,104,332,23,0,8,0,6,332,391,1,55,3,31,0,90,22,371,1119
CHHATTISGARH,KANKER,2005,40,28,0,68,32,0,32,64,11,9,2,22,28,0,14,58,64,9,55,228,37,2,4,2,17,68,177,0,26,0,9,0,35,47,535,1022
CHHATTISGARH,KORBA,2005,35,12,3,50,27,0,27,54,3,2,1,6,2,0,15,136,322,97,225,797,33,1,20,3,10,419,618,7,48,4,29,0,88,132,822,2083
CHHATTISGARH,KORIYA,2005,34,20,1,55,51,0,51,102,5,5,0,10,4,1,15,142,128,18,110,418,27,1,15,0,4,150,263,3,64,1,43,0,111,66,568,1343
CHHATTISGARH,MAHASAMUND,2005,19,9,2,30,25,0,25,50,7,5,2,14,2,2,10,120,219,43,176,572,13,6,21,3,9,213,357,3,81,6,23,0,113,92,666,1551
CHHATTISGARH,NARAYANPUR,2005,13,41,0,54,1,0,1,2,0,0,0,0,24,0,7,8,6,0,6,51,1,3,0,0,6,19,34,0,6,0,1,0,7,5,22,163
CHHATTISGARH,RAIGARH,2005,62,29,2,93,35,0,35,70,11,11,0,22,8,1,30,175,430,133,297,1074,61,10,22,1,14,159,411,9,64,2,32,0,107,144,933,2234
CHHATTISGARH,RAIPUR,2005,92,59,2,153,125,0,125,250,46,41,5,92,4,2,42,619,1027,474,553,2721,101,38,80,27,19,373,990,16,235,29,94,0,374,352,4072,7454
CHHATTISGARH,RAJNANDGAON,2005,40,26,0,66,81,0,81,162,8,6,2,16,7,4,16,157,234,59,175,652,29,2,16,0,17,121,309,5,69,6,25,0,105,124,1432,2419
CHHATTISGARH,SARGUJA,2005,52,22,5,79,74,0,74,148,19,0,19,38,10,1,28,210,198,48,150,645,70,4,18,2,12,96,255,1,77,1,31,0,110,53,859,1843
CHHATTISGARH,SURAJPUR,2005,56,17,2,75,41,0,41,82,8,7,1,16,2,1,18,130,129,15,114,409,46,4,4,0,4,109,232,1,62,2,24,0,89,65,488,1213
GOA,NORTH GOA,2005,22,10,4,36,11,0,11,22,7,4,3,14,1,0,15,172,290,101,189,768,32,30,30,3,7,89,314,0,15,6,7,0,28,123,431,1305
GOA,SOUTH GOA,2005,23,5,1,29,9,0,9,18,10,8,2,20,1,0,13,93,205,84,121,517,13,20,28,3,5,66,221,2,15,2,4,0,23,86,210,814
GUJARAT,AHMEDABAD COMMR.,2005,76,49,4,129,35,0,35,70,219,136,83,438,23,3,159,825,5359,2264,3095,11728,150,267,344,9,6,1361,2325,1,54,26,745,0,826,188,7565,17468
GUJARAT,AHMEDABAD RURAL,2005,28,7,2,37,7,0,7,14,29,26,3,58,9,1,29,94,242,59,183,617,48,38,9,8,5,310,697,0,15,0,72,0,87,279,1693,2925
GUJARAT,AHWA-DANG,2005,5,1,0,6,5,0,5,10,0,0,0,0,0,0,1,2,3,1,2,9,3,4,2,1,0,30,57,0,5,0,5,0,10,17,62,146
GUJARAT,AMRELI,2005,24,14,1,39,11,0,11,22,49,47,2,98,3,0,18,127,186,49,137,520,28,31,10,16,15,286,483,2,18,1,127,0,148,97,2514,3578
GUJARAT,ANAND,2005,20,7,1,28,7,0,7,14,24,20,4,48,8,0,17,119,320,146,174,784,20,68,19,8,9,333,639,1,28,2,97,0,128,182,1787,3077
GUJARAT,BHARUCH,2005,35,10,1,46,8,0,8,16,23,15,8,46,8,0,14,139,323,123,200,807,29,56,9,10,12,335,662,0,16,5,46,0,67,211,1398,2688
GUJARAT,BHAVNAGAR,2005,66,31,0,97,14,0,14,28,85,70,15,170,30,0,164,398,1116,345,771,2824,190,91,155,46,41,93,619,3,79,33,216,0,331,3,4732,7586
GUJARAT,DAHOD,2005,48,13,1,62,9,0,9,18,29,26,3,58,20,2,26,77,128,72,56,381,54,10,3,4,14,279,364,0,28,0,28,0,56,0,750,1523
GUJARAT,GANDHINAGAR,2005,20,6,0,26,9,0,9,18,29,20,9,58,5,0,23,124,395,152,243,942,19,12,37,9,16,237,481,4,8,4,101,0,117,151,1437,2646
GUJARAT,HIMATNAGAR,2005,26,12,2,40,12,0,12,24,32,31,1,64,15,0,20,145,222,70,152,624,60,47,25,28,16,349,762,0,42,0,147,0,189,237,2943,4380
GUJARAT,JAMNAGAR,2005,41,19,1,61,14,0,14,28,20,15,5,40,1,0,14,152,402,140,262,971,45,48,26,16,11,366,516,0,15,3,188,0,206,4,2496,3882
GUJARAT,JUNAGADH,2005,33,27,0,60,13,0,13,26,38,32,6,76,6,0,43,225,469,182,287,1212,67,68,37,35,17,487,921,5,54,9,421,0,489,210,3522,5786
GUJARAT,KHEDA NORTH,2005,30,8,1,39,14,0,14,28,30,29,1,60,7,0,18,114,336,96,240,811,42,33,19,15,8,316,649,0,39,0,155,0,194,216,2596,3997
GUJARAT,KUTCH,2005,35,23,0,58,9,0,9,18,45,36,9,90,9,0,33,233,411,176,235,1097,61,34,72,15,9,424,875,4,42,2,234,0,282,260,2466,4421
GUJARAT,MEHSANA,2005,30,21,1,52,6,0,6,12,55,47,8,110,19,1,55,258,599,104,495,1531,71,48,70,14,10,488,852,1,25,0,221,0,247,151,2648,4792
GUJARAT,NARMADA,2005,15,2,0,17,6,0,6,12,1,1,0,2,4,0,2,26,30,4,26,92,19,5,1,0,3,92,156,0,2,0,4,0,6,36,801,1049
GUJARAT,NAVSARI,2005,14,3,0,17,6,0,6,12,6,5,1,12,4,0,7,52,95,52,43,253,5,19,12,11,1,83,131,2,3,0,31,0,36,0,892,1246
GUJARAT,PALANPUR,2005,40,24,1,65,11,0,11,22,23,21,2,46,11,0,20,192,306,65,241,835,34,12,39,14,14,980,1277,1,26,0,79,0,106,184,1834,3845
GUJARAT,PANCHMAHAL,2005,50,6,0,56,12,0,12,24,32,28,4,64,5,0,23,135,251,92,159,665,28,39,14,7,16,204,308,1,75,3,86,0,165,0,2272,3259
GUJARAT,PATAN,2005,24,13,1,38,6,0,6,12,22,19,3,44,6,0,13,84,303,50,253,709,38,27,5,10,23,305,503,0,24,0,111,0,135,95,1536,2646
GUJARAT,PORBANDAR,2005,10,8,0,18,1,0,1,2,9,8,1,18,0,0,13,48,61,26,35,183,7,11,7,7,6,128,224,1,5,0,36,0,42,58,670,1086
GUJARAT,RAJKOT COMMR.,2005,24,12,0,36,7,0,7,14,37,33,4,74,7,0,31,265,989,529,460,2281,64,39,47,43,5,333,624,0,7,7,153,0,167,93,1771,3934
GUJARAT,RAJKOT RURAL,2005,35,32,4,71,18,0,18,36,56,48,8,112,6,0,27,185,369,99,270,956,76,135,29,15,20,443,938,4,39,1,278,0,322,220,2817,4809
GUJARAT,SURAT COMMR.,2005,86,23,3,112,23,0,23,46,114,72,42,228,22,4,56,429,1797,1140,657,4105,118,65,202,31,8,637,1465,12,50,4,190,0,256,404,995,5273
GUJARAT,SURAT RURAL,2005,46,9,2,57,9,0,9,18,14,14,0,28,12,0,17,92,181,64,117,483,27,14,26,13,8,198,620,5,4,0,23,0,32,334,1212,2246
GUJARAT,SURENDRANAGAR,2005,30,21,0,51,13,0,13,26,38,31,7,76,8,0,23,126,305,71,234,767,77,40,8,22,7,494,799,0,36,1,90,0,127,151,2036,3526
GUJARAT,VADODARA COMMR.,2005,26,24,1,51,5,0,5,10,39,26,13,78,6,2,20,392,1341,689,652,3102,174,34,192,16,6,300,844,0,13,2,136,0,151,122,2425,5276
GUJARAT,VADODARA RURAL,2005,70,13,0,83,21,0,21,42,37,36,1,74,9,0,16,105,166,56,110,462,40,38,15,12,12,339,669,0,25,0,38,0,63,213,1854,3023
GUJARAT,VALSAD,2005,34,13,0,47,11,0,11,22,25,20,5,50,17,0,17,153,319,121,198,825,29,24,38,10,2,241,344,1,17,0,31,0,49,0,712,1694
GUJARAT,W.RLY,2005,12,1,0,13,2,0,2,4,4,4,0,8,2,2,47,16,940,46,894,1947,5,13,69,2,0,32,125,0,8,1,1,0,10,4,446,1607
HARYANA,AMBALA,2005,24,16,2,42,19,0,19,38,24,19,5,48,1,2,15,179,275,116,159,747,2,48,66,1,8,254,381,9,19,16,130,0,174,2,952,2064
HARYANA,BHIWANI,2005,47,18,3,68,18,0,18,36,24,22,2,48,3,6,19,190,389,180,209,996,134,30,52,0,6,262,489,19,20,16,87,0,142,5,836,2184
HARYANA,FARIDABAD,2005,76,44,4,124,39,0,39,78,91,67,24,182,2,30,30,285,1130,876,254,2607,190,126,43,4,8,349,743,18,42,253,188,0,501,23,2076,5051
HARYANA,FATEHABAD,2005,21,14,1,36,9,0,9,18,20,15,5,40,0,1,6,108,157,93,64,429,11,11,116,1,4,185,332,5,17,8,66,0,96,4,517,1282
HARYANA,GRP,2005,13,8,1,22,2,0,2,4,2,2,0,4,1,1,5,3,195,0,195,400,11,4,5,0,0,21,58,7,2,116,0,0,125,17,445,859
HARYANA,GURGAON,2005,65,38,6,109,17,0,17,34,38,22,16,76,8,10,40,413,1462,1112,350,3395,67,45,124,0,5,121,377,10,20,31,71,0,132,15,1363,3969
HARYANA,HISSAR,2005,51,50,2,103,25,0,25,50,22,9,13,44,3,9,28,248,526,272,254,1340,45,15,148,1,10,333,552,19,31,6,139,0,195,0,998,2709
HARYANA,JHAJJAR,2005,60,32,4,96,13,0,13,26,14,10,4,28,1,8,28,96,203,98,105,539,53,28,37,0,5,115,365,11,16,20,86,0,133,127,386,1343
HARYANA,JIND,2005,37,27,2,66,14,0,14,28,12,6,6,24,1,4,10,73,210,119,91,508,69,27,20,3,7,125,253,17,2,17,35,0,71,2,517,1231
HARYANA,KAITHAL,2005,23,18,3,44,19,0,19,38,11,9,2,22,1,3,6,120,197,72,125,524,0,48,21,3,2,211,288,6,9,0,115,0,130,3,467,1286
HARYANA,KARNAL,2005,46,31,8,85,50,0,50,100,31,19,12,62,5,10,27,215,648,299,349,1553,44,12,128,6,4,776,1205,14,39,2,236,0,291,235,423,2990
HARYANA,KURUKSHETRA,2005,25,15,2,42,24,0,24,48,15,9,6,30,16,2,18,220,412,171,241,1080,0,4,39,3,6,180,232,5,24,15,99,0,143,0,1040,2164
HARYANA,MAHENDRAGARH,2005,12,7,2,21,15,0,15,30,13,9,4,26,2,0,6,71,126,57,69,331,49,23,6,0,5,120,206,6,13,0,20,0,39,3,585,1084
HARYANA,MEWAT,2005,19,34,1,54,34,0,34,68,9,3,6,18,14,21,10,37,223,127,96,528,91,10,33,1,8,183,327,7,12,5,112,0,136,1,702,1567
HARYANA,PANCHKULA,2005,9,2,0,11,8,0,8,16,15,13,2,30,0,0,3,139,227,120,107,596,4,7,73,0,0,31,205,2,7,18,65,0,92,90,500,1200
HARYANA,PANIPAT,2005,42,19,7,68,56,0,56,112,35,21,14,70,9,8,34,176,583,376,207,1393,32,37,13,3,4,164,435,11,11,10,127,0,159,182,575,2138
HARYANA,REWARI,2005,33,11,1,45,13,0,13,26,20,19,1,40,10,1,16,117,256,141,115,656,36,33,20,0,11,160,263,9,21,10,50,0,90,3,922,1753
HARYANA,ROHTAK,2005,48,48,1,97,29,0,29,58,16,10,6,32,3,6,31,209,425,267,158,1099,37,15,81,2,9,178,480,9,17,32,79,0,137,158,570,2003
HARYANA,SIRSA,2005,31,23,2,56,15,0,15,30,16,10,6,32,3,2,11,186,256,106,150,714,16,9,50,0,6,330,414,10,17,0,119,0,146,3,562,1667
HARYANA,SONIPAT,2005,73,42,1,116,28,0,28,56,39,29,10,78,2,12,35,178,464,231,233,1155,8,20,74,1,6,287,606,14,21,22,124,0,181,210,752,2413
HARYANA,YAMUNANAGAR,2005,29,16,4,49,14,0,14,28,25,21,4,50,3,2,12,174,330,201,129,851,0,10,55,2,5,184,256,4,20,0,127,0,151,0,691,1707
HIMACHAL PRADESH,BILASPUR,2005,13,7,3,23,8,0,8,16,9,6,3,18,1,0,1,34,59,11,48,154,28,8,22,1,20,58,181,0,30,0,27,0,57,44,792,1165
HIMACHAL PRADESH,CHAMBA,2005,9,8,1,18,12,0,12,24,8,8,0,16,0,0,1,110,36,4,32,183,12,1,1,1,11,58,115,1,20,0,10,0,31,31,249,580
HIMACHAL PRADESH,G.R.P.,2005,0,0,0,0,0,0,0,0,0,0,0,0,0,0,0,2,5,0,5,12,0,0,0,0,0,0,0,0,0,0,0,0,0,0,3,10
HIMACHAL PRADESH,HAMIRPUR,2005,4,2,3,9,4,0,4,8,4,4,0,8,0,0,0,52,42,9,33,136,32,11,20,1,10,245,354,0,11,4,21,0,36,35,482,983
HIMACHAL PRADESH,KANGRA,2005,21,13,6,40,23,0,23,46,22,18,4,44,2,0,4,95,99,23,76,299,97,3,31,1,15,218,366,0,27,8,48,0,83,1,1289,2023
HIMACHAL PRADESH,KINNAUR,2005,3,1,0,4,4,0,4,8,3,3,0,6,1,0,1,36,10,0,10,58,10,0,0,0,0,14,38,0,6,1,6,0,13,14,121,231
HIMACHAL PRADESH,KULLU,2005,10,13,1,24,19,0,19,38,24,24,0,48,1,0,8,82,77,9,68,245,49,2,4,0,2,52,152,0,23,0,12,0,35,43,448,870
HIMACHAL PRADESH,LAHAUL-SPITI,2005,0,0,0,0,0,0,0,0,1,1,0,2,0,0,0,0,2,0,2,4,0,1,0,0,0,3,13,0,0,0,1,0,1,9,34,51
HIMACHAL PRADESH,MANDI,2005,7,12,1,20,8,0,8,16,10,8,2,20,0,0,2,65,62,22,40,191,46,5,16,0,16,156,301,0,70,4,20,0,94,62,1150,1712
HIMACHAL PRADESH,SHIMLA,2005,15,6,1,22,32,0,32,64,14,10,4,28,0,0,3,94,147,31,116,391,122,32,36,0,8,78,354,0,51,7,29,0,87,78,1256,2009
HIMACHAL PRADESH,SIRMAUR,2005,12,5,0,17,11,0,11,22,9,8,1,18,0,0,0,33,33,12,21,99,58,2,11,0,4,40,165,0,20,4,21,0,45,50,407,720
HIMACHAL PRADESH,SOLAN,2005,6,8,6,20,15,0,15,30,9,8,1,18,0,0,2,42,63,24,39,170,65,11,9,0,5,345,506,1,22,1,19,0,43,71,536,1236
HIMACHAL PRADESH,UNA,2005,10,4,0,14,5,0,5,10,5,4,1,10,1,0,0,51,61,21,40,174,39,6,13,2,6,92,200,0,6,0,14,0,20,42,398,755
JAMMU & KASHMIR,ANANTNAG,2005,37,49,5,91,9,0,9,18,83,78,5,166,4,0,22,146,122,28,94,416,47,12,19,1,29,19,150,0,63,35,1,0,99,23,804,1530
JAMMU & KASHMIR,AWANTIPORA,2005,29,7,0,36,7,0,7,14,11,9,2,22,0,0,1,37,50,5,45,138,17,0,9,1,0,0,27,0,25,3,0,0,28,0,213,410
JAMMU & KASHMIR,BARAMULLA,2005,78,93,4,175,16,0,16,32,109,97,12,218,0,0,11,156,166,13,153,499,134,10,13,10,24,15,206,0,166,36,0,0,202,0,660,1701
JAMMU & KASHMIR,BORDER,2005,7,15,0,22,5,0,5,10,9,8,1,18,0,0,0,21,24,5,19,69,19,2,3,2,2,8,69,0,7,5,0,0,12,33,360,522
JAMMU & KASHMIR,BUDGAM,2005,27,29,3,59,6,0,6,12,63,55,8,126,1,0,2,82,141,20,121,367,118,3,9,3,13,5,173,0,75,17,0,0,92,22,346,965
JAMMU & KASHMIR,CRIME JAMMU,2005,2,0,0,2,0,0,0,0,0,0,0,0,0,0,0,0,0,0,0,0,0,0,43,0,0,0,43,0,0,0,0,0,0,0,1,46
JAMMU & KASHMIR,CRIME SRINAGAR,2005,0,0,0,0,0,0,0,0,0,0,0,0,0,0,0,0,0,0,0,0,0,7,85,0,0,0,92,0,0,0,0,0,0,0,1,93
JAMMU & KASHMIR,DODA,2005,66,82,1,149,7,0,7,14,14,14,0,28,0,0,0,43,48,3,45,139,24,6,3,0,15,36,111,0,6,2,1,0,9,27,302,683
JAMMU & KASHMIR,GANDERBAL,2005,13,3,1,17,5,0,5,10,39,38,1,78,0,0,7,35,60,5,55,162,52,4,7,0,16,1,91,0,42,4,0,0,46,11,198,498
JAMMU & KASHMIR,HANDWARA,2005,17,40,1,58,10,0,10,20,30,27,3,60,0,0,6,32,41,0,41,120,41,0,11,0,5,6,64,0,44,3,1,0,48,1,205,494
JAMMU & KASHMIR,JAMMU,2005,22,58,9,89,20,0,20,40,42,40,2,84,1,0,1,180,382,208,174,946,69,17,64,1,9,32,341,4,22,36,28,0,90,149,1939,3085
JAMMU & KASHMIR,KARGIL,2005,0,0,0,0,1,0,1,2,2,2,0,4,0,0,0,5,4,0,4,13,2,3,3,0,1,0,18,0,3,0,0,0,3,9,60,93
JAMMU & KASHMIR,KATHUA,2005,12,29,1,42,12,0,12,24,16,12,4,32,0,0,2,44,23,4,19,92,15,6,2,0,6,23,120,0,7,8,4,0,19,68,689,967
JAMMU & KASHMIR,KULGAM,2005,39,7,1,47,12,0,12,24,43,35,8,86,0,0,11,51,55,9,46,172,60,1,8,1,9,7,98,0,22,3,1,0,26,12,241,584
JAMMU & KASHMIR,KUPWARA,2005,22,60,1,83,11,0,11,22,40,33,7,80,0,0,0,55,49,1,48,153,96,8,7,4,16,1,132,0,40,5,0,0,45,0,260,675
JAMMU & KASHMIR,LEH,2005,1,1,1,3,5,0,5,10,3,3,0,6,0,0,0,11,9,1,8,29,13,1,3,0,0,0,17,0,4,0,0,0,4,0,122,174
JAMMU & KASHMIR,POONCH,2005,35,85,1,121,7,0,7,14,16,14,2,32,0,0,0,22,60,0,60,142,50,5,8,0,10,30,113,0,11,1,7,0,19,10,283,641
JAMMU & KASHMIR,PULWAMA,2005,42,70,1,113,7,0,7,14,37,36,1,74,1,0,14,57,109,17,92,290,191,3,10,2,10,71,300,0,40,4,0,0,44,13,240,922
JAMMU & KASHMIR,RAILWAYS,2005,0,1,0,1,0,0,0,0,1,1,0,2,0,0,0,0,9,0,9,18,0,0,0,0,1,0,2,0,0,0,0,0,0,1,8,21
JAMMU & KASHMIR,RAJOURI,2005,51,63,0,114,21,0,21,42,23,23,0,46,0,0,2,46,61,6,55,170,91,3,13,0,29,39,211,0,15,7,14,0,36,36,654,1168
JAMMU & KASHMIR,RAMBAN,2005,50,42,1,93,6,0,6,12,12,10,2,24,2,0,0,25,43,0,43,113,14,1,9,0,9,8,42,0,4,1,4,0,9,1,416,648
JAMMU & KASHMIR,REASI,2005,33,32,1,66,1,0,1,2,12,11,1,24,0,0,0,27,20,1,19,67,0,1,1,1,6,3,12,0,2,3,1,0,6,0,172,316
JAMMU & KASHMIR,SRINAGAR,2005,52,116,5,173,18,0,18,36,132,103,29,264,4,0,36,279,361,171,190,1041,147,15,63,3,29,36,337,0,219,181,11,0,411,44,1132,2883
JAMMU & KASHMIR,UDHAMPUR,2005,12,23,0,35,15,0,15,30,11,9,2,22,0,0,1,43,64,7,57,172,22,9,10,0,1,15,59,1,13,17,3,0,34,2,734,996
JHARKHAND,BOKARO,2005,49,13,0,62,36,0,36,72,43,41,2,86,34,0,45,186,576,90,486,1417,128,0,55,0,25,0,223,19,0,7,47,0,73,15,1133,2411
JHARKHAND,CHAIBASA,2005,115,54,2,171,53,0,53,106,2,0,2,4,11,2,21,16,140,0,140,330,27,11,11,0,5,68,130,0,2,7,11,0,20,8,438,1004
JHARKHAND,CHATRA,2005,27,0,0,27,11,0,11,22,9,2,7,18,15,0,20,16,88,2,86,227,82,0,2,0,1,0,95,14,1,0,3,0,18,10,417,716
JHARKHAND,DEOGHAR,2005,51,56,1,108,46,0,46,92,10,1,9,20,10,0,15,119,166,15,151,476,164,14,29,0,7,199,424,3,15,2,19,0,39,11,448,1385
JHARKHAND,DHANBAD,2005,97,65,12,174,32,0,32,64,68,58,10,136,71,3,52,179,722,154,568,1749,296,24,79,1,8,481,896,48,16,7,31,0,102,7,1346,3645
JHARKHAND,DHANBAD RLY.,2005,5,0,0,5,2,0,2,4,2,1,1,4,22,0,22,4,18,2,16,84,4,2,3,0,0,0,11,3,0,0,0,0,3,2,14,103
JHARKHAND,DUMKA,2005,52,18,7,77,38,0,38,76,23,9,14,46,10,0,5,71,176,37,139,438,135,4,16,0,23,146,389,12,11,7,38,3,71,65,711,1571
JHARKHAND,GARHWA,2005,47,5,0,52,17,0,17,34,20,0,20,40,8,0,17,46,77,0,77,225,132,0,20,0,0,8,167,17,0,2,15,0,34,7,526,964
JHARKHAND,GIRIDIH,2005,63,101,2,166,28,0,28,56,41,39,2,82,53,3,36,119,306,12,294,823,222,7,13,0,4,67,397,24,54,0,44,0,122,84,1085,2356
JHARKHAND,GODDA,2005,44,83,6,133,46,0,46,92,29,0,29,58,6,0,11,52,117,0,117,303,142,8,30,0,30,71,296,8,28,0,39,0,75,15,508,1273
JHARKHAND,GUMLA,2005,140,40,1,181,45,0,45,90,17,10,7,34,26,0,27,32,61,14,47,207,31,7,5,7,7,1,68,2,10,0,6,0,18,10,312,787
JHARKHAND,HAZARIBAGH,2005,104,34,11,149,57,0,57,114,55,32,23,110,99,6,82,155,726,181,545,1794,279,16,66,5,17,45,443,31,32,0,55,0,118,15,1299,3189
JHARKHAND,JAMSHEDPUR,2005,87,103,8,198,37,0,37,74,43,9,34,86,17,5,49,152,834,112,722,1891,85,60,118,5,10,223,674,10,34,1,56,0,101,173,1033,3143
JHARKHAND,JAMSHEDPUR RLY.,2005,8,0,0,8,0,0,0,0,2,0,2,4,7,0,7,5,130,5,125,279,1,0,4,0,0,5,10,0,3,0,3,0,6,0,225,400
JHARKHAND,JAMTARA,2005,19,28,2,49,0,0,0,0,6,3,3,12,12,1,5,25,88,2,86,219,70,1,6,0,0,124,224,6,17,2,17,0,42,23,88,540
JHARKHAND,KODERMA,2005,26,9,0,35,12,0,12,24,14,4,10,28,22,1,18,17,91,27,64,240,41,18,21,0,3,39,172,15,4,0,23,0,42,50,392,816
JHARKHAND,LATEHAR,2005,34,1,1,36,12,0,12,24,6,6,0,12,26,1,13,16,59,7,52,174,14,2,1,0,0,0,49,1,2,0,3,0,6,32,235,459
JHARKHAND,LOHARDAGGA,2005,51,43,1,95,25,0,25,50,18,14,4,36,10,2,28,25,90,7,83,245,58,6,19,0,4,87,195,1,11,0,29,0,41,21,86,615
JHARKHAND,PAKUR,2005,35,84,4,123,30,0,30,60,9,6,3,18,7,0,5,18,54,7,47,138,90,12,11,0,7,112,265,4,12,0,5,0,21,33,187,719
JHARKHAND,PALAMU,2005,69,57,4,130,27,0,27,54,44,30,14,88,9,6,34,91,160,19,141,460,217,13,40,0,21,541,832,21,13,0,29,0,63,0,322,1718
JHARKHAND,RANCHI,2005,239,168,19,426,102,5,97,204,105,0,105,210,82,19,190,239,1138,462,676,2806,174,26,49,0,11,681,1808,11,14,0,58,0,83,867,883,5075
JHARKHAND,SAHEBGANJ,2005,47,43,4,94,44,0,44,88,26,6,20,52,5,0,12,17,117,7,110,268,70,5,16,1,10,49,172,4,6,1,36,0,47,21,279,813
JHARKHAND,SARAIKELA,2005,49,59,2,110,33,0,33,66,19,6,13,38,18,0,7,6,191,10,181,413,52,4,20,0,0,89,175,3,6,0,22,0,31,10,423,1013
JHARKHAND,SIMDEGA,2005,65,20,0,85,20,0,20,40,10,6,4,20,12,0,11,4,70,9,61,167,10,3,9,0,9,42,84,0,2,0,1,1,4,11,160,460
KARNATAKA,BAGALKOT,2005,43,28,2,73,4,0,4,8,15,4,11,30,17,9,9,97,128,47,81,388,204,6,34,1,9,324,578,1,43,4,68,0,116,0,1037,2083
KARNATAKA,BANGALORE COMMR.,2005,242,282,5,529,38,0,38,76,131,25,106,262,35,82,594,1771,9617,3753,5864,21716,377,172,1633,90,5,3474,5844,39,167,39,287,0,532,93,9869,29042
KARNATAKA,BANGALORE RURAL,2005,171,94,2,267,16,0,16,32,44,20,24,88,25,1,58,378,876,292,584,2214,599,24,106,1,13,1154,1897,46,110,0,102,0,258,0,4380,8200
KARNATAKA,BELGAUM,2005,116,79,1,196,13,0,13,26,41,26,15,82,11,2,36,234,363,137,226,1009,311,14,141,4,23,816,1343,10,74,0,108,0,192,34,3249,5680
KARNATAKA,BELLARY,2005,58,35,0,93,17,0,17,34,21,16,5,42,4,1,31,166,304,115,189,810,263,12,93,2,17,627,1021,5,53,0,60,0,118,7,2656,4432
KARNATAKA,BIDAR,2005,38,44,1,83,5,0,5,10,12,8,4,24,2,0,22,136,183,31,152,526,165,19,34,2,9,1056,1285,10,44,3,53,0,110,0,1751,3589
KARNATAKA,BIJAPUR,2005,49,61,2,112,18,0,18,36,22,16,6,44,6,7,18,149,154,54,100,488,326,11,40,1,12,678,1068,0,93,0,105,0,198,0,1263,3015
KARNATAKA,CHAMARAJNAGAR,2005,24,29,1,54,7,0,7,14,8,5,3,16,3,0,3,81,134,13,121,355,89,2,10,0,0,503,604,3,43,0,23,0,69,0,541,1504
KARNATAKA,CHICKMAGALUR,2005,35,25,0,60,16,0,16,32,9,4,5,18,5,1,12,154,193,36,157,558,135,9,18,0,8,809,981,7,33,3,69,0,112,2,1173,2716
KARNATAKA,CHITRADURGA,2005,21,14,3,38,15,0,15,30,6,5,1,12,2,2,12,118,230,47,183,594,230,8,32,1,6,723,1000,6,62,0,29,0,97,0,1972,3492
KARNATAKA,DAKSHIN KANNADA,2005,35,29,1,65,14,0,14,28,14,6,8,28,12,0,37,213,269,128,141,800,221,10,89,3,29,611,976,2,40,1,37,0,80,13,2612,4292
KARNATAKA,DAVANAGERE,2005,40,16,5,61,14,0,14,28,14,9,5,28,2,1,24,145,283,64,219,738,184,6,67,6,3,547,818,9,66,2,78,0,155,5,1352,2869
KARNATAKA,DHARWAD COMMR.,2005,15,13,0,28,0,0,0,0,7,4,3,14,1,0,22,133,274,143,131,704,73,24,66,2,3,195,365,3,2,2,14,0,21,2,967,1818
KARNATAKA,DHARWAD RURAL,2005,22,15,4,41,4,0,4,8,8,8,0,16,3,0,3,36,65,1,64,172,80,9,13,0,0,136,238,5,21,0,12,0,38,0,556,992
KARNATAKA,GADAG,2005,20,23,1,44,1,0,1,2,7,2,5,14,11,0,4,56,67,22,45,205,123,7,14,2,1,152,299,4,16,0,14,0,34,0,507,1030
KARNATAKA,GULBARGA,2005,115,111,0,226,16,0,16,32,33,17,16,66,7,2,27,191,290,96,194,807,472,7,76,5,57,1060,1698,12,119,0,112,0,243,21,2125,4858
KARNATAKA,HASSAN,2005,63,58,5,126,10,0,10,20,21,9,12,42,6,0,31,196,298,97,201,829,161,7,26,1,0,1128,1323,8,49,0,42,0,99,0,2010,4120
KARNATAKA,HAVERI,2005,25,8,2,35,4,0,4,8,6,6,0,12,2,0,3,67,117,29,88,306,233,9,14,0,0,255,511,4,27,0,22,0,53,0,1090,1888
KARNATAKA,K.G.F.,2005,8,24,4,36,5,0,5,10,8,5,3,16,1,0,4,50,100,14,86,255,52,4,13,0,0,240,309,7,18,0,20,0,45,0,283,841
KARNATAKA,KODAGU,2005,34,29,2,65,10,0,10,20,10,9,1,20,1,0,8,118,75,9,66,277,44,4,23,1,3,484,561,2,18,3,35,0,58,2,572,1478
KARNATAKA,KOLAR,2005,73,49,5,127,20,0,20,40,30,24,6,60,4,0,30,125,356,77,279,871,359,8,43,1,0,592,1003,19,41,0,41,0,101,0,1329,3125
KARNATAKA,KOPPAL,2005,29,22,11,62,8,0,8,16,8,8,0,16,11,0,7,79,83,28,55,263,136,8,25,0,0,230,399,4,24,1,40,0,69,0,863,1589
KARNATAKA,MANDYA,2005,43,56,1,100,17,0,17,34,12,11,1,24,3,1,13,179,261,90,171,718,197,5,25,1,0,800,1028,13,56,0,60,0,129,0,1637,3380
KARNATAKA,MYSORE COMMR.,2005,27,50,4,81,8,0,8,16,16,14,2,32,2,0,87,173,573,276,297,1408,43,7,67,0,0,359,476,6,17,0,82,0,105,0,1079,2600
KARNATAKA,MYSORE RURAL,2005,43,34,4,81,14,0,14,28,8,7,1,16,5,0,13,154,249,33,216,670,178,6,20,1,0,760,965,13,66,0,57,0,136,0,1024,2649
KARNATAKA,RAICHUR,2005,41,43,6,90,8,0,8,16,10,6,4,20,5,1,9,89,114,35,79,332,217,3,52,1,3,569,853,2,66,6,59,0,133,8,1297,2609
KARNATAKA,RAILWAYS,2005,17,1,1,19,0,0,0,0,1,0,1,2,1,0,6,5,475,4,471,962,9,0,1,3,0,17,30,2,1,0,1,0,4,0,65,606
KARNATAKA,SHIMOGA,2005,50,38,0,88,17,0,17,34,27,20,7,54,6,9,25,183,293,100,193,809,227,10,63,2,7,1071,1392,7,88,5,158,0,258,12,1871,4169
KARNATAKA,TUMKUR,2005,64,54,5,123,14,0,14,28,24,15,9,48,6,0,28,306,419,100,319,1178,226,5,35,0,8,888,1198,8,59,0,41,0,108,36,2128,4354
KARNATAKA,UDUPI,2005,26,18,1,45,7,0,7,14,9,2,7,18,6,0,15,134,90,29,61,335,146,11,13,1,4,263,446,2,27,1,14,0,44,8,1441,2237
KARNATAKA,UTTAR KANNADA,2005,22,24,1,47,3,0,3,6,7,1,6,14,3,0,11,70,75,20,55,234,71,7,23,1,18,362,482,2,42,1,40,0,85,0,1540,2323
KERALA,ALAPUZHA,2005,23,21,3,47,22,0,22,44,18,7,11,36,6,0,28,226,224,85,139,708,288,25,181,2,21,1204,1721,1,165,4,201,0,371,0,4959,7622
KERALA,CBCID,2005,10,3,0,13,1,0,1,2,0,0,0,0,3,0,1,10,1,0,1,16,11,11,18,59,24,1,124,0,0,0,5,0,5,0,6,164
KERALA,ERNAKULAM COMMR.,2005,15,12,11,38,7,0,7,14,6,1,5,12,10,0,40,214,447,155,292,1158,169,12,248,1,5,521,956,2,33,12,66,0,113,0,4099,5930
KERALA,ERNAKULAM RURAL,2005,25,19,8,52,15,0,15,30,14,5,9,28,2,18,30,250,349,132,217,998,332,23,137,0,13,1141,1648,2,134,2,105,0,243,2,6046,8667
KERALA,IDUKKI,2005,26,31,1,58,28,0,28,56,7,5,2,14,4,0,20,150,193,23,170,560,223,35,109,4,5,1236,1613,2,125,10,107,0,244,1,2183,4500
KERALA,KANNUR,2005,23,18,2,43,25,0,25,50,7,5,2,14,5,0,15,196,191,94,97,598,616,17,111,0,81,986,1815,0,121,17,215,0,353,4,2503,5153
KERALA,KASARGOD,2005,10,14,3,27,25,0,25,50,9,4,5,18,2,3,24,138,166,70,96,499,439,3,100,1,17,613,1173,0,72,6,133,0,211,0,1220,2998
KERALA,KOLLAM,2005,40,29,13,82,47,0,47,94,21,19,2,42,14,0,53,346,481,164,317,1375,544,13,161,3,35,2286,3044,2,320,4,367,0,693,2,5208,9989
KERALA,KOTTAYAM,2005,24,13,4,41,25,0,25,50,17,13,4,34,3,0,34,393,325,84,241,1080,361,30,389,2,10,1650,2445,1,167,16,149,0,333,3,4307,7923
KERALA,KOZHIKODE COMMR.,2005,11,16,4,31,13,0,13,26,12,7,5,24,5,13,30,183,323,191,132,877,238,16,175,2,21,420,873,2,50,2,130,0,184,1,1832,3499
KERALA,KOZHIKODE RURAL,2005,6,12,4,22,36,0,36,72,11,6,5,22,2,0,10,208,244,89,155,708,464,12,164,0,53,944,1638,2,120,14,209,0,345,1,2017,4533
KERALA,MALAPPURAM,2005,28,33,1,62,50,0,50,100,13,8,5,26,10,11,22,258,425,239,186,1151,629,21,273,1,36,883,1843,0,130,5,449,0,584,0,3582,6860
KERALA,PALAKKAD,2005,37,23,8,68,53,0,53,106,10,6,4,20,6,7,17,229,288,144,144,835,374,47,184,0,17,1030,1661,1,66,4,279,0,350,9,2807,5496
KERALA,PATHANAMTHITTA,2005,22,14,3,39,14,0,14,28,9,6,3,18,1,0,14,201,144,39,105,504,171,13,100,2,20,924,1230,1,139,2,119,0,261,0,2475,4388
KERALA,RAILWAYS,2005,0,0,0,0,0,0,0,0,0,0,0,0,0,1,6,3,157,1,156,324,4,0,4,0,0,19,27,0,5,1,0,0,6,0,22,222
KERALA,THRISSUR,2005,41,35,6,82,38,0,38,76,23,11,12,46,13,23,79,258,445,153,292,1263,563,33,379,0,45,902,1930,2,161,28,270,0,461,8,6287,9639
KERALA,TRIVANDRUM COMMR.,2005,8,15,5,28,10,0,10,20,21,9,12,42,16,62,91,284,484,118,366,1421,325,25,251,0,13,932,1546,0,160,20,92,0,272,0,2681,5495
KERALA,TRIVANDRUM RURAL,2005,30,29,12,71,36,0,36,72,22,15,7,44,7,20,95,423,446,162,284,1437,602,12,214,0,34,1981,2846,2,311,15,294,0,622,3,4520,9108
KERALA,WAYANADU,2005,9,4,0,13,33,0,33,66,6,2,4,12,1,0,12,140,121,26,95,395,182,13,63,2,6,629,895,1,60,13,93,0,167,0,776,2164
MADHYA PRADESH,ANUPPUR,2005,25,10,0,35,31,0,31,62,7,5,2,14,1,1,18,94,129,16,113,372,9,4,17,0,3,161,204,5,72,5,29,0,111,10,827,1458
MADHYA PRADESH,ASHOK NAGAR,2005,36,43,5,84,47,0,47,94,7,6,1,14,3,2,10,102,102,15,87,321,30,10,5,1,12,702,796,9,113,4,30,0,156,36,632,1941
MADHYA PRADESH,BALAGHAT,2005,65,36,1,102,58,0,58,116,10,6,4,20,2,1,7,140,194,22,172,538,48,5,16,0,24,479,647,4,155,17,34,0,210,75,1553,2924
MADHYA PRADESH,BARWANI,2005,43,18,4,65,41,0,41,82,5,5,0,10,0,2,7,121,212,52,160,554,33,5,5,0,7,289,443,2,92,17,14,0,125,104,1314,2335
MADHYA PRADESH,BETUL,2005,66,30,1,97,136,0,136,272,14,12,2,28,2,0,13,178,195,53,142,583,4,0,19,0,19,413,538,22,130,11,74,0,237,83,1595,3005
MADHYA PRADESH,BHIND,2005,97,121,0,218,29,0,29,58,21,9,12,42,14,6,56,192,242,91,151,752,117,13,20,1,14,816,1095,28,73,2,41,0,144,114,1912,3929
MADHYA PRADESH,BHOPAL,2005,72,71,0,143,79,0,79,158,31,24,7,62,5,1,108,740,1468,694,774,3790,62,17,107,4,19,508,917,13,177,51,125,0,366,200,6992,10850
MADHYA PRADESH,BHOPAL RLY.,2005,3,2,0,5,1,0,1,2,1,1,0,2,1,0,11,13,1175,15,1160,2375,6,4,12,4,2,17,47,3,11,3,1,0,18,2,272,1544
MADHYA PRADESH,BURHANPUR,2005,11,14,0,25,14,0,14,28,1,1,0,2,2,3,10,55,132,38,94,334,17,10,0,0,4,135,208,3,51,14,30,0,98,42,901,1449
MADHYA PRADESH,CHHATARPUR,2005,62,72,6,140,46,0,46,92,12,10,2,24,3,4,31,212,152,0,152,554,58,6,9,1,22,597,797,18,162,8,40,0,228,104,2026,3651
MADHYA PRADESH,CHHINDWARA,2005,74,29,3,106,122,0,122,244,19,18,1,38,2,1,14,190,262,70,192,731,52,4,19,0,15,1205,1419,15,165,24,122,0,326,124,1502,3963
MADHYA PRADESH,DAMOH,2005,40,68,0,108,43,0,43,86,12,6,6,24,0,7,18,116,139,34,105,419,12,4,4,0,4,1011,1082,31,113,0,53,0,197,47,553,2275
MADHYA PRADESH,DATIYA,2005,37,61,0,98,30,0,30,60,20,7,13,40,2,5,30,96,134,26,108,401,29,2,17,0,7,472,581,7,66,0,26,0,99,54,1084,2179
MADHYA PRADESH,DEWAS,2005,57,76,1,134,86,0,86,172,32,21,11,64,5,3,32,279,720,178,542,1759,107,28,57,0,37,418,805,20,186,52,173,0,431,158,3548,6075
MADHYA PRADESH,DHAR,2005,86,82,1,169,134,0,134,268,40,36,4,80,9,5,45,278,600,167,433,1537,100,27,21,0,37,722,1110,41,180,9,63,0,293,203,2544,5227
MADHYA PRADESH,DINDORI,2005,18,9,1,28,32,0,32,64,1,1,0,2,0,0,1,38,18,6,12,75,6,1,7,0,4,23,71,2,57,0,11,0,70,30,466,725
MADHYA PRADESH,GUNA,2005,40,34,3,77,77,0,77,154,5,5,0,10,4,6,34,174,269,50,219,756,88,7,22,0,13,1115,1347,3,176,18,61,0,258,102,1170,3421
MADHYA PRADESH,GWALIOR,2005,99,133,22,254,61,0,61,122,44,32,12,88,6,10,141,926,1378,718,660,3839,138,33,104,3,13,1023,1540,21,164,11,130,0,326,226,4079,8765
MADHYA PRADESH,HARDA,2005,20,13,0,33,32,0,32,64,7,6,1,14,0,1,10,60,93,43,50,257,8,0,8,0,5,373,394,7,41,0,9,0,57,0,411,1098
MADHYA PRADESH,HOSHANGABAD,2005,41,65,10,116,64,0,64,128,16,9,7,32,1,10,37,229,375,99,276,1027,60,4,17,3,10,449,543,10,124,16,58,0,208,0,1947,3546
MADHYA PRADESH,INDORE,2005,104,137,7,248,102,0,102,204,59,42,17,118,5,3,97,966,2680,1513,1167,6431,122,85,132,5,32,1269,2014,29,221,73,283,0,606,369,9246,16026
MADHYA PRADESH,INDORE RLY.,2005,1,1,0,2,3,0,3,6,0,0,0,0,0,0,5,3,132,1,131,272,0,0,3,0,0,10,13,0,6,0,1,0,7,0,155,320
MADHYA PRADESH,JABALPUR,2005,77,131,0,208,92,0,92,184,36,23,13,72,1,1,73,404,832,417,415,2143,82,33,110,8,4,4424,4884,34,310,133,154,0,631,223,2301,9463
MADHYA PRADESH,JABALPUR RLY.,2005,3,0,2,5,0,0,0,0,0,0,0,0,0,1,18,8,366,1,365,759,1,1,1,0,1,7,11,2,10,1,0,0,13,0,152,574
MADHYA PRADESH,JHABUA,2005,129,68,1,198,37,0,37,74,48,43,5,96,2,2,12,82,167,46,121,432,30,4,7,0,42,386,469,1,62,2,8,0,73,0,1415,2505
MADHYA PRADESH,KATNI,2005,33,25,0,58,46,0,46,92,3,3,0,6,4,1,16,150,201,88,113,573,25,11,20,2,9,954,1141,30,104,10,50,0,194,120,720,2534
MADHYA PRADESH,KHANDWA,2005,38,53,0,91,56,0,56,112,36,34,2,72,12,6,19,386,443,105,338,1309,60,11,23,0,14,36,225,8,197,22,59,0,286,81,2820,4380
MADHYA PRADESH,KHARGON,2005,40,42,1,83,61,0,61,122,9,8,1,18,8,6,18,232,556,65,491,1376,72,31,23,0,11,428,673,21,151,21,32,1,226,108,2100,3972
MADHYA PRADESH,MANDLA,2005,44,15,0,59,61,0,61,122,8,7,1,16,1,0,8,69,63,10,53,204,6,2,9,0,4,333,399,4,75,3,18,0,100,45,694,1462
MADHYA PRADESH,MANDSAUR,2005,38,27,1,66,31,0,31,62,18,10,8,36,1,4,35,178,378,99,279,974,38,14,23,5,32,352,519,7,129,14,79,0,229,55,1587,3046
MADHYA PRADESH,MORENA,2005,62,105,3,170,32,0,32,64,30,20,10,60,9,2,70,214,464,165,299,1223,181,2,38,0,14,1376,1746,27,89,3,74,0,193,135,2092,5022
MADHYA PRADESH,NARSINGHPUR,2005,34,50,6,90,65,0,65,130,2,1,1,4,0,2,17,76,128,45,83,351,21,7,8,0,15,1166,1302,21,156,10,52,0,239,85,692,2613
MADHYA PRADESH,NEEMUCH,2005,13,18,2,33,27,0,27,54,9,3,6,18,0,2,16,148,314,91,223,794,26,35,21,1,8,372,521,1,68,7,41,0,117,58,673,1860
MADHYA PRADESH,PANNA,2005,32,28,0,60,33,0,33,66,12,4,8,24,1,2,13,117,88,24,64,309,16,7,6,0,11,94,173,14,85,0,13,1,113,39,875,1487
MADHYA PRADESH,RAISEN,2005,46,55,0,101,97,0,97,194,14,14,0,28,1,2,20,136,205,52,153,569,70,2,12,0,11,340,527,8,154,15,57,0,234,92,2031,3368
MADHYA PRADESH,RAJGARH,2005,26,47,0,73,75,0,75,150,19,15,4,38,3,0,22,154,406,86,320,991,140,15,11,0,54,406,715,4,158,31,92,0,285,89,2741,4493
MADHYA PRADESH,RATLAM,2005,47,37,3,87,74,0,74,148,13,10,3,26,1,3,27,148,443,109,334,1065,29,33,31,1,14,268,481,10,127,30,56,0,223,105,2297,3797
MADHYA PRADESH,REWA,2005,53,46,1,100,64,0,64,128,26,15,11,52,4,2,42,464,397,128,269,1306,74,8,41,5,30,903,1187,42,107,2,39,0,190,126,1480,3956
MADHYA PRADESH,SAGAR,2005,76,105,0,181,110,0,110,220,31,21,10,62,2,6,49,445,491,94,397,1484,86,14,23,0,29,2486,2779,34,362,24,127,0,547,141,2694,7335
MADHYA PRADESH,SATNA,2005,78,53,3,134,75,0,75,150,18,3,15,36,3,3,44,396,413,156,257,1272,43,10,28,0,27,970,1280,34,195,9,66,0,304,202,2571,5241
MADHYA PRADESH,SEONI,2005,23,14,4,41,57,0,57,114,10,8,2,20,0,0,10,107,111,28,83,339,24,1,6,0,8,372,507,22,142,11,37,0,212,96,1399,2454
MADHYA PRADESH,SHAHDOL,2005,44,17,3,64,43,0,43,86,6,5,1,12,0,0,21,240,216,42,174,693,21,2,32,0,20,262,337,13,156,9,57,0,235,0,1390,2552
MADHYA PRADESH,SHAJAPUR,2005,31,45,1,77,73,0,73,146,15,10,5,30,3,3,58,221,542,91,451,1369,73,35,11,0,26,1177,1418,6,173,22,64,0,265,96,895,3570
MADHYA PRADESH,SHEOPUR,2005,13,17,0,30,21,0,21,42,4,1,3,8,2,0,6,53,86,16,70,233,27,0,12,0,2,280,349,1,42,0,24,0,67,28,549,1167
MADHYA PRADESH,SHIVPURI,2005,73,86,0,159,58,0,58,116,22,19,3,44,3,6,30,142,310,73,237,801,52,12,25,0,25,405,604,2,99,0,30,0,131,85,2248,3713
MADHYA PRADESH,SIDHI,2005,50,9,7,66,47,0,47,94,22,21,1,44,4,1,12,327,251,47,204,846,29,8,20,0,13,694,883,23,132,4,42,0,201,119,1847,3661
MADHYA PRADESH,SIHORE,2005,42,54,1,97,73,0,73,146,11,10,1,22,6,0,13,143,403,76,327,968,39,6,13,1,10,297,492,14,76,14,45,0,149,126,1570,2957
MADHYA PRADESH,TIKAMGARH,2005,47,43,1,91,40,0,40,80,15,6,9,30,1,1,23,189,187,30,157,588,45,3,13,0,18,989,1135,18,106,5,28,0,157,67,922,2761
MADHYA PRADESH,UJJAIN,2005,55,134,0,189,74,0,74,148,28,14,14,56,7,2,91,447,1058,226,832,2663,72,25,69,6,29,792,1118,17,172,41,173,1,404,125,3953,7371
MADHYA PRADESH,UMARIYA,2005,18,14,27,59,34,0,34,68,3,0,3,6,1,1,8,95,84,10,74,273,11,0,18,0,8,194,239,1,55,5,19,0,80,8,604,1208
MADHYA PRADESH,VIDISHA,2005,43,49,2,94,97,0,97,194,15,14,1,30,0,0,31,219,281,69,212,812,74,12,17,0,25,833,1017,27,199,9,45,0,280,56,1910,3944
MAHARASHTRA,AHMEDNAGAR,2005,92,56,1,149,56,0,56,112,33,25,8,66,29,16,84,392,1025,279,746,2571,206,36,142,3,26,768,1655,0,91,0,338,0,429,474,1373,5241
MAHARASHTRA,AKOLA,2005,46,40,2,88,21,0,21,42,24,22,2,48,10,0,56,285,1225,140,1085,2801,136,25,97,5,27,828,1206,3,82,14,184,0,283,88,1396,4594
MAHARASHTRA,AMRAVATI COMMR.,2005,30,25,2,57,23,0,23,46,11,8,3,22,0,3,15,169,782,105,677,1751,83,12,63,1,14,396,626,2,31,20,57,0,110,57,777,2573
MAHARASHTRA,AMRAVATI RURAL,2005,78,23,2,103,60,0,60,120,18,16,2,36,11,4,21,241,927,47,880,2131,93,19,39,0,35,760,1086,10,122,34,132,0,298,140,886,3655
MAHARASHTRA,AURANGABAD COMMR.,2005,22,27,0,49,26,0,26,52,12,10,2,24,10,4,55,183,649,214,435,1550,123,8,107,3,10,320,707,2,31,8,93,0,134,136,647,2476
MAHARASHTRA,AURANGABAD RURAL,2005,46,17,1,64,9,0,9,18,6,4,2,12,12,7,30,124,337,59,278,847,195,17,37,1,34,738,1224,26,44,10,263,0,343,202,559,2715
MAHARASHTRA,BEED,2005,62,52,1,115,25,0,25,50,26,18,8,52,21,3,67,305,783,115,668,1962,417,22,52,2,55,1085,1831,7,99,15,275,0,396,198,752,4324
MAHARASHTRA,BHANDARA,2005,27,11,3,41,15,0,15,30,17,14,3,34,1,0,12,175,475,37,438,1138,52,15,39,6,43,340,608,3,64,34,67,0,168,113,886,2398
MAHARASHTRA,BULDHANA,2005,51,62,0,113,42,0,42,84,23,16,7,46,8,2,33,181,863,86,777,1950,163,29,182,5,72,716,1303,53,110,40,187,0,390,136,1282,4240
MAHARASHTRA,CHANDRAPUR,2005,61,18,0,79,41,0,41,82,17,14,3,34,9,1,29,323,704,91,613,1770,116,23,51,7,38,578,1001,2,93,27,110,0,232,188,1010,3446
MAHARASHTRA,DHULE,2005,47,30,0,77,15,0,15,30,9,9,0,18,5,1,15,110,317,79,238,765,108,21,42,0,8,380,763,10,27,7,110,0,154,204,792,2258
MAHARASHTRA,GADCHIROLI,2005,60,45,3,108,22,0,22,44,5,3,2,10,14,3,24,97,140,6,134,418,36,15,4,3,48,279,453,1,62,4,42,0,109,68,291,1266
MAHARASHTRA,GONDIA,2005,29,21,0,50,22,0,22,44,18,17,1,36,4,1,16,209,376,39,337,982,41,8,23,4,23,378,579,1,106,19,59,0,185,102,648,2108
MAHARASHTRA,HINGOLI,2005,34,11,1,46,15,0,15,30,15,12,3,30,9,2,41,119,243,26,217,657,153,9,13,0,38,595,861,2,45,8,106,0,161,53,396,1908
MAHARASHTRA,JALGAON,2005,74,55,2,131,52,0,52,104,26,26,0,52,8,2,37,217,733,130,603,1730,200,85,311,8,12,698,1609,4,92,30,301,0,427,295,1321,4563
MAHARASHTRA,JALNA,2005,37,40,2,79,20,0,20,40,13,8,5,26,19,2,58,153,391,82,309,1014,176,11,63,3,42,533,944,21,53,5,215,0,294,116,907,2880
MAHARASHTRA,KOLHAPUR,2005,65,62,2,129,26,0,26,52,25,15,10,50,7,1,27,258,690,250,440,1673,167,98,184,3,10,552,1295,22,47,12,76,0,157,281,808,3423
MAHARASHTRA,LATUR,2005,49,40,1,90,24,0,24,48,22,20,2,44,11,6,36,220,401,76,325,1075,175,18,55,2,35,962,1399,40,61,3,107,0,211,152,959,3379
MAHARASHTRA,MUMBAI,2005,212,136,8,356,201,0,201,402,198,122,76,396,47,57,362,3175,11903,3494,8409,27447,261,536,1664,169,10,3731,7029,9,385,99,336,0,829,658,7275,31432
MAHARASHTRA,MUMBAI RLY.,2005,5,1,0,6,2,0,2,4,7,5,2,14,0,1,29,5,1574,1,1573,3183,16,6,39,3,0,36,101,0,12,4,0,0,16,1,77,1818
MAHARASHTRA,NAGPUR COMMR.,2005,106,68,3,177,52,0,52,104,57,48,9,114,16,32,184,1236,2733,939,1794,6934,246,59,272,15,26,973,1840,4,76,52,185,0,317,249,2961,9605
MAHARASHTRA,NAGPUR RLY.,2005,9,2,1,12,1,0,1,2,3,3,0,6,9,0,16,3,903,15,888,1834,4,1,9,7,0,26,50,0,7,2,0,0,9,3,104,1110
MAHARASHTRA,NAGPUR RURAL,2005,67,28,7,102,51,0,51,102,19,16,3,38,14,5,60,283,1167,93,1074,2696,168,18,47,0,48,677,1306,8,113,36,86,0,243,348,1565,4815
MAHARASHTRA,NANDED,2005,70,112,3,185,41,0,41,82,42,29,13,84,31,9,85,325,624,119,505,1698,285,25,112,3,52,1359,1958,17,85,10,239,0,351,122,1769,5420
MAHARASHTRA,NANDURBAR,2005,27,22,0,49,19,0,19,38,3,2,1,6,5,0,6,56,168,21,147,403,65,14,43,2,2,234,448,3,21,8,73,0,105,88,309,1168
MAHARASHTRA,NASIK COMMR.,2005,28,17,2,47,21,0,21,42,16,13,3,32,4,6,19,387,836,365,471,2088,97,15,168,9,5,231,685,0,35,13,121,0,169,160,586,2776
MAHARASHTRA,NASIK RURAL,2005,105,31,1,137,50,0,50,100,25,16,9,50,16,3,42,317,551,140,411,1480,293,62,111,10,17,771,1720,8,102,30,375,0,515,456,1137,4513
MAHARASHTRA,NAVI MUMBAI,2005,51,21,2,74,19,0,19,38,15,7,8,30,21,21,71,395,1121,534,587,2750,110,42,187,7,8,425,1138,9,42,11,63,0,125,359,843,3843
MAHARASHTRA,OSMANABAD,2005,41,19,0,60,22,0,22,44,7,4,3,14,15,0,23,207,434,42,392,1113,111,7,58,0,23,649,1047,1,42,8,118,0,169,199,1043,3027
MAHARASHTRA,PARBHANI,2005,39,33,2,74,14,0,14,28,13,8,5,26,15,4,31,159,344,74,270,897,167,8,74,2,30,852,1222,10,40,3,131,0,184,89,323,2383
MAHARASHTRA,PUNE COMMR.,2005,106,85,7,198,79,0,79,158,102,72,30,204,27,18,190,1201,4322,2165,2157,10080,474,72,609,22,16,1258,2858,1,107,95,201,0,404,407,2418,11817
MAHARASHTRA,PUNE RLY.,2005,1,1,0,2,0,0,0,0,0,0,0,0,2,1,5,0,159,2,157,326,3,2,1,0,0,2,8,0,2,1,0,0,3,0,28,208
MAHARASHTRA,PUNE RURAL,2005,123,43,2,168,46,0,46,92,33,16,17,66,39,22,75,382,983,322,661,2484,181,69,141,5,32,595,1782,6,57,14,172,0,249,759,1564,5343
MAHARASHTRA,RAIGAD,2005,41,22,0,63,25,0,25,50,8,6,2,16,29,1,20,164,391,55,336,996,140,26,50,7,5,324,826,4,47,7,63,0,121,274,674,2322
MAHARASHTRA,RATNAGIRI,2005,21,3,0,24,27,0,27,54,7,3,4,14,4,1,15,167,274,28,246,735,79,21,52,6,19,191,478,2,40,29,40,0,111,110,350,1458
MAHARASHTRA,SANGLI,2005,77,12,1,90,34,0,34,68,32,12,20,64,9,2,41,245,721,198,523,1739,128,25,169,6,23,423,1036,7,55,7,105,0,174,262,684,3068
MAHARASHTRA,SATARA,2005,59,32,7,98,31,0,31,62,26,18,8,52,17,2,43,339,753,168,585,1907,144,31,96,7,30,455,1091,6,61,2,180,0,249,328,1128,3777
MAHARASHTRA,SINDHUDURG,2005,15,8,2,25,4,0,4,8,4,2,2,8,7,0,4,119,110,15,95,350,45,9,12,1,14,142,285,0,20,12,4,0,36,62,259,853
MAHARASHTRA,SOLAPUR COMMR.,2005,24,15,0,39,20,0,20,40,10,4,6,20,11,2,38,214,344,150,194,953,89,11,102,3,4,186,480,1,17,11,47,0,76,85,410,1644
MAHARASHTRA,SOLAPUR RURAL,2005,97,38,8,143,40,0,40,80,26,16,10,52,20,5,52,199,465,132,333,1206,193,26,31,6,20,623,1248,6,54,9,127,0,196,349,969,3363
MAHARASHTRA,THANE COMMR.,2005,106,52,3,161,60,0,60,120,85,52,33,170,29,36,146,1127,2042,844,1198,5422,288,84,564,22,17,1815,3073,1,110,39,246,0,396,283,509,7664
MAHARASHTRA,THANE RURAL,2005,140,51,2,193,66,0,66,132,47,37,10,94,45,8,86,452,648,219,429,1887,226,38,137,10,23,710,1709,5,132,33,133,0,303,565,1043,4600
MAHARASHTRA,WARDHA,2005,45,30,4,79,35,0,35,70,31,31,0,62,4,6,31,254,535,49,486,1365,71,14,56,5,56,914,1242,4,110,45,94,0,253,126,1548,4018
MAHARASHTRA,WASHIM,2005,24,24,1,49,12,0,12,24,15,12,3,30,7,0,17,115,432,24,408,1003,102,6,17,1,25,451,676,10,63,7,139,0,219,74,554,2096
MAHARASHTRA,YAVATMAL,2005,72,73,9,154,59,0,59,118,43,40,3,86,10,7,64,328,1253,120,1133,2915,153,22,66,1,48,1058,1537,10,133,42,233,0,418,189,1566,5439
MANIPUR,BISHNUPUR,2005,30,38,0,68,3,0,3,6,7,5,2,14,0,0,0,5,19,0,19,43,6,0,8,0,4,38,56,0,3,0,1,0,4,0,178,340
MANIPUR,CHANDEL,2005,20,10,0,30,0,0,0,0,1,0,1,2,4,0,2,2,3,0,3,14,0,2,3,0,11,5,21,0,2,0,0,0,2,0,24,89
MANIPUR,CHURACHANDPUR,2005,49,25,1,75,0,0,0,0,4,1,3,8,0,0,0,4,11,1,10,26,1,3,3,1,1,4,13,0,2,0,0,0,2,0,66,175
MANIPUR,IMPHAL(EAST),2005,38,50,0,88,4,0,4,8,28,21,7,56,0,0,1,6,31,6,25,69,5,2,50,1,20,62,140,0,3,0,1,0,4,0,221,523
MANIPUR,IMPHAL(WEST),2005,49,68,1,118,10,0,10,20,41,28,13,82,0,0,4,38,138,82,56,318,12,18,40,8,58,107,246,0,12,0,3,0,15,3,448,1058
MANIPUR,SENAPATI,2005,10,12,0,22,0,0,0,0,3,0,3,6,0,0,1,1,7,0,7,16,0,1,3,0,19,3,27,0,0,0,0,0,0,1,59,120
MANIPUR,TAMENGLONG,2005,7,2,0,9,1,0,1,2,1,0,1,2,0,0,0,0,4,0,4,8,2,0,1,0,8,3,14,0,0,0,0,0,0,0,18,47
MANIPUR,THOUBAL,2005,46,38,1,85,7,0,7,14,20,14,6,40,0,0,0,5,27,3,24,59,9,12,9,0,9,73,113,0,3,0,15,0,18,1,207,482
MANIPUR,UKHRUL,2005,7,9,1,17,0,0,0,0,1,0,1,2,0,0,0,1,3,0,3,7,0,14,5,0,25,0,44,0,0,0,0,0,0,0,13,79
MEGHALAYA,GARO HILLS EAST,2005,10,6,1,17,4,0,4,8,7,0,7,14,11,1,7,11,33,0,33,96,9,2,6,0,7,15,39,0,0,0,0,0,0,0,28,158
MEGHALAYA,GARO HILLS SOUTH,2005,5,2,0,7,0,0,0,0,2,0,2,4,3,0,2,1,17,0,17,40,0,0,0,1,1,2,4,0,2,0,0,0,2,0,11,49
MEGHALAYA,GARO HILLS WEST,2005,11,4,0,15,3,0,3,6,11,5,6,22,14,0,5,18,47,4,43,131,26,0,5,0,14,40,102,0,9,0,2,0,11,17,41,267
MEGHALAYA,JAINTIA HILLS,2005,43,3,0,46,10,0,10,20,7,3,4,14,11,0,8,15,62,19,43,158,0,4,3,0,9,24,53,0,10,0,0,0,10,13,64,286
MEGHALAYA,KHASI HILLS EAST,2005,40,12,0,52,25,0,25,50,19,10,9,38,12,0,55,89,225,88,137,606,7,11,24,2,30,22,118,1,10,0,1,0,12,22,155,762
MEGHALAYA,KHASI HILLS WEST,2005,8,7,0,15,12,0,12,24,0,0,0,0,21,0,7,12,34,0,34,108,0,0,1,0,0,5,6,0,7,0,0,0,7,0,61,175
MEGHALAYA,RI-BHOI,2005,17,1,1,19,9,0,9,18,2,1,1,4,9,0,11,2,58,5,53,138,0,1,0,0,9,27,46,0,6,0,0,0,6,9,21,183
MIZORAM,AIZAWL,2005,4,4,2,10,10,0,10,20,5,0,5,10,2,0,2,90,230,0,230,554,9,4,18,2,7,11,53,0,10,2,0,0,12,2,120,534
MIZORAM,CHAMPHAI,2005,4,3,1,8,5,0,5,10,1,0,1,2,0,0,0,70,60,0,60,190,3,1,3,2,1,12,22,0,7,0,0,0,7,0,60,233
MIZORAM,KOLASIB,2005,2,1,0,3,2,0,2,4,0,0,0,0,0,0,0,30,70,0,70,170,0,0,2,0,1,4,7,0,0,0,0,0,0,0,40,152
MIZORAM,LAWNGTLAI,2005,3,3,0,6,2,0,2,4,2,0,2,4,0,0,1,60,70,0,70,201,5,1,10,0,2,11,29,2,6,1,0,0,9,0,70,249
MIZORAM,LUNGLEI,2005,4,4,1,9,6,0,6,12,2,0,2,4,1,0,2,80,200,0,200,483,5,2,10,1,6,14,40,0,8,0,0,0,8,2,120,468
MIZORAM,MAMIT,2005,4,2,1,7,6,0,6,12,2,0,2,4,0,0,0,22,15,0,15,52,1,0,5,0,0,5,11,0,3,0,0,0,3,0,38,104
MIZORAM,SAIHA,2005,2,3,0,5,2,0,2,4,1,0,1,2,0,0,1,60,107,0,107,275,10,2,8,0,2,10,32,2,9,1,0,0,12,0,50,270
MIZORAM,SERCHHIP,2005,1,4,0,5,4,0,4,8,0,0,0,0,0,0,0,30,25,0,25,80,2,1,2,0,1,10,16,0,6,0,0,0,6,0,60,146
NAGALAND,DIMAPUR,2005,23,4,1,28,7,0,7,14,5,0,5,10,5,0,55,35,117,73,44,329,0,5,12,2,0,7,56,0,0,0,0,0,0,30,42,350
NAGALAND,KIPHIRE,2005,0,0,1,1,0,0,0,0,0,0,0,0,0,0,0,2,2,0,2,6,0,0,0,0,0,0,0,0,0,0,0,0,0,0,14,19
NAGALAND,KOHIMA,2005,19,7,0,26,5,0,5,10,12,5,7,24,5,0,12,17,61,13,48,156,0,5,21,2,0,5,33,0,0,0,0,0,0,0,83,254
NAGALAND,MOKOKCHUNG,2005,3,2,1,6,0,0,0,0,0,0,0,0,0,0,1,10,9,3,6,29,0,1,1,0,1,6,12,0,1,0,0,0,1,3,8,47
NAGALAND,MON,2005,15,3,0,18,1,0,1,2,1,0,1,2,0,0,5,3,25,2,23,58,1,3,1,0,0,7,15,0,1,0,0,0,1,3,15,84
NAGALAND,PEREN,2005,5,3,0,8,1,0,1,2,0,0,0,0,0,0,0,4,8,0,8,20,0,0,0,0,0,0,1,0,4,0,0,0,4,1,4,30
NAGALAND,PHEK,2005,2,1,1,4,1,0,1,2,2,1,1,4,2,0,4,5,9,1,8,29,0,1,2,0,1,6,10,0,1,0,0,0,1,0,14,52
NAGALAND,TUENSANG,2005,9,0,3,12,1,0,1,2,2,0,2,4,0,0,0,8,5,0,5,18,6,1,3,1,2,0,13,0,0,0,0,0,0,0,36,77
NAGALAND,WOKHA,2005,10,4,1,15,0,0,0,0,4,3,1,8,0,0,2,1,40,1,39,83,1,1,0,0,0,4,6,0,0,0,0,0,0,0,18,86
NAGALAND,ZUNHEBOTO,2005,1,2,0,3,1,0,1,2,0,0,0,0,0,0,1,8,18,4,14,45,0,0,1,0,0,0,1,0,0,0,0,0,0,0,18,50
ODISHA,ANGUL,2005,41,46,1,88,28,0,28,56,15,15,0,30,14,2,38,94,302,32,270,752,112,14,39,0,12,60,585,5,135,0,61,0,201,348,680,2047
ODISHA,BALASORE,2005,27,18,3,48,43,0,43,86,41,35,6,82,6,1,31,151,251,28,223,691,55,20,38,4,21,268,406,32,132,17,122,0,303,0,1303,2584
ODISHA,BARAGARH,2005,33,54,0,87,21,0,21,42,12,12,0,24,5,0,21,80,218,32,186,542,70,13,45,1,26,19,256,9,112,3,256,0,380,82,575,1655
ODISHA,BERHAMPUR,2005,17,58,2,77,6,0,6,12,7,3,4,14,6,3,73,95,212,92,120,601,40,9,46,0,10,70,235,1,111,6,24,0,142,60,648,1504
ODISHA,BHADRAK,2005,17,32,0,49,37,0,37,74,18,18,0,36,1,2,16,61,101,13,88,282,34,6,34,2,16,14,167,9,90,25,116,0,240,61,1028,1720
ODISHA,BOLANGIR,2005,39,80,3,122,37,0,37,74,40,32,8,80,0,3,35,72,171,41,130,452,66,5,27,3,13,24,186,11,126,10,22,0,169,48,786,1621
ODISHA,BOUDH,2005,16,4,0,20,7,0,7,14,2,2,0,4,0,0,4,18,31,0,31,84,13,1,2,0,7,136,159,3,35,2,6,0,46,0,122,409
ODISHA,CUTTACK,2005,34,119,0,153,29,0,29,58,71,64,7,142,13,6,135,317,777,279,498,2025,82,25,96,0,11,333,700,39,24,6,162,0,231,153,1765,4197
ODISHA,DEOGARH,2005,15,15,1,31,16,0,16,32,8,5,3,16,5,1,20,25,37,1,36,125,20,4,4,0,5,208,272,1,60,3,12,0,76,31,90,581
ODISHA,DHENKANAL,2005,36,56,0,92,8,0,8,16,12,9,3,24,8,0,20,66,134,31,103,362,97,13,36,0,10,95,319,20,139,9,34,0,202,68,685,1546
ODISHA,GAJAPATI,2005,22,7,3,32,9,0,9,18,6,6,0,12,1,0,2,40,39,9,30,121,22,3,8,1,3,44,110,1,35,2,3,0,41,29,140,420
ODISHA,GANJAM,2005,56,66,6,128,26,0,26,52,25,12,13,50,8,1,41,131,145,18,127,471,63,8,13,1,24,269,452,28,179,10,92,0,309,74,682,1948
ODISHA,JAGATSINGHPUR,2005,26,35,5,66,14,0,14,28,11,10,1,22,2,4,27,74,114,12,102,335,24,8,25,0,7,123,366,11,7,6,35,0,59,179,481,1218
ODISHA,JAJPUR,2005,22,28,0,50,20,0,20,40,39,39,0,78,5,1,44,75,146,17,129,417,40,16,20,0,18,297,486,25,37,3,59,0,124,95,796,1786
ODISHA,JHARSUGUDA,2005,12,14,0,26,19,0,19,38,6,5,1,12,4,1,17,71,155,38,117,403,45,2,15,1,17,539,693,1,52,3,22,0,78,74,124,1194
ODISHA,KALAHANDI,2005,24,29,3,56,30,0,30,60,11,10,1,22,5,0,29,55,82,7,75,253,94,2,49,0,9,180,387,5,40,1,32,0,78,53,331,1064
ODISHA,KANDHAMAL,2005,28,11,0,39,20,0,20,40,20,20,0,40,3,0,10,41,70,6,64,194,22,5,13,0,6,477,523,8,111,2,45,0,166,0,55,947
ODISHA,KENDRAPARA,2005,29,42,1,72,23,0,23,46,20,17,3,40,3,2,27,63,107,9,98,309,12,8,15,0,17,45,122,19,13,0,5,0,37,25,683,1159
ODISHA,KEONJHAR,2005,72,64,1,137,36,0,36,72,21,21,0,42,6,1,39,96,241,38,203,624,62,28,31,0,21,101,598,12,89,15,20,0,136,355,957,2268
ODISHA,KHURDA,2005,43,71,3,117,57,0,57,114,65,56,9,130,14,6,130,491,1220,614,606,3081,79,45,247,8,29,1092,1665,17,42,9,46,0,114,165,1553,5432
ODISHA,KORAPUT,2005,46,19,2,67,45,0,45,90,27,25,2,54,9,0,15,102,158,24,134,442,66,4,30,0,14,39,229,2,116,6,64,0,188,76,711,1551
ODISHA,MALKANGIR,2005,41,31,4,76,7,0,7,14,7,6,1,14,8,0,3,21,40,3,37,112,30,2,7,0,4,60,121,3,23,2,6,0,34,18,178,495
ODISHA,MAYURBHANJ,2005,70,38,4,112,102,0,102,204,40,37,3,80,4,0,28,95,226,26,200,579,27,15,30,0,14,24,226,19,136,0,180,0,335,116,1091,2259
ODISHA,NAYAGARH,2005,28,7,0,35,17,0,17,34,25,20,5,50,6,1,13,73,109,14,95,311,33,8,30,0,16,317,435,4,10,3,14,0,31,31,246,991
ODISHA,NOWRANGPUR,2005,29,13,0,42,18,0,18,36,8,8,0,16,4,0,9,49,58,7,51,178,56,2,2,1,4,76,174,2,49,1,8,0,60,33,334,756
ODISHA,NUAPADA,2005,11,2,1,14,6,0,6,12,7,5,2,14,7,0,10,22,82,8,74,203,23,0,15,3,9,52,122,2,38,3,14,0,57,20,424,751
ODISHA,PURI,2005,54,134,0,188,31,0,31,62,24,18,6,48,5,2,49,168,296,69,227,816,42,6,27,0,11,21,412,30,24,8,90,0,152,305,1150,2477
ODISHA,RAYAGADA,2005,27,20,0,47,17,0,17,34,3,0,3,6,9,0,14,32,84,5,79,223,50,6,12,0,8,4,163,2,44,5,37,0,88,83,508,965
ODISHA,ROURKELA,2005,23,19,1,43,17,0,17,34,12,10,2,24,0,3,18,96,252,46,206,621,13,4,36,0,3,34,143,8,51,7,26,0,92,53,675,1351
ODISHA,SAMBALPUR,2005,44,84,0,128,15,0,15,30,25,17,8,50,11,6,44,145,294,43,251,794,55,10,17,3,11,121,350,3,76,10,22,0,111,133,917,2046
ODISHA,SONEPUR,2005,10,14,0,24,4,0,4,8,1,1,0,2,0,0,2,21,30,0,30,83,29,2,6,0,7,19,88,0,43,0,6,0,49,25,128,347
ODISHA,SRP(CUTTACK),2005,2,3,0,5,1,0,1,2,1,1,0,2,1,1,9,6,283,32,251,583,1,0,2,0,1,14,20,0,4,0,2,0,6,2,93,426
ODISHA,SRP(ROURKELA),2005,3,1,0,4,1,0,1,2,3,3,0,6,0,1,3,10,99,8,91,212,3,2,1,0,0,4,13,0,6,0,1,0,7,3,74,215
ODISHA,SUNDARGARH,2005,82,45,4,131,32,0,32,64,8,5,3,16,11,2,22,73,179,24,155,466,35,5,22,3,2,740,1043,2,49,7,27,0,85,236,169,1755
PUNJAB,AMRITSAR,2005,47,28,4,79,5,0,5,10,20,14,6,40,0,7,4,52,121,55,66,305,0,15,199,5,0,114,412,2,6,0,44,0,52,79,372,1124
PUNJAB,BARNALA,2005,11,12,2,25,11,0,11,22,2,1,1,4,0,1,1,31,29,10,19,91,1,8,86,0,1,73,213,3,11,0,12,0,26,44,134,473
PUNJAB,BATALA,2005,22,30,1,53,24,0,24,48,18,11,7,36,0,5,1,42,83,20,63,214,0,11,127,1,0,136,333,7,7,0,34,0,48,58,478,1085
PUNJAB,BHATINDA,2005,45,52,73,170,30,0,30,60,37,21,16,74,0,2,4,193,191,88,103,581,0,32,150,2,5,214,408,2,23,1,45,0,71,5,441,1547
PUNJAB,FARIDKOT,2005,17,36,1,54,6,0,6,12,10,2,8,20,2,2,0,56,59,26,33,178,0,2,71,0,0,125,198,1,10,0,9,0,20,0,172,579
PUNJAB,FATEHGARH SAHIB,2005,17,5,1,23,6,0,6,12,6,5,1,12,0,5,4,34,49,30,19,141,0,17,82,2,0,88,298,4,1,1,13,0,19,109,183,627
PUNJAB,FEROZPUR,2005,43,38,7,88,24,0,24,48,14,10,4,28,2,3,0,112,153,70,83,423,0,18,112,5,4,332,565,8,10,0,21,0,39,94,354,1354
PUNJAB,G.R.P,2005,5,3,0,8,1,0,1,2,1,0,1,2,1,0,0,0,29,2,27,59,0,0,17,3,1,12,33,2,4,0,0,0,6,0,216,295
PUNJAB,GURDASPUR,2005,25,24,5,54,16,0,16,32,17,12,5,34,2,0,0,50,79,29,50,210,0,5,39,0,5,105,279,6,11,0,22,0,39,125,312,848
PUNJAB,HOSHIARPUR,2005,34,30,10,74,23,0,23,46,19,14,5,38,3,0,5,59,92,19,73,251,0,6,109,3,5,218,497,8,11,1,46,0,66,156,282,1120
PUNJAB,JAGRAON,2005,15,24,2,41,12,0,12,24,16,9,7,32,1,3,4,75,84,26,58,251,0,6,33,2,0,138,241,0,9,6,3,0,18,62,346,841
PUNJAB,JALANDHAR,2005,63,83,11,157,37,0,37,74,80,65,15,160,4,12,9,226,335,128,207,921,0,16,454,11,8,460,1180,7,27,1,78,0,113,231,773,2926
PUNJAB,KAPURTHALA,2005,23,26,4,53,18,0,18,36,24,18,6,48,2,3,2,63,135,51,84,340,0,6,119,9,3,180,418,2,21,0,29,0,52,101,261,1031
PUNJAB,KHANNA,2005,7,36,3,46,11,0,11,22,12,7,5,24,0,4,8,75,99,20,79,285,0,2,38,0,1,152,285,2,12,0,20,0,34,92,382,956
PUNJAB,LUDHIANA,2005,61,55,14,130,42,0,42,84,52,37,15,104,0,16,7,200,368,194,174,959,0,30,327,6,5,216,829,5,26,25,85,0,141,245,922,2707
PUNJAB,MAJITHA,2005,35,21,2,58,9,0,9,18,18,15,3,36,0,5,4,37,71,14,57,188,0,5,72,6,5,141,307,7,2,1,16,0,26,78,162,697
PUNJAB,MANSA,2005,23,23,26,72,15,0,15,30,11,6,5,22,2,1,1,51,39,12,27,133,0,10,59,0,1,143,213,1,5,0,18,0,24,0,184,613
PUNJAB,MOGA,2005,22,34,10,66,9,0,9,18,18,11,7,36,1,6,2,65,74,30,44,222,0,16,119,5,0,201,399,3,6,1,13,0,23,58,210,873
PUNJAB,MUKTSAR,2005,26,30,4,60,18,0,18,36,23,15,8,46,0,6,2,62,85,20,65,240,0,23,87,3,5,126,285,3,18,0,34,0,55,41,176,772
PUNJAB,NAWAN SHAHR,2005,13,23,2,38,14,0,14,28,12,6,6,24,3,3,15,92,116,32,84,345,0,3,75,1,2,222,388,2,8,1,21,0,32,85,137,850
PUNJAB,PATIALA,2005,61,30,10,101,19,0,19,38,24,20,4,48,3,5,9,181,328,154,174,854,0,32,224,3,0,414,975,8,30,2,82,0,122,302,1019,2786
PUNJAB,ROPAR,2005,27,10,0,37,18,0,18,36,12,10,2,24,0,8,1,81,139,62,77,368,0,6,117,0,1,128,441,6,16,2,29,0,53,189,414,1204
PUNJAB,SANGRUR,2005,33,34,19,86,11,0,11,22,21,15,6,42,1,5,2,66,109,42,67,292,0,28,149,0,3,197,456,7,14,1,43,0,65,79,333,1155
PUNJAB,TARN TARAN,2005,38,36,5,79,19,0,19,38,11,5,6,22,0,1,0,30,57,17,40,145,0,9,69,6,0,132,266,3,20,0,12,0,35,50,175,673
RAJASTHAN,AJMER,2005,43,54,2,99,26,0,26,52,89,89,0,178,0,2,33,339,859,372,487,2092,46,31,313,11,18,370,1141,11,61,3,339,0,414,352,2859,5861
RAJASTHAN,ALWAR,2005,78,93,5,176,52,0,52,104,86,61,25,172,1,16,42,143,1094,462,632,2390,157,33,463,2,27,1973,2991,31,110,0,297,0,438,336,1882,6921
RAJASTHAN,BANSWARA,2005,26,15,0,41,29,0,29,58,33,29,4,66,0,0,9,77,105,33,72,296,119,2,53,0,19,1088,1363,7,83,1,56,0,147,82,622,2426
RAJASTHAN,BARAN,2005,34,80,0,114,45,0,45,90,47,39,8,94,0,2,9,91,258,66,192,618,23,5,122,3,20,389,631,3,121,0,212,0,336,69,1444,2977
RAJASTHAN,BARMER,2005,27,28,1,56,19,0,19,38,26,20,6,52,0,0,3,88,186,59,127,463,20,4,107,3,15,647,921,13,86,0,72,0,171,125,1009,2479
RAJASTHAN,BHARATPUR,2005,91,111,1,203,46,0,46,92,88,58,30,176,4,2,23,63,772,228,544,1636,2,16,312,2,32,798,1357,35,44,0,220,0,299,195,3807,6664
RAJASTHAN,BHILWARA,2005,35,48,8,91,39,0,39,78,136,102,34,272,3,2,43,265,829,335,494,1971,130,8,339,2,27,105,827,14,87,0,293,0,394,216,2476,5105
RAJASTHAN,BIKANER,2005,39,86,0,125,30,0,30,60,20,20,0,40,2,0,14,147,362,107,255,887,0,12,185,1,14,362,736,12,67,0,199,0,278,162,1704,3418
RAJASTHAN,BUNDI,2005,20,75,0,95,41,0,41,82,70,58,12,140,0,0,8,89,244,89,155,585,40,7,80,1,8,889,1136,5,105,0,166,0,276,111,1184,3143
RAJASTHAN,CHITTORGARH,2005,52,55,3,110,61,0,61,122,133,102,31,266,1,6,30,256,557,182,375,1407,135,19,287,7,36,1858,2552,7,118,1,335,0,461,210,1508,5675
RAJASTHAN,CHURU,2005,19,33,1,53,18,0,18,36,28,19,9,56,1,0,8,78,144,34,110,375,17,8,162,0,13,687,987,7,60,0,149,0,216,100,725,2258
RAJASTHAN,DAUSA,2005,27,21,0,48,12,0,12,24,30,16,14,60,2,0,7,77,552,225,327,1190,58,13,139,4,10,52,453,13,12,0,83,0,108,177,2161,3450
RAJASTHAN,DHOLPUR,2005,31,87,1,119,25,0,25,50,53,35,18,106,6,1,16,50,273,76,197,619,39,16,104,0,13,1315,1594,17,30,0,98,0,145,107,618,2900
RAJASTHAN,DUNGARPUR,2005,21,11,1,33,9,0,9,18,31,30,1,62,1,0,9,36,50,11,39,146,83,6,35,0,14,109,343,3,39,0,50,0,92,96,864,1468
RAJASTHAN,G.R.P.,2005,4,3,0,7,2,0,2,4,2,2,0,4,1,1,9,0,467,14,453,945,4,0,7,1,0,5,19,0,15,1,0,0,16,2,392,916
RAJASTHAN,GANGANAGAR,2005,59,114,0,173,45,0,45,90,53,47,6,106,0,0,17,215,454,118,336,1140,7,25,469,3,15,1067,1720,10,58,0,373,0,441,134,1737,4855
RAJASTHAN,HANUMANGARH,2005,48,79,0,127,36,0,36,72,28,18,10,56,0,1,11,117,238,46,192,605,0,10,297,2,8,415,832,12,58,0,235,0,305,100,1490,3185
RAJASTHAN,JAIPUR,2005,88,95,6,189,82,0,82,164,211,163,48,422,3,7,49,821,4041,1935,2106,8962,489,213,1844,23,47,1714,5324,40,212,5,538,0,795,994,8771,20293
RAJASTHAN,JAISALMER,2005,7,0,1,8,2,0,2,4,9,4,5,18,1,0,3,61,115,19,96,295,14,2,31,0,2,0,81,5,16,0,16,0,37,32,425,742
RAJASTHAN,JALORE,2005,15,22,0,37,5,0,5,10,22,14,8,44,1,0,2,75,139,26,113,356,10,3,109,2,15,44,269,5,42,0,59,0,106,86,1452,2108
RAJASTHAN,JHALAWAR,2005,40,87,1,128,40,0,40,80,68,46,22,136,4,25,21,127,377,134,243,931,106,11,105,2,53,1000,1380,6,160,6,199,0,371,103,1017,3558
RAJASTHAN,JHUNJHUNU,2005,27,13,0,40,31,0,31,62,29,15,14,58,0,2,7,119,261,46,215,650,81,8,166,0,33,139,553,11,45,0,98,0,154,126,2159,3355
RAJASTHAN,JODHPUR,2005,47,102,1,150,29,0,29,58,75,58,17,150,1,0,52,340,1238,552,686,2869,63,26,599,6,20,1805,2807,16,98,5,221,0,340,288,1424,6456
RAJASTHAN,KARAULI,2005,26,20,2,48,22,0,22,44,62,41,21,124,1,2,5,40,380,153,227,808,4,10,138,2,14,98,348,14,40,0,116,0,170,82,2088,3166
RAJASTHAN,KOTA,2005,44,303,5,352,40,0,40,80,109,93,16,218,2,5,43,293,1118,540,578,2579,25,26,429,3,23,470,1188,5,154,1,361,0,521,212,3102,6773
RAJASTHAN,NAGAUR,2005,38,27,4,69,33,0,33,66,43,40,3,86,1,0,11,169,350,93,257,881,8,3,249,1,25,176,633,15,169,0,136,0,320,171,2449,4078
RAJASTHAN,PALI,2005,33,35,3,71,36,0,36,72,68,59,9,136,2,0,14,206,329,74,255,880,34,21,199,2,15,30,532,8,145,1,211,0,365,231,3070,4693
RAJASTHAN,RAJSAMAND,2005,18,19,0,37,8,0,8,16,47,37,10,94,0,1,7,70,179,53,126,436,36,10,103,2,12,1096,1400,0,29,2,117,0,148,141,421,2318
RAJASTHAN,SAWAI MADHOPUR,2005,18,33,1,52,23,0,23,46,36,29,7,72,1,0,12,92,381,156,225,867,2,9,106,1,11,18,215,8,28,0,114,0,150,68,2097,3059
RAJASTHAN,SIKAR,2005,51,46,0,97,21,0,21,42,68,44,24,136,0,0,7,176,381,97,284,945,102,6,165,0,37,417,955,12,22,0,137,0,171,228,2347,4223
RAJASTHAN,SIROHI,2005,30,24,2,56,23,0,23,46,24,21,3,48,1,0,16,110,167,37,130,461,82,11,102,0,14,656,998,4,51,0,104,0,159,133,578,2132
RAJASTHAN,TONK,2005,24,26,1,51,18,0,18,36,64,52,12,128,1,1,7,88,368,142,226,833,107,11,179,0,9,1332,1770,1,37,1,188,0,227,132,1249,3844
RAJASTHAN,UDAIPUR,2005,61,75,9,145,45,0,45,90,105,88,17,210,0,3,43,309,630,209,421,1615,247,28,343,2,29,1482,2402,11,101,1,205,0,318,271,2418,6418
SIKKIM,EAST,2005,5,10,1,16,8,0,8,16,2,1,1,4,0,0,1,43,43,5,38,130,7,3,32,2,1,37,113,0,8,0,3,0,11,31,34,271
SIKKIM,NORTH,2005,0,2,0,2,1,0,1,2,0,0,0,0,0,0,0,3,8,0,8,19,1,0,0,0,1,5,11,0,1,0,0,0,1,4,6,32
SIKKIM,SOUTH,2005,2,2,0,4,6,0,6,12,1,1,0,2,2,0,3,30,24,0,24,83,9,0,5,0,0,37,58,0,22,0,0,0,22,7,23,173
SIKKIM,WEST,2005,1,2,1,4,3,0,3,6,0,0,0,0,0,0,0,9,6,0,6,21,2,1,7,0,1,20,42,0,7,0,1,0,8,11,4,76
TAMIL NADU,CHENNAI,2005,123,175,4,302,43,0,43,86,55,31,24,110,5,0,59,597,3063,594,2469,6787,78,8,530,6,0,1124,2787,30,82,102,236,0,450,1041,12766,20127
TAMIL NADU,CHENNAI RLY.,2005,1,1,0,2,0,0,0,0,0,0,0,0,1,0,2,3,92,0,92,190,9,5,4,0,0,31,53,0,3,1,2,0,6,4,214,373
TAMIL NADU,COIMBATORE RURAL,2005,87,122,0,209,33,0,33,66,47,18,29,94,4,0,35,333,1355,523,832,3082,117,15,168,3,18,3608,4748,8,165,35,147,0,355,819,2881,10000
TAMIL NADU,COIMBATORE URBAN,2005,19,20,1,40,6,0,6,12,4,3,1,8,2,0,31,153,896,263,633,1978,194,32,109,1,1,120,641,3,21,5,31,0,60,184,2012,3845
TAMIL NADU,CUDDALORE,2005,60,90,0,150,32,0,32,64,32,23,9,64,2,0,13,87,455,125,330,1012,134,0,1,0,13,516,1051,13,45,0,40,0,98,387,4538,6458
TAMIL NADU,DHARMAPURI,2005,31,32,2,65,7,0,7,14,31,23,8,62,3,0,6,52,179,76,103,419,131,12,41,0,27,664,1027,5,42,4,41,0,92,152,1265,2727
TAMIL NADU,DINDIGUL,2005,73,51,0,124,17,0,17,34,36,0,36,72,1,0,13,73,425,99,326,937,34,7,73,0,0,395,811,5,33,1,35,0,74,302,3255,4829
TAMIL NADU,ERODE,2005,55,28,0,83,22,0,22,44,22,16,6,44,2,0,15,114,609,174,435,1349,32,20,84,1,18,2295,2948,5,72,11,63,0,151,498,2413,6379
TAMIL NADU,KANCHIPURAM,2005,42,62,0,104,18,0,18,36,29,0,29,58,4,0,19,90,430,70,360,973,38,0,0,0,9,346,431,12,43,13,10,0,78,38,3882,5085
TAMIL NADU,KANYAKUMARI,2005,30,41,3,74,13,0,13,26,16,16,0,32,2,0,3,110,260,21,239,635,6,5,124,2,12,311,629,1,15,0,40,0,56,169,1900,3063
TAMIL NADU,KARUR,2005,23,25,1,49,6,0,6,12,15,12,3,30,2,0,9,57,257,72,185,582,23,2,19,0,12,233,505,5,8,7,26,0,46,216,1919,2865
TAMIL NADU,KRISHNAGIRI,2005,42,21,1,64,10,0,10,20,30,26,4,60,7,0,14,95,349,175,174,814,184,10,60,0,25,773,1357,10,47,34,28,0,119,305,2979,5024
TAMIL NADU,MADURAI RURAL,2005,36,70,0,106,24,0,24,48,36,32,4,72,2,0,19,100,440,45,395,1001,89,7,62,0,15,1290,1749,4,57,13,44,0,118,286,2786,5380
TAMIL NADU,MADURAI URBAN,2005,21,40,0,61,5,0,5,10,20,13,7,40,1,0,24,101,430,97,333,986,126,5,222,5,2,92,564,3,28,29,43,0,103,112,2075,3384
TAMIL NADU,NAGAPATTINAM,2005,43,31,1,75,12,0,12,24,20,12,8,40,0,0,8,62,220,59,161,510,41,3,38,1,18,1437,1683,2,45,6,19,0,72,145,1521,3673
TAMIL NADU,NAMAKKAL,2005,29,26,0,55,0,0,0,0,35,33,2,70,1,0,6,52,194,70,124,447,72,4,19,4,11,1378,1804,0,39,0,41,0,80,316,1083,3310
TAMIL NADU,NILGIRIS,2005,11,21,0,32,13,0,13,26,9,8,1,18,1,0,2,73,120,8,112,316,16,3,12,1,0,209,241,0,32,0,6,0,38,0,1166,1695
TAMIL NADU,PERAMBALUR,2005,34,34,0,68,19,0,19,38,19,16,3,38,1,0,12,57,190,71,119,450,63,7,37,0,9,691,936,3,51,3,21,0,78,129,1303,2683
TAMIL NADU,PUDUKOTTAI,2005,29,33,0,62,14,0,14,28,34,29,5,68,0,0,10,78,268,68,200,624,199,9,22,0,18,306,732,4,55,8,51,0,118,178,2436,3752
TAMIL NADU,RAMNATHAPURAM,2005,29,28,1,58,5,0,5,10,17,14,3,34,1,0,3,49,125,24,101,303,42,8,56,0,16,416,646,4,28,3,29,0,64,108,1926,2894
TAMIL NADU,SALEM RURAL,2005,53,172,0,225,52,0,52,104,107,106,1,214,5,0,16,112,289,66,223,711,195,3,71,1,36,2590,3234,14,218,0,154,0,386,338,1665,6091
TAMIL NADU,SALEM URBAN,2005,17,8,0,25,4,0,4,8,12,10,2,24,0,0,1,34,266,65,201,567,2,4,97,1,1,121,336,6,9,9,18,0,42,110,3305,4025
TAMIL NADU,SIVAGANGAI,2005,15,40,2,57,2,0,2,4,9,7,2,18,5,0,3,78,237,49,188,560,15,2,43,0,9,258,441,8,8,10,28,0,54,114,1514,2400
TAMIL NADU,THANJAVUR,2005,63,55,0,118,9,0,9,18,45,45,0,90,1,0,7,155,613,109,504,1389,88,5,18,1,27,648,1050,7,102,5,26,0,140,263,1957,4095
TAMIL NADU,THENI,2005,29,51,0,80,3,0,3,6,17,14,3,34,0,0,2,79,228,48,180,537,38,2,72,0,12,413,686,2,50,4,19,0,75,149,2057,3227
TAMIL NADU,THIRUNELVELI RURAL,2005,75,108,4,187,27,0,27,54,26,26,0,52,3,0,9,83,374,22,352,843,0,6,30,2,19,1267,1554,5,123,1,48,0,177,230,3090,5530
TAMIL NADU,THIRUNELVELI URBAN,2005,14,43,0,57,2,0,2,4,10,6,4,20,1,0,4,30,158,20,138,351,0,2,50,1,3,72,181,1,7,29,6,0,43,53,705,1191
TAMIL NADU,THIRUVALLUR,2005,27,19,1,47,15,0,15,30,21,21,0,42,4,0,7,77,191,23,168,470,58,1,12,0,5,1447,1763,14,58,17,24,0,113,240,823,3061
TAMIL NADU,THIRUVANNAMALAI,2005,33,18,0,51,26,0,26,52,35,35,0,70,0,0,5,48,345,43,302,743,121,7,88,2,17,1330,1766,5,17,16,53,0,91,201,604,2971
TAMIL NADU,THIRUVARUR,2005,16,20,0,36,4,0,4,8,11,4,7,22,1,0,2,65,234,38,196,536,31,13,23,0,13,1001,1185,1,72,21,15,0,109,104,1417,3064
TAMIL NADU,THOOTHUGUDI,2005,63,71,2,136,17,0,17,34,25,8,17,50,1,0,4,135,429,55,374,998,3,9,137,1,22,1376,1739,3,10,105,59,0,177,191,1908,4571
TAMIL NADU,TRICHY RLY.,2005,1,0,0,1,0,0,0,0,0,0,0,0,0,0,1,2,77,0,77,157,2,1,4,0,0,20,30,0,1,0,1,0,2,3,87,200
TAMIL NADU,TRICHY RURAL,2005,50,35,0,85,19,0,19,38,53,50,3,106,4,0,21,80,248,75,173,601,35,0,20,2,13,1084,1419,7,12,7,43,0,69,265,1857,3855
TAMIL NADU,TRICHY URBAN,2005,18,10,0,28,1,0,1,2,7,4,3,14,2,0,11,75,315,58,257,718,3,3,74,0,3,702,905,2,17,74,23,0,116,120,1475,2935
TAMIL NADU,VELLORE,2005,49,32,2,83,23,1,22,46,37,23,14,74,1,0,12,151,577,169,408,1318,26,8,133,4,26,2229,2783,12,54,0,28,0,94,357,2650,6411
TAMIL NADU,VILUPPURAM,2005,68,83,3,154,49,0,49,98,49,49,0,98,1,0,13,102,306,51,255,728,250,2,21,0,36,468,1344,9,50,5,59,0,123,567,3818,5959
TAMIL NADU,VIRUDHUNAGAR,2005,31,43,0,74,19,0,19,38,58,50,8,116,2,0,16,96,607,58,549,1328,56,9,120,1,29,464,887,2,45,87,93,0,227,208,3242,5228
TRIPURA,DHALAI,2005,12,5,0,17,15,0,15,30,21,8,13,42,9,0,5,19,22,0,22,77,30,4,2,1,2,47,107,1,13,0,29,0,43,21,70,328
TRIPURA,NORTH,2005,27,17,1,45,47,0,47,94,19,11,8,38,6,0,19,47,64,2,62,200,30,6,15,3,11,103,193,3,44,0,105,0,152,25,135,727
TRIPURA,SOUTH,2005,21,14,0,35,42,0,42,84,21,12,9,42,1,0,11,47,110,21,89,279,31,9,15,4,5,144,241,11,65,0,129,0,205,33,228,941
TRIPURA,WEST,2005,61,20,0,81,58,0,58,116,24,12,12,48,6,0,26,57,129,39,90,347,57,13,27,8,17,135,366,19,39,1,176,0,235,109,378,1360
UTTAR PRADESH,AGRA,2005,115,126,34,275,29,0,29,58,120,77,43,240,10,2,71,169,1087,678,409,2426,197,97,158,3,12,421,1256,38,80,162,232,0,512,368,1268,4799
UTTAR PRADESH,ALIGARH,2005,176,200,20,396,61,0,61,122,112,84,28,224,5,12,80,123,885,413,472,1990,226,98,189,2,62,337,1159,43,38,43,226,0,350,245,983,4166
UTTAR PRADESH,ALLAHABAD,2005,144,118,48,310,17,0,17,34,67,50,17,134,4,0,48,198,487,246,241,1224,120,58,162,7,25,284,928,40,30,47,117,0,234,272,1224,3517
UTTAR PRADESH,AMBEDKAR NAGAR,2005,47,41,13,101,11,0,11,22,32,31,1,64,1,0,25,44,123,28,95,316,20,29,33,3,6,158,262,13,14,9,42,0,78,13,209,886
UTTAR PRADESH,AURAIYA,2005,55,44,5,104,9,0,9,18,36,22,14,72,9,0,26,31,72,18,54,210,31,16,21,0,12,162,316,22,15,8,26,0,71,74,288,962
UTTAR PRADESH,AZAMGARH,2005,84,91,21,196,10,0,10,20,34,32,2,68,7,0,68,85,185,62,123,530,109,32,64,9,5,286,510,27,26,24,156,0,233,5,702,2030
UTTAR PRADESH,BADAUN,2005,179,182,32,393,22,0,22,44,77,60,17,154,5,0,27,42,179,27,152,432,32,57,15,0,18,178,307,32,39,22,47,0,140,7,811,2003
UTTAR PRADESH,BAGHPAT,2005,83,69,7,159,13,0,13,26,33,26,7,66,6,0,31,23,128,55,73,316,55,13,30,0,0,129,317,10,15,19,74,0,118,90,174,1002
UTTAR PRADESH,BAHRAICH,2005,50,43,19,112,25,0,25,50,41,39,2,82,0,18,16,55,121,21,100,331,44,40,38,1,10,179,377,21,20,38,21,0,100,65,299,1164
UTTAR PRADESH,BALLIA,2005,36,52,21,109,2,0,2,4,8,4,4,16,2,1,14,51,95,30,65,258,67,12,28,1,5,142,322,12,7,5,11,0,35,67,224,863
UTTAR PRADESH,BALRAMPUR,2005,16,13,6,35,6,0,6,12,5,5,0,10,1,0,3,17,44,8,36,109,7,8,11,1,0,54,95,4,9,4,7,0,24,14,79,309
UTTAR PRADESH,BANDA,2005,65,34,16,115,16,0,16,32,16,10,6,32,1,0,13,39,92,21,71,237,29,18,51,0,7,87,195,22,32,5,12,0,71,3,451,1009
UTTAR PRADESH,BARABANKI,2005,49,66,12,127,30,0,30,60,35,29,6,70,7,0,22,79,197,37,160,502,44,42,11,1,3,220,442,21,29,35,59,0,144,121,555,1638
UTTAR PRADESH,BAREILLY,2005,224,209,32,465,48,0,48,96,107,81,26,214,14,2,66,119,506,174,332,1213,108,82,206,12,11,449,1120,37,89,74,210,0,410,252,1163,4020
UTTAR PRADESH,BASTI,2005,25,20,11,56,13,0,13,26,13,13,0,26,2,1,10,26,107,39,68,253,19,18,33,1,0,130,287,7,8,20,22,0,57,86,250,822
UTTAR PRADESH,BIJNOR,2005,62,51,15,128,22,0,22,44,35,26,9,70,3,1,20,36,215,63,152,490,31,15,70,1,2,74,290,26,26,45,60,0,157,97,527,1434
UTTAR PRADESH,BULANDSHAHAR,2005,198,124,20,342,33,0,33,66,81,60,21,162,5,0,54,57,347,100,247,810,65,28,61,1,10,305,696,41,62,116,106,0,325,226,783,2723
UTTAR PRADESH,CHANDOLI,2005,29,24,12,65,6,0,6,12,6,3,3,12,2,1,7,17,43,18,25,113,9,12,18,0,0,22,61,9,5,50,10,0,74,0,202,484
UTTAR PRADESH,CHITRAKOOT DHAM,2005,23,10,8,41,10,0,10,20,9,0,9,18,1,1,1,11,21,9,12,56,7,10,9,0,6,47,115,12,12,0,6,0,30,36,166,406
UTTAR PRADESH,DEORIA,2005,39,36,21,96,7,0,7,14,19,17,2,38,0,0,16,36,100,44,56,252,57,22,38,2,8,127,347,17,7,5,27,0,56,93,383,1060
UTTAR PRADESH,ETAH,2005,145,183,47,375,16,0,16,32,59,33,26,118,0,0,24,65,196,111,85,481,74,45,40,0,18,210,555,43,34,26,62,0,165,168,486,1941
UTTAR PRADESH,ETAWAH,2005,67,59,7,133,12,0,12,24,71,28,43,142,3,0,25,35,96,59,37,255,13,20,50,1,11,70,302,29,20,35,26,0,110,137,817,1604
UTTAR PRADESH,FAIZABAD,2005,55,43,13,111,11,0,11,22,35,33,2,70,1,0,21,66,135,43,92,358,35,63,30,1,6,144,392,15,13,29,48,0,105,113,349,1226
UTTAR PRADESH,FATEHGARH,2005,70,68,8,146,10,0,10,20,31,20,11,62,1,0,16,21,75,22,53,188,16,11,16,1,0,52,98,14,7,15,26,0,62,2,305,765
UTTAR PRADESH,FATEHPUR,2005,92,41,36,169,7,0,7,14,28,18,10,56,2,0,16,27,80,22,58,205,7,9,22,1,0,157,320,22,11,9,21,0,63,124,430,1142
UTTAR PRADESH,FIROZABAD,2005,122,117,34,273,17,0,17,34,71,44,27,142,4,1,55,58,358,216,142,834,52,26,35,2,6,312,437,48,16,42,57,0,163,4,709,2146
UTTAR PRADESH,G.R.P.,2005,15,16,2,33,3,0,3,6,4,1,3,8,10,1,32,4,1102,68,1034,2251,13,39,63,0,0,9,126,1,15,26,0,0,42,2,645,2002
UTTAR PRADESH,GAUTAMBUDH NAGAR,2005,69,58,15,142,18,0,18,36,51,42,9,102,6,1,41,88,962,564,398,2060,64,49,173,4,1,19,562,14,28,43,45,0,130,252,168,2169
UTTAR PRADESH,GHAZIABAD,2005,183,135,35,353,24,0,24,48,103,79,24,206,6,0,38,100,1387,844,543,2918,52,78,277,14,2,75,879,33,26,92,147,0,298,381,1068,4256
UTTAR PRADESH,GHAZIPUR,2005,48,45,16,109,2,0,2,4,8,3,5,16,1,0,27,43,102,44,58,275,68,22,35,6,6,156,295,19,7,20,35,0,81,2,204,872
UTTAR PRADESH,GONDA,2005,31,59,32,122,12,0,12,24,18,15,3,36,1,1,16,66,139,46,93,362,34,21,39,2,3,110,209,26,14,23,6,0,69,0,346,999
UTTAR PRADESH,GORAKHPUR,2005,94,67,41,202,24,0,24,48,29,27,2,58,5,1,39,120,367,166,201,899,104,60,61,14,0,266,726,16,22,25,18,0,81,221,599,2193
UTTAR PRADESH,HAMIRPUR,2005,48,26,23,97,9,0,9,18,14,10,4,28,0,0,3,29,53,10,43,138,19,16,9,0,0,49,93,6,17,11,10,0,44,0,289,631
UTTAR PRADESH,HARDOI,2005,91,52,46,189,31,0,31,62,45,32,13,90,1,0,24,48,209,43,166,491,21,21,63,1,1,311,552,25,51,48,47,0,171,134,644,1914
UTTAR PRADESH,HATHRAS,2005,65,88,11,164,12,0,12,24,29,20,9,58,7,0,41,49,276,114,162,649,92,45,33,2,2,176,400,20,34,35,86,0,175,50,493,1646
UTTAR PRADESH,J.P.NAGAR,2005,66,40,11,117,22,0,22,44,17,14,3,34,3,1,16,46,131,42,89,328,39,11,21,3,0,39,232,8,30,40,20,0,98,119,449,1132
UTTAR PRADESH,JALAUN,2005,59,33,12,104,3,0,3,6,14,8,6,28,1,1,10,31,85,32,53,213,17,7,17,1,4,5,128,21,13,37,17,0,88,77,1087,1552
UTTAR PRADESH,JAUNPUR,2005,41,59,37,137,13,0,13,26,24,21,3,48,1,1,32,51,150,61,89,385,37,22,39,1,0,181,412,26,15,32,40,0,113,132,367,1301
UTTAR PRADESH,JHANSI,2005,50,19,27,96,3,0,3,6,11,9,2,22,0,3,15,27,126,59,67,297,16,13,44,7,6,56,184,13,14,37,38,0,102,42,303,870
UTTAR PRADESH,KANNAUJ,2005,61,55,16,132,5,0,5,10,38,27,11,76,2,0,11,31,84,24,60,212,22,21,33,1,4,22,209,10,20,13,62,0,105,106,313,930
UTTAR PRADESH,KANPUR DEHAT,2005,49,34,22,105,8,0,8,16,61,44,17,122,3,0,11,40,139,17,122,332,75,24,30,0,3,246,507,26,32,20,53,0,131,129,449,1454
UTTAR PRADESH,KANPUR NAGAR,2005,150,91,40,281,18,0,18,36,107,90,17,214,11,2,45,137,803,526,277,1801,94,141,218,8,5,261,1055,51,43,227,205,0,526,328,733,3718
UTTAR PRADESH,KAUSHAMBI,2005,70,25,18,113,9,0,9,18,11,7,4,22,6,0,19,31,43,8,35,142,35,9,20,0,0,85,225,13,11,7,21,0,52,76,214,723
UTTAR PRADESH,KHIRI,2005,131,141,33,305,45,0,45,90,69,58,11,138,2,6,25,64,235,63,172,567,51,19,56,2,3,388,653,61,55,70,63,0,249,134,604,2257
UTTAR PRADESH,KUSHI NAGAR,2005,41,35,33,109,6,0,6,12,22,16,6,44,1,0,4,35,110,32,78,260,74,21,32,2,8,221,482,16,11,32,23,0,82,124,255,1106
UTTAR PRADESH,LALITPUR,2005,21,3,13,37,1,0,1,2,2,1,1,4,0,1,0,10,22,9,13,55,8,10,6,0,0,13,54,1,4,32,4,0,41,17,119,287
UTTAR PRADESH,LUCKNOW,2005,194,156,38,388,51,0,51,102,150,136,14,300,8,2,102,477,2340,1135,1205,5269,244,232,432,58,1,64,1423,44,71,204,281,0,600,392,2466,8007
UTTAR PRADESH,MAHARAJGANJ,2005,30,13,17,60,9,0,9,18,15,14,1,30,0,0,10,30,48,10,38,136,30,14,22,1,0,87,222,9,14,21,6,0,50,68,119,563
UTTAR PRADESH,MAHOBA,2005,43,13,8,64,4,0,4,8,1,1,0,2,0,0,0,12,28,6,22,68,15,3,10,0,0,43,101,4,3,12,2,0,21,30,168,399
UTTAR PRADESH,MAINPURI,2005,111,121,18,250,5,0,5,10,41,22,19,82,3,4,28,38,139,76,63,351,61,20,29,2,0,193,313,22,8,5,17,0,52,8,564,1437
UTTAR PRADESH,MATHURA,2005,90,128,26,244,18,0,18,36,54,44,10,108,7,1,44,79,464,266,198,1059,93,58,136,7,17,170,738,23,31,63,74,0,191,257,692,2532
UTTAR PRADESH,MAU,2005,34,41,17,92,5,0,5,10,8,6,2,16,0,0,20,49,77,16,61,223,81,21,31,3,3,88,291,10,10,47,29,0,96,64,146,784
UTTAR PRADESH,MEERUT,2005,199,208,16,423,37,0,37,74,139,97,42,278,16,2,110,195,1038,524,514,2399,135,89,160,7,2,61,663,34,66,121,303,0,524,209,1200,4347
UTTAR PRADESH,MIRZAPUR,2005,50,21,14,85,6,0,6,12,10,7,3,20,10,1,19,48,118,24,94,314,18,23,28,1,0,174,365,26,11,11,29,0,77,121,159,898
UTTAR PRADESH,MORADABAD,2005,168,169,29,366,52,0,52,104,98,88,10,196,10,5,65,106,574,189,385,1334,107,54,117,11,0,94,525,38,95,135,209,0,477,142,1221,3499
UTTAR PRADESH,MUZAFFARNAGAR,2005,207,187,24,418,44,0,44,88,80,52,28,160,20,1,105,115,606,229,377,1453,131,63,104,7,0,12,317,20,46,113,156,0,335,0,1191,3232
UTTAR PRADESH,PILIBHIT,2005,59,59,16,134,24,0,24,48,37,28,9,74,7,0,16,25,89,20,69,226,14,30,52,3,0,2,143,20,23,33,15,0,91,42,672,1238
UTTAR PRADESH,PRATAPGARH,2005,60,74,24,158,15,0,15,30,37,33,4,74,3,0,17,73,170,46,124,433,77,31,56,1,10,233,474,23,17,4,51,0,95,66,397,1439
UTTAR PRADESH,RAIBAREILLY,2005,72,81,21,174,26,0,26,52,41,41,0,82,5,0,25,57,247,55,192,581,63,25,33,0,4,320,556,18,47,27,167,0,259,111,381,1771
UTTAR PRADESH,RAMPUR,2005,69,57,14,140,17,0,17,34,33,29,4,66,6,0,12,42,169,48,121,398,44,35,88,5,3,24,268,13,22,3,4,0,42,69,479,1208
UTTAR PRADESH,SAHARANPUR,2005,84,117,20,221,15,0,15,30,31,25,6,62,2,0,34,75,374,144,230,859,87,65,178,6,0,31,492,19,35,74,119,0,247,125,902,2393
UTTAR PRADESH,SANT KABIRNAGAR,2005,16,12,2,30,3,0,3,6,16,16,0,32,1,0,10,25,50,12,38,136,25,8,5,3,1,65,123,6,2,15,11,0,34,16,116,408
UTTAR PRADESH,SHAHJAHANPUR,2005,139,120,14,273,26,0,26,52,55,37,18,110,8,0,33,46,186,45,141,459,35,25,53,5,5,149,399,25,40,25,22,0,112,127,684,1822
UTTAR PRADESH,SHRAWASTI,2005,21,14,9,44,6,0,6,12,13,13,0,26,0,10,9,25,36,2,34,116,9,8,7,0,1,64,100,6,5,7,8,0,26,11,68,337
UTTAR PRADESH,SIDHARTHNAGAR,2005,17,15,10,42,4,0,4,8,19,19,0,38,3,0,7,45,77,35,42,209,22,14,26,2,0,76,181,12,13,40,13,0,78,41,221,677
UTTAR PRADESH,SITAPUR,2005,142,627,43,812,51,0,51,102,89,86,3,178,5,0,57,104,471,76,395,1108,70,68,109,1,36,391,862,70,72,31,142,0,315,187,402,3168
UTTAR PRADESH,SONBHADRA,2005,24,17,19,60,8,0,8,16,7,5,2,14,1,0,5,29,57,17,40,149,10,16,32,5,6,60,224,10,6,20,11,0,47,95,81,519
UTTAR PRADESH,ST.RAVIDASNAGAR,2005,17,21,7,45,1,0,1,2,2,2,0,4,5,0,13,41,71,24,47,201,25,10,20,0,3,75,181,8,3,17,31,0,59,48,66,484
UTTAR PRADESH,SULTANPUR,2005,57,88,36,181,16,0,16,32,33,24,9,66,1,2,21,71,212,66,146,519,20,18,20,0,0,185,320,14,14,21,38,0,87,77,353,1297
UTTAR PRADESH,UNNAO,2005,102,68,50,220,35,0,35,70,54,43,11,108,2,0,25,70,185,58,127,467,51,15,44,1,1,213,372,40,47,32,72,0,191,47,614,1768
UTTAR PRADESH,VARANASI,2005,73,65,27,165,8,0,8,16,34,19,15,68,0,2,38,99,370,188,182,879,50,49,56,13,14,81,308,19,8,43,44,0,114,45,610,1748
UTTARAKHAND,ALMORA,2005,22,7,0,29,6,0,6,12,6,6,0,12,0,0,17,16,48,4,44,129,6,0,8,2,2,32,63,6,4,2,6,0,18,13,51,254
UTTARAKHAND,BAGESHWAR,2005,10,5,0,15,7,0,7,14,2,0,2,4,0,0,5,5,17,0,17,44,0,0,0,0,2,10,17,1,1,1,0,0,3,5,35,106
UTTARAKHAND,CHAMOLI,2005,9,4,2,15,4,0,4,8,5,3,2,10,0,0,1,44,17,0,17,79,14,3,1,0,1,15,51,6,3,4,1,0,14,17,97,248
UTTARAKHAND,CHAMPAWAT,2005,7,0,0,7,1,0,1,2,3,2,1,6,1,0,6,0,17,2,15,41,7,1,0,0,1,8,29,3,2,0,2,0,7,12,37,108
UTTARAKHAND,DEHRADUN,2005,42,39,5,86,23,0,23,46,45,39,6,90,3,0,24,123,446,161,285,1042,108,43,167,3,6,63,527,8,13,47,86,0,154,137,414,1845
UTTARAKHAND,HARIDWAR,2005,65,56,5,126,32,0,32,64,54,38,16,108,18,0,41,88,455,181,274,1057,66,29,90,11,6,351,697,7,20,34,73,0,134,144,155,1800
UTTARAKHAND,NAINITAL,2005,31,29,5,65,7,0,7,14,16,16,0,32,11,0,19,57,161,50,111,409,45,12,22,3,0,37,188,13,6,0,18,0,37,69,310,871
UTTARAKHAND,PAURI GARHWAL,2005,17,6,3,26,7,0,7,14,4,4,0,8,1,0,3,45,64,14,50,177,11,7,9,0,2,77,136,1,8,0,11,0,20,30,81,387
UTTARAKHAND,PITHORAGARH,2005,8,4,2,14,7,0,7,14,4,0,4,8,1,0,7,23,28,0,28,87,10,8,11,0,1,15,45,4,6,0,10,0,20,0,105,254
UTTARAKHAND,RUDRA PRAYAG,2005,11,4,2,17,2,0,2,4,4,3,1,8,2,0,3,24,11,0,11,51,7,1,1,0,3,11,36,3,5,1,0,0,9,13,29,137
UTTARAKHAND,TEHRI GARHWAL,2005,11,10,0,21,9,0,9,18,8,8,0,16,0,0,2,16,24,2,22,66,15,7,10,0,0,11,65,6,1,0,10,0,17,22,86,248
UTTARAKHAND,UDHAMSINGH NAGAR,2005,40,34,4,78,21,0,21,42,47,1,46,94,11,0,31,62,309,118,191,722,130,23,74,3,0,111,341,5,23,0,51,0,79,0,582,1561
UTTARAKHAND,UTTARKASHI,2005,6,4,2,12,7,0,7,14,5,5,0,10,0,0,0,18,33,1,32,84,14,10,3,0,0,4,31,0,8,0,4,0,12,0,96,214
WEST BENGAL,24 PARGANAS NORTH,2005,168,70,38,276,217,0,217,434,211,153,58,422,18,196,39,78,1564,493,1071,3459,203,74,128,14,0,113,539,71,151,5,886,0,1113,7,3707,7958
WEST BENGAL,24 PARGANAS SOUTH,2005,131,8,39,178,136,0,136,272,118,117,1,236,17,242,21,237,1071,257,814,2659,246,0,93,2,6,0,389,64,123,2,915,0,1104,42,3211,6724
WEST BENGAL,ASANSOL,2005,27,2,2,31,9,0,9,18,14,14,0,28,3,23,7,15,158,93,65,364,69,14,13,3,1,40,245,4,10,0,340,0,354,105,358,1217
WEST BENGAL,BANKURA,2005,53,6,10,69,43,0,43,86,27,27,0,54,25,5,28,13,280,18,262,631,72,5,25,1,7,173,395,22,54,0,149,0,225,112,432,1542
WEST BENGAL,BIRBHUM,2005,47,19,16,82,78,0,78,156,41,37,4,82,11,38,31,15,231,37,194,557,189,7,14,8,10,77,465,5,42,0,160,0,207,160,481,1680
WEST BENGAL,BURDWAN,2005,110,10,26,146,113,0,113,226,53,52,1,106,13,79,26,29,532,100,432,1211,209,12,62,4,6,98,651,40,56,0,230,0,326,260,2534,4502
WEST BENGAL,COOCHBEHAR,2005,33,7,6,46,82,0,82,164,30,30,0,60,1,3,3,3,119,20,99,248,20,7,26,4,5,43,199,8,76,0,203,0,287,94,504,1277
WEST BENGAL,DAKSHIN DINAJPUR,2005,27,5,15,47,28,0,28,56,33,27,6,66,2,11,9,5,100,6,94,227,24,6,11,1,1,34,144,20,45,1,141,0,207,67,357,943
WEST BENGAL,DARJEELING,2005,50,4,18,72,39,0,39,78,17,17,0,34,3,41,7,4,333,60,273,721,23,19,9,3,6,207,382,1,39,2,81,0,123,115,427,1448
WEST BENGAL,HOOGHLY,2005,58,6,23,87,42,0,42,84,32,30,2,64,9,130,21,64,469,69,400,1162,337,13,51,4,9,239,885,5,31,0,539,0,575,232,956,3270
WEST BENGAL,HOWRAH,2005,50,2,7,59,41,0,41,82,34,27,7,68,5,20,5,3,141,32,109,315,78,6,49,2,3,103,410,9,38,2,243,0,292,169,648,1658
WEST BENGAL,HOWRAH CITY,2005,31,4,11,46,20,0,20,40,21,12,9,42,3,85,30,8,485,176,309,1096,63,8,67,3,2,168,423,9,18,0,157,0,184,112,1076,2381
WEST BENGAL,HOWRAH G.R.P.,2005,7,6,2,15,0,0,0,0,8,4,4,16,1,97,1,0,281,2,279,661,12,0,22,1,0,8,44,0,4,2,0,1,7,1,115,569
WEST BENGAL,JALPAIGURI,2005,87,22,42,151,108,0,108,216,61,48,13,122,9,17,20,40,712,79,633,1510,53,50,11,6,3,254,533,15,103,1,237,0,356,156,879,2886
WEST BENGAL,KHARAGPUR G.R.P.,2005,2,0,2,4,1,0,1,2,1,0,1,2,2,2,2,0,109,0,109,224,3,1,1,0,0,3,11,0,3,0,0,0,3,3,15,150
WEST BENGAL,KOLKATA,2005,43,73,16,132,13,0,13,26,82,66,16,164,17,59,55,130,2639,548,2091,5539,183,215,935,11,0,1032,2862,6,148,35,236,0,425,486,2977,9391
WEST BENGAL,MALDA,2005,61,55,21,137,96,0,96,192,44,36,8,88,7,6,18,20,335,111,224,721,64,0,8,10,0,66,148,3,137,0,287,0,427,0,1003,2241
WEST BENGAL,MURSHIDABAD,2005,115,23,46,184,236,0,236,472,121,110,11,242,7,19,18,17,536,99,437,1133,139,15,64,16,6,577,1049,35,223,1,696,0,955,232,910,4052
WEST BENGAL,NADIA,2005,100,0,12,112,148,0,148,296,102,97,5,204,11,53,15,2,772,129,643,1625,233,0,44,9,4,628,1093,48,95,3,545,60,751,175,1395,4454
WEST BENGAL,PASCHIM MIDNAPUR,2005,79,38,14,131,92,0,92,184,45,44,1,90,25,18,27,35,353,36,317,811,184,23,30,0,7,54,300,21,57,0,300,0,378,2,1312,2716
WEST BENGAL,PURAB MIDNAPUR,2005,42,19,17,78,54,0,54,108,54,53,1,108,7,44,8,8,219,30,189,505,155,45,46,0,4,17,273,34,28,0,325,0,387,6,1031,2163
WEST BENGAL,PURULIA,2005,61,0,9,70,34,0,34,68,8,8,0,16,3,23,14,4,143,3,140,330,43,5,23,0,0,0,71,8,37,0,108,0,153,0,511,1034
WEST BENGAL,SEALDAH G.R.P.,2005,20,4,2,26,3,0,3,6,9,4,5,18,0,9,4,0,188,0,188,389,3,1,11,2,0,5,23,1,5,0,0,0,6,1,36,304
WEST BENGAL,SILIGURI G.R.P.,2005,2,0,1,3,0,0,0,0,2,2,0,4,1,0,1,0,98,0,98,198,0,1,0,0,0,0,1,0,2,0,0,0,2,0,33,141
WEST BENGAL,UTTAR DINAJPUR,2005,49,51,13,113,53,0,53,106,39,24,15,78,11,1,16,9,256,37,219,549,30,1,17,3,12,186,449,17,47,0,158,0,222,200,536,1705
CHANDIGARH,CHANDIGARH,2005,18,15,4,37,33,0,33,66,54,45,9,108,0,2,12,223,1373,579,794,2983,43,41,161,0,1,57,312,3,31,9,75,0,118,9,969,3133
D & N HAVELI,D and N HAVELI,2005,7,5,0,12,5,0,5,10,13,9,4,26,3,0,2,25,74,17,57,178,18,12,10,4,1,33,95,0,5,0,5,0,10,17,195,434
DAMAN & DIU,DAMAN,2005,4,2,0,6,2,0,2,4,4,2,2,8,3,0,0,29,42,24,18,116,16,5,2,3,1,12,60,1,1,0,1,0,3,21,44,193
DAMAN & DIU,DIU,2005,1,0,0,1,0,0,0,0,0,0,0,0,1,0,0,8,8,3,5,25,3,1,1,4,0,4,16,0,0,0,2,0,2,3,14,50
DELHI UT,CENTRAL,2005,23,28,3,54,20,0,20,40,52,32,20,104,1,9,20,57,1192,492,700,2471,1,39,164,5,5,182,405,4,40,26,48,1,119,9,1600,3529
DELHI UT,EAST,2005,31,38,2,71,59,0,59,118,153,129,24,306,1,28,58,187,2030,1146,884,4334,8,32,140,2,1,255,497,12,105,16,178,0,311,59,2058,5453
DELHI UT,G.R.P.(RLY),2005,16,4,1,21,2,0,2,4,4,1,3,8,0,1,6,2,1053,15,1038,2115,1,3,15,0,2,9,30,1,5,1,0,0,7,0,75,1201
DELHI UT,IGI AIRPORT,2005,1,0,0,1,1,0,1,2,4,0,4,8,0,0,2,0,80,19,61,162,0,0,612,0,0,3,615,0,1,0,0,0,1,0,112,816
DELHI UT,NEW DELHI,2005,10,11,3,24,6,0,6,12,19,15,4,38,0,2,13,42,803,236,567,1663,9,32,236,8,1,40,417,2,26,24,9,0,61,91,908,2295
DELHI UT,NORTH,2005,24,23,1,48,22,0,22,44,78,49,29,156,3,15,34,86,900,310,590,1938,5,50,140,5,3,122,325,2,45,7,96,0,150,0,1645,3306
DELHI UT,NORTH-EAST,2005,51,63,8,122,106,0,106,212,212,151,61,424,4,24,60,186,1266,718,548,2806,6,28,124,2,4,258,598,29,79,23,140,0,271,176,2000,4849
DELHI UT,NORTH-WEST,2005,128,121,18,267,190,0,190,380,572,349,223,1144,9,19,124,543,2605,1546,1059,5905,13,62,184,2,6,333,621,23,138,53,324,0,538,21,5531,11019
DELHI UT,SOUTH,2005,67,63,6,136,87,0,87,174,231,169,62,462,4,34,93,287,4104,2274,1830,8626,8,80,362,3,4,214,705,19,151,36,188,0,394,34,4454,10529
DELHI UT,SOUTH-WEST,2005,47,51,10,108,71,0,71,142,114,89,25,228,2,13,51,378,1551,737,814,3546,9,29,177,2,11,112,533,12,86,20,114,0,232,193,2709,5762
DELHI UT,SPL CELL,2005,0,10,0,10,0,0,0,0,0,0,0,0,0,1,0,0,1,0,1,3,0,2,45,6,0,0,53,0,0,0,0,0,0,0,24,89
DELHI UT,WEST,2005,57,55,12,124,94,0,94,188,151,122,29,302,3,11,49,325,2370,1369,1001,5128,1,37,179,1,10,286,565,10,86,19,227,0,342,51,3183,7217
LAKSHADWEEP,LAKSHADWEEP,2005,1,0,0,1,0,0,0,0,0,0,0,0,0,0,0,2,7,0,7,16,6,0,0,0,0,4,10,0,0,0,0,0,0,0,22,42
PUDUCHERRY,PONDICHERRY,2005,19,24,8,51,6,0,6,12,6,3,3,12,1,0,5,67,466,235,231,1005,159,8,41,0,9,857,1298,4,60,26,6,0,96,224,2579,4575
ANDHRA PRADESH,ADILABAD,2006,99,88,14,201,64,0,64,128,96,71,25,192,10,0,17,228,390,64,326,1035,102,19,194,5,34,1447,2114,22,185,107,423,0,737,313,2265,6122
ANDHRA PRADESH,ANANTAPUR,2006,184,116,0,300,16,0,16,32,67,32,35,134,13,0,28,223,516,258,258,1296,176,8,86,18,41,1132,1857,16,187,11,189,0,403,396,1667,5090
ANDHRA PRADESH,CHITTOOR,2006,126,59,1,186,31,0,31,62,65,37,28,130,13,0,19,238,1037,194,843,2344,95,29,181,48,22,996,1934,18,123,190,249,0,580,563,2337,6440
ANDHRA PRADESH,CUDDAPAH,2006,98,0,3,101,25,0,25,50,68,51,17,136,4,0,15,157,377,84,293,930,148,19,184,6,32,985,1796,10,130,84,199,0,423,422,2332,5298
ANDHRA PRADESH,CYBERABAD,2006,193,92,11,296,60,0,60,120,166,90,76,332,13,1,86,1321,2339,642,1697,6099,49,156,1275,6,43,3871,6464,50,132,93,837,0,1112,1064,2368,14226
ANDHRA PRADESH,EAST GODAVARI,2006,85,116,2,203,41,0,41,82,81,28,53,162,5,0,29,520,1385,221,1164,3324,89,114,319,20,39,3456,4647,25,173,107,465,0,770,610,1375,9056
ANDHRA PRADESH,GUNTAKAL RLY.,2006,7,0,0,7,0,0,0,0,1,1,0,2,4,0,5,0,140,0,140,289,0,0,1,5,0,7,16,0,2,1,3,0,6,3,42,221
ANDHRA PRADESH,GUNTUR,2006,155,119,4,278,47,0,47,94,99,35,64,198,3,0,19,303,1349,139,1210,3023,139,73,507,26,73,1974,3297,15,281,236,427,0,959,505,2726,9080
ANDHRA PRADESH,HYDERABAD CITY,2006,125,116,6,247,93,0,93,186,143,77,66,286,12,0,99,1186,4408,1691,2717,10113,128,84,1777,13,26,4581,7191,29,189,108,1160,0,1486,582,2430,17295
ANDHRA PRADESH,KARIMNAGAR,2006,147,103,8,258,73,0,73,146,151,119,32,302,3,0,22,225,699,24,675,1648,117,32,481,15,45,1775,2883,47,371,195,698,0,1311,418,2516,8141
ANDHRA PRADESH,KHAMMAM,2006,134,59,2,195,44,0,44,88,91,58,33,182,11,0,19,218,581,98,483,1410,183,25,157,10,19,1202,2001,17,171,129,327,0,644,405,2157,5961
ANDHRA PRADESH,KRISHNA,2006,73,60,1,134,36,0,36,72,54,38,16,108,1,0,2,182,540,75,465,1265,32,16,126,12,60,2423,2999,9,168,74,296,0,547,330,772,5267
ANDHRA PRADESH,KURNOOL,2006,132,101,1,234,35,0,35,70,85,70,15,170,6,0,6,223,358,13,345,951,158,23,143,15,33,1268,2099,9,341,157,157,0,664,459,2113,5823
ANDHRA PRADESH,MAHABOOBNAGAR,2006,191,75,17,283,67,0,67,134,73,62,11,146,9,0,28,190,738,4,734,1703,125,32,169,3,53,2088,3088,33,201,9,287,0,530,618,1314,6320
ANDHRA PRADESH,MEDAK,2006,134,69,9,212,57,0,57,114,63,39,24,126,5,0,28,289,558,113,445,1438,72,23,218,6,72,2057,3030,33,107,59,276,0,475,582,885,5602
ANDHRA PRADESH,NALGONDA,2006,132,47,4,183,61,0,61,122,86,71,15,172,14,0,31,209,521,92,429,1296,208,20,247,5,73,1853,3044,40,246,126,395,0,807,638,2977,7933
ANDHRA PRADESH,NELLORE,2006,78,74,5,157,35,0,35,70,69,49,20,138,8,0,21,192,664,153,511,1549,97,25,152,8,68,2265,2980,10,192,137,294,0,633,365,1046,5805
ANDHRA PRADESH,NIZAMABAD,2006,110,83,11,204,36,0,36,72,71,46,25,142,17,1,43,329,593,121,472,1576,139,16,208,3,28,2127,2892,18,115,64,431,0,628,371,998,5812
ANDHRA PRADESH,PRAKASHAM,2006,92,111,3,206,23,0,23,46,83,68,15,166,5,0,30,279,559,102,457,1432,99,30,266,2,30,1807,2629,8,200,68,249,0,525,395,1437,5776
ANDHRA PRADESH,RANGA REDDY,2006,57,26,5,88,9,0,9,18,29,10,19,58,0,0,7,85,126,20,106,344,33,3,52,0,37,918,1211,15,50,9,67,0,141,168,332,2028
ANDHRA PRADESH,SECUNDERABAD RLY.,2006,11,0,0,11,2,0,2,4,3,1,2,6,2,0,8,0,222,0,222,454,0,0,7,10,0,8,28,2,0,0,1,0,3,3,32,311
ANDHRA PRADESH,SRIKAKULAM,2006,46,0,6,52,27,0,27,54,21,21,0,42,0,0,2,119,214,0,214,549,71,14,69,3,26,1184,1575,3,70,25,188,0,286,208,720,3016
ANDHRA PRADESH,VIJAYAWADA CITY,2006,43,50,6,99,21,1,20,42,86,60,26,172,3,0,34,392,1495,424,1071,3419,11,58,410,12,10,1619,2366,8,135,158,336,0,637,246,729,5862
ANDHRA PRADESH,VIJAYAWADA RLY.,2006,2,1,0,3,0,0,0,0,0,0,0,0,1,0,2,0,259,0,259,521,2,1,2,2,0,14,24,0,5,1,0,0,6,3,44,339
ANDHRA PRADESH,VISAKHA RURAL,2006,65,29,1,95,6,0,6,12,11,11,0,22,5,0,6,96,181,0,181,469,49,13,83,3,27,1613,2206,4,45,38,158,0,245,418,384,3235
ANDHRA PRADESH,VISAKHAPATNAM,2006,37,30,1,68,21,0,21,42,49,40,9,98,3,1,27,417,1121,356,765,2690,28,66,261,27,8,540,1177,10,62,30,397,0,499,247,2095,5478
ANDHRA PRADESH,VIZIANAGARAM,2006,35,17,0,52,16,0,16,32,20,16,4,40,6,0,8,89,171,1,170,445,50,10,57,5,8,549,897,5,69,22,171,0,267,218,1429,2955
ANDHRA PRADESH,WARANGAL,2006,116,89,2,207,50,0,50,100,103,78,25,206,1,0,19,319,718,188,530,1775,464,15,290,10,70,1743,3079,40,230,56,480,0,806,487,2577,7879
ANDHRA PRADESH,WEST GODAVARI,2006,59,130,0,189,53,0,53,106,96,50,46,192,1,0,19,275,1251,236,1015,2797,52,83,441,26,35,2444,3533,23,354,117,4,0,498,452,1623,7538
ARUNACHAL PRADESH,CHANGLANG,2006,3,3,1,7,4,0,4,8,4,4,0,8,3,0,4,21,29,0,29,86,0,5,6,1,1,20,37,0,0,0,2,0,2,4,42,153
ARUNACHAL PRADESH,DIBANG VALLEY,2006,2,5,0,7,2,0,2,4,2,2,0,4,4,0,6,14,18,4,14,60,1,1,2,1,1,30,39,0,1,0,0,0,1,3,42,135
ARUNACHAL PRADESH,K/KUMEY,2006,5,1,0,6,2,0,2,4,3,2,1,6,0,0,0,5,3,0,3,11,0,1,1,0,0,3,7,0,0,0,0,0,0,2,10,36
ARUNACHAL PRADESH,KAMENG EAST,2006,3,0,0,3,1,0,1,2,3,0,3,6,0,0,2,17,15,0,15,49,0,2,2,1,0,38,44,0,2,0,0,0,2,1,37,124
ARUNACHAL PRADESH,KAMENG WEST,2006,4,1,0,5,2,0,2,4,2,2,0,4,0,0,6,18,14,0,14,52,2,1,3,0,1,19,40,0,3,0,0,0,3,14,23,113
ARUNACHAL PRADESH,LOHIT,2006,9,0,0,9,3,0,3,6,10,8,2,20,4,0,12,15,38,3,35,107,0,1,0,0,3,26,44,0,3,0,1,0,4,14,34,173
ARUNACHAL PRADESH,PAPUM PARE,2006,10,11,1,22,5,0,5,10,20,10,10,40,7,0,18,73,138,53,85,374,1,30,7,3,1,84,143,0,14,1,2,0,17,17,113,556
ARUNACHAL PRADESH,SIANG EAST,2006,2,8,0,10,7,0,7,14,6,4,2,12,5,0,12,30,54,5,49,155,0,2,1,0,1,52,61,0,11,0,1,0,12,5,48,245
ARUNACHAL PRADESH,SIANG UPPER,2006,1,0,0,1,2,0,2,4,2,2,0,4,0,0,0,9,18,0,18,45,0,3,3,0,4,18,30,0,6,0,1,0,7,2,16,85
ARUNACHAL PRADESH,SIANG WEST,2006,6,1,1,8,0,0,0,0,7,7,0,14,1,0,3,17,55,9,46,131,0,5,6,2,5,48,70,0,13,1,4,0,18,4,71,250
ARUNACHAL PRADESH,SUBANSIRI LOWER,2006,4,1,0,5,3,0,3,6,5,3,2,10,1,0,6,5,22,0,22,56,2,2,1,0,1,22,32,0,3,0,0,0,3,4,29,111
ARUNACHAL PRADESH,SUBANSIRI UPPER,2006,4,0,0,4,2,0,2,4,4,4,0,8,0,0,3,12,20,0,20,55,0,5,6,0,2,28,45,0,6,0,3,0,9,4,53,152
ARUNACHAL PRADESH,TAWANG,2006,0,0,0,0,0,0,0,0,0,0,0,0,1,0,0,7,13,0,13,34,0,1,0,1,0,6,13,0,1,0,0,0,1,5,14,49
ARUNACHAL PRADESH,TIRAP,2006,7,2,0,9,4,0,4,8,7,3,4,14,2,0,2,12,11,0,11,38,0,2,0,0,0,19,22,1,0,0,0,0,1,1,29,99
ARUNACHAL PRADESH,UPPER DIBANG VALLEY,2006,0,0,0,0,0,0,0,0,0,0,0,0,0,0,0,2,3,0,3,8,0,0,0,0,0,2,4,0,0,0,0,0,0,2,4,13
ASSAM,BARPETA,2006,57,3,0,60,58,0,58,116,75,70,5,150,22,1,19,128,177,16,161,524,153,17,43,5,10,104,377,4,18,0,116,0,138,45,822,1877
ASSAM,BASKA,2006,25,5,0,30,14,0,14,28,24,14,10,48,3,0,7,10,25,3,22,70,2,5,2,0,7,92,131,1,26,0,12,0,39,23,77,360
ASSAM,BONGAIGAON,2006,15,1,0,16,13,0,13,26,19,19,0,38,8,0,9,39,58,0,58,172,30,3,1,4,9,47,111,0,20,0,28,0,48,17,331,652
ASSAM,C.I.D.,2006,0,0,0,0,0,0,0,0,1,0,1,2,0,0,0,0,1,0,1,2,0,0,6,0,0,0,6,0,0,0,0,0,0,0,10,18
ASSAM,CACHAR,2006,58,18,0,76,60,0,60,120,129,105,24,258,44,1,19,157,487,86,401,1195,252,29,25,4,46,217,965,5,181,0,306,0,492,392,1387,3817
ASSAM,CHIRANG,2006,39,4,4,47,30,0,30,60,26,26,0,52,5,1,2,47,72,0,72,199,77,12,13,4,11,68,218,0,34,0,58,0,92,33,72,612
ASSAM,DARRANG,2006,25,14,0,39,70,0,70,140,53,46,7,106,11,1,12,79,171,12,159,445,48,8,28,4,10,207,420,2,109,0,75,0,186,115,349,1391
ASSAM,DHEMAJI,2006,23,33,1,57,58,0,58,116,45,30,15,90,1,2,11,26,150,0,150,340,43,26,24,2,8,196,349,1,28,0,94,0,123,50,203,1025
ASSAM,DHUBRI,2006,40,37,0,77,115,0,115,230,118,94,24,236,20,1,20,98,174,13,161,487,564,52,95,7,24,373,1397,7,132,0,217,0,356,282,253,2629
ASSAM,DIBRUGARH,2006,104,25,4,133,53,0,53,106,65,56,9,130,4,0,41,106,419,24,395,989,59,16,46,2,33,391,747,4,48,0,44,0,96,200,405,2069
ASSAM,G.R.P.,2006,6,0,0,6,1,0,1,2,1,0,1,2,3,0,10,7,181,0,181,382,19,1,1,0,0,0,21,0,0,0,0,0,0,0,125,355
ASSAM,GOALPARA,2006,23,9,4,36,55,0,55,110,40,35,5,80,17,1,9,64,87,15,72,265,31,6,19,2,19,129,341,4,45,0,151,0,200,135,213,1063
ASSAM,GOLAGHAT,2006,72,24,4,100,63,0,63,126,91,70,21,182,3,0,25,72,277,28,249,654,8,21,32,5,18,353,512,1,44,0,76,0,121,75,236,1500
ASSAM,GUWAHATI CITY,2006,60,43,4,107,33,0,33,66,151,108,43,302,10,0,130,461,1822,786,1036,4245,169,75,200,13,37,374,1082,6,180,0,150,0,336,214,860,4992
ASSAM,HAILAKANDI,2006,18,1,1,20,23,0,23,46,56,48,8,112,6,0,2,52,99,4,95,258,145,1,19,2,19,32,237,1,9,0,49,0,59,19,394,948
ASSAM,JORHAT,2006,37,6,0,43,30,0,30,60,54,52,2,108,3,0,23,81,253,43,210,613,27,6,28,3,18,330,533,0,40,0,56,0,96,121,347,1463
ASSAM,KAMRUP,2006,43,3,0,46,37,0,37,74,80,60,20,160,24,1,25,107,137,30,107,431,64,18,34,4,8,17,204,10,58,0,115,0,183,59,361,1205
ASSAM,KARBI ANGLONG,2006,42,14,1,57,14,0,14,28,40,18,22,80,5,0,16,21,152,28,124,346,37,9,6,7,9,43,178,2,9,0,11,0,22,67,188,693
ASSAM,KARIMGANJ,2006,38,22,2,62,44,0,44,88,46,46,0,92,13,0,5,81,198,7,191,495,215,11,10,3,16,112,413,4,3,0,74,0,81,46,210,1153
ASSAM,KOKRAJHAR,2006,38,14,0,52,29,0,29,58,47,39,8,94,4,0,11,47,105,9,96,272,48,5,16,1,8,279,413,14,26,0,69,0,109,56,144,961
ASSAM,LAKHIMPUR,2006,43,4,0,47,79,0,79,158,96,93,3,192,1,0,3,70,196,4,192,466,125,18,67,8,15,328,677,6,38,0,110,0,154,116,319,1642
ASSAM,MORIGAON,2006,27,3,1,31,58,0,58,116,56,56,0,112,3,0,10,44,112,4,108,281,81,8,19,3,11,201,374,10,72,0,60,0,142,51,364,1194
ASSAM,N.C.HILLS,2006,18,11,0,29,4,0,4,8,14,9,5,28,5,1,2,10,27,1,26,72,11,0,2,0,2,23,53,0,3,0,24,0,27,15,49,221
ASSAM,NAGAON,2006,83,33,2,118,133,0,133,266,179,177,2,358,56,2,56,278,366,116,250,1124,260,54,51,5,62,515,1271,8,10,10,278,0,306,324,781,3546
ASSAM,NALBARI,2006,24,21,0,45,17,0,17,34,33,26,7,66,9,0,9,63,74,7,67,229,14,4,5,1,16,229,311,1,32,0,24,0,57,42,226,844
ASSAM,R.P.O.,2006,5,0,0,5,3,0,3,6,5,0,5,10,4,0,1,0,9,0,9,23,10,0,0,0,0,0,10,0,0,0,0,0,0,0,49,86
ASSAM,SIBSAGAR,2006,77,30,3,110,54,0,54,108,79,79,0,158,2,0,24,94,378,37,341,876,67,12,42,2,26,234,463,3,65,0,133,0,201,80,573,1978
ASSAM,SONITPUR,2006,88,16,1,105,56,0,56,112,108,105,3,216,8,0,25,148,390,40,350,961,96,18,43,5,15,178,535,7,7,0,155,0,169,180,612,2156
ASSAM,TINSUKIA,2006,48,13,0,61,23,0,23,46,57,38,19,114,11,0,13,486,1144,34,1110,2798,13,24,19,0,17,144,433,3,20,0,47,0,70,216,362,2660
ASSAM,UDALGURI,2006,31,7,0,38,17,0,17,34,37,25,12,74,14,0,5,35,79,15,64,212,16,2,9,2,14,74,166,1,33,0,16,0,50,49,122,563
BIHAR,ARARIA,2006,63,37,5,105,42,0,42,84,104,12,92,208,43,0,51,34,167,38,129,462,400,73,93,2,14,54,669,19,10,0,52,0,81,33,1315,2611
BIHAR,ARWAL,2006,22,53,0,75,0,0,0,0,9,4,5,18,2,0,7,14,56,0,56,135,45,0,9,4,9,160,228,9,20,0,5,0,34,1,137,562
BIHAR,AURANGABAD,2006,82,175,0,257,18,0,18,36,42,41,1,84,23,0,34,104,256,16,240,673,208,10,12,0,16,701,973,23,5,0,35,0,63,26,460,2230
BIHAR,BAGAHA,2006,45,12,4,61,27,0,27,54,44,12,32,88,9,1,8,13,156,6,150,343,73,5,35,0,10,303,439,5,7,0,13,0,25,13,373,1156
BIHAR,BANKA,2006,77,12,6,95,70,0,70,140,41,26,15,82,21,2,19,67,108,9,99,325,256,16,27,1,15,2,355,21,2,0,18,0,41,38,707,1526
BIHAR,BEGUSARAI,2006,111,225,5,341,23,0,23,46,69,41,28,138,13,1,62,78,315,21,294,784,245,25,133,3,20,465,1012,36,16,0,55,0,107,121,863,2884
BIHAR,BETTIAH,2006,74,105,5,184,49,0,49,98,110,35,75,220,15,0,42,86,314,45,269,771,238,38,122,6,39,1429,1917,23,24,29,40,0,116,45,225,3058
BIHAR,BHABHUA,2006,53,16,2,71,22,0,22,44,35,14,21,70,33,0,17,64,198,1,197,510,133,15,22,0,28,69,331,19,5,0,17,1,42,64,609,1422
BIHAR,BHAGALPUR,2006,119,94,7,220,43,0,43,86,83,44,39,166,14,0,50,157,426,90,336,1073,273,43,90,5,12,352,843,19,19,1,22,0,61,68,1655,3552
BIHAR,BHOJPUR,2006,127,235,0,362,17,0,17,34,57,34,23,114,32,0,57,85,314,71,243,802,254,14,37,0,57,524,982,26,18,0,81,0,125,96,1112,3143
BIHAR,BUXAR,2006,46,67,0,113,10,0,10,20,48,10,38,96,32,0,34,59,270,37,233,665,255,40,47,0,27,406,823,25,12,0,67,2,106,48,168,1663
BIHAR,DARBHANGA,2006,70,74,6,150,74,0,74,148,68,17,51,136,25,2,26,73,270,8,262,666,191,88,93,7,37,87,573,33,54,3,76,4,170,70,1804,3235
BIHAR,GAYA,2006,158,178,28,364,25,0,25,50,68,50,18,136,72,37,100,128,443,72,371,1223,326,59,39,7,92,498,1236,168,0,0,9,0,177,215,774,3424
BIHAR,GOPALGANJ,2006,72,46,10,128,23,0,23,46,55,34,21,110,25,2,40,77,206,31,175,556,188,22,42,0,3,55,384,32,16,0,94,0,142,74,1275,2357
BIHAR,JAMALPUR RLY.,2006,4,0,0,4,0,0,0,0,0,0,0,0,7,1,5,0,100,11,89,213,4,0,1,0,0,0,6,0,0,0,0,0,0,1,45,168
BIHAR,JAMUI,2006,69,82,12,163,29,0,29,58,28,14,14,56,25,4,61,42,112,5,107,356,166,13,18,0,19,179,399,15,7,2,19,0,43,4,650,1556
BIHAR,JEHANABAD,2006,39,14,1,54,10,0,10,20,20,1,19,40,16,0,15,22,96,13,83,245,71,11,12,0,6,22,135,15,5,0,5,0,25,13,694,1087
BIHAR,KATIHAR,2006,59,46,3,108,82,0,82,164,57,31,26,114,8,1,10,50,150,20,130,369,114,27,37,2,14,245,473,35,33,6,29,0,103,34,715,1757
BIHAR,KATIHAR RLY.,2006,10,0,0,10,3,0,3,6,6,4,2,12,9,1,8,7,278,5,273,581,10,2,16,0,0,0,28,1,1,0,0,0,2,0,151,503
BIHAR,KHAGARIA,2006,53,148,1,202,22,0,22,44,47,0,47,94,15,0,31,10,130,6,124,316,224,8,6,0,5,190,566,15,6,0,12,0,33,133,656,1712
BIHAR,KISHANGANJ,2006,20,3,1,24,81,0,81,162,84,69,15,168,8,0,9,39,79,19,60,214,110,0,44,1,0,90,271,9,0,0,57,0,66,26,425,1086
BIHAR,LAKHISARAI,2006,48,111,6,165,12,0,12,24,30,17,13,60,6,0,14,22,65,6,59,172,67,8,18,0,8,70,221,14,10,0,5,0,29,50,407,971
BIHAR,MADHEPURA,2006,60,24,2,86,10,0,10,20,16,10,6,32,15,1,41,18,111,11,100,297,123,7,11,0,15,102,283,12,4,0,7,0,23,25,568,1172
BIHAR,MADHUBANI,2006,62,89,10,161,58,0,58,116,76,12,64,152,50,23,31,122,94,0,94,414,358,4,12,0,0,0,374,10,14,0,14,0,38,0,169,1196
BIHAR,MOTIHARI,2006,119,142,13,274,22,0,22,44,100,38,62,200,42,6,56,162,436,45,391,1138,368,77,64,0,25,985,1714,51,11,0,37,5,104,195,1330,4246
BIHAR,MUNGER,2006,73,35,1,109,13,0,13,26,53,0,53,106,19,1,47,44,197,29,168,505,208,16,56,2,10,284,602,7,10,0,40,0,57,26,704,1846
BIHAR,MUZAFFARPUR,2006,134,24,6,164,48,0,48,96,148,23,125,296,48,4,104,283,930,12,918,2299,413,9,203,5,33,673,1396,65,7,0,75,0,147,60,2212,5484
BIHAR,MUZAFFARPUR RLY.,2006,20,3,1,24,3,0,3,6,14,0,14,28,16,2,23,13,352,22,330,758,12,1,22,1,0,21,58,0,1,0,3,0,4,1,200,709
BIHAR,NALANDA,2006,143,91,7,241,31,0,31,62,76,35,41,152,30,2,57,79,348,14,334,864,184,52,58,7,14,813,1214,63,45,0,90,0,198,86,697,2973
BIHAR,NAUGACHIA,2006,36,13,0,49,8,0,8,16,12,4,8,24,4,0,15,17,43,5,38,122,118,0,11,0,0,10,227,1,0,0,17,0,18,88,521,914
BIHAR,NAWADAH,2006,80,131,3,214,20,0,20,40,36,15,21,72,11,1,24,68,112,5,107,328,170,16,35,0,15,239,551,24,9,2,18,2,55,76,474,1566
BIHAR,PATNA,2006,338,88,83,509,54,0,54,108,309,84,225,618,87,13,535,665,1558,978,580,4416,440,4,265,7,8,53,1052,54,13,2,239,0,308,275,7646,12736
BIHAR,PATNA RLY.,2006,16,15,3,34,1,0,1,2,7,3,4,14,17,2,30,1,621,26,595,1292,7,2,21,3,0,0,33,3,7,0,1,0,11,0,215,972
BIHAR,PURNEA,2006,57,23,5,85,41,0,41,82,44,27,17,88,21,1,70,60,229,31,198,610,136,6,18,0,7,9,248,14,5,0,13,0,32,72,1572,2403
BIHAR,ROHTAS,2006,102,88,5,195,17,0,17,34,45,20,25,90,16,1,37,137,282,18,264,755,136,18,19,8,30,744,1209,36,9,0,25,0,70,254,1029,3038
BIHAR,SAHARSA,2006,44,97,2,143,33,0,33,66,41,4,37,82,1,1,35,50,106,9,97,299,240,61,71,1,15,138,539,12,21,0,24,0,57,13,781,1787
BIHAR,SAMASTIPUR,2006,102,195,37,334,53,0,53,106,109,11,98,218,22,19,50,83,371,45,326,916,293,39,39,0,41,295,873,47,11,5,33,27,123,166,1296,3333
BIHAR,SARAN,2006,134,290,18,442,48,0,48,96,104,70,34,208,41,2,80,135,318,50,268,894,228,27,126,1,32,1324,1836,74,49,0,102,0,225,98,295,3526
BIHAR,SHEIKHPURA,2006,24,8,4,36,5,0,5,10,9,4,5,18,7,0,16,12,68,1,67,171,75,2,22,0,3,8,123,11,4,0,18,0,33,13,281,590
BIHAR,SHEOHAR,2006,16,28,1,45,2,0,2,4,19,13,6,38,3,0,3,8,36,1,35,86,78,10,13,0,4,32,146,3,2,0,18,0,23,9,203,488
BIHAR,SITAMARHI,2006,45,30,4,79,27,0,27,54,61,45,16,122,34,2,33,85,241,28,213,636,190,53,25,4,23,286,609,13,19,2,76,1,111,28,1266,2548
BIHAR,SIWAN,2006,93,72,8,173,18,0,18,36,103,88,15,206,36,3,99,89,224,49,175,675,173,35,61,15,20,243,610,41,12,1,75,0,129,63,954,2438
BIHAR,SUPAUL,2006,31,45,2,78,24,0,24,48,31,19,12,62,7,1,24,26,90,13,77,238,175,28,14,0,4,30,267,8,0,0,10,0,18,16,736,1302
BIHAR,VAISHALI,2006,99,39,9,147,14,0,14,28,101,49,52,202,21,3,59,143,476,101,375,1178,283,70,52,5,55,484,1072,77,7,0,43,0,127,123,1572,3735
CHHATTISGARH,BALRAMPUR,2006,38,23,0,61,45,0,45,90,1,1,0,2,10,1,16,41,21,2,19,110,19,1,6,0,3,170,219,0,40,0,9,0,49,20,139,603
CHHATTISGARH,BILASPUR,2006,95,62,1,158,68,0,68,136,27,27,0,54,5,0,55,492,701,265,436,1954,147,11,52,2,25,1301,1765,23,192,13,120,0,348,227,1682,5301
CHHATTISGARH,BIZAPUR,2006,139,181,1,321,6,0,6,12,7,0,7,14,43,2,2,3,7,0,7,64,19,1,7,0,11,17,64,0,3,0,1,0,4,9,63,522
CHHATTISGARH,DANTEWARA,2006,88,85,0,173,14,0,14,28,16,9,7,32,17,0,1,65,55,5,50,193,28,6,5,0,18,47,136,1,11,1,4,0,17,32,290,784
CHHATTISGARH,DHAMTARI,2006,21,11,0,32,27,0,27,54,4,4,0,8,0,0,5,116,129,20,109,379,32,1,18,3,6,103,248,0,62,10,16,0,88,85,814,1463
CHHATTISGARH,DURG,2006,71,54,6,131,108,0,108,216,33,18,15,66,5,1,63,484,880,290,590,2313,51,21,116,3,29,753,1294,19,241,27,102,0,389,321,3550,6938
CHHATTISGARH,GRP RAIPUR,2006,4,1,0,5,1,0,1,2,0,0,0,0,1,0,6,9,230,11,219,476,1,1,0,0,0,19,22,0,3,2,3,0,8,1,104,386
CHHATTISGARH,JAGDALPUR,2006,62,38,0,100,71,0,71,142,14,13,1,28,5,5,19,191,156,33,123,532,61,1,12,0,8,220,414,4,55,0,18,0,77,112,1145,2197
CHHATTISGARH,JANJGIR,2006,47,43,0,90,40,0,40,80,12,9,3,24,1,1,22,232,255,44,211,766,104,7,29,3,8,243,509,10,109,10,90,0,219,115,1470,2851
CHHATTISGARH,JASHPUR,2006,47,10,1,58,62,0,62,124,8,7,1,16,6,1,32,60,66,24,42,231,20,3,12,3,12,148,261,1,46,3,11,0,61,63,359,974
CHHATTISGARH,KABIRDHAM,2006,14,10,0,24,36,0,36,72,1,0,1,2,0,0,3,75,88,21,67,254,15,0,4,0,6,408,474,1,67,8,35,0,111,41,359,1171
CHHATTISGARH,KANKER,2006,36,40,1,77,23,0,23,46,9,6,3,18,9,1,13,65,84,15,69,256,33,0,5,4,11,60,176,2,20,5,13,0,40,63,520,1017
CHHATTISGARH,KORBA,2006,43,17,0,60,40,0,40,80,5,4,1,10,8,4,25,145,297,110,187,776,44,1,29,2,5,480,708,5,86,6,27,0,124,147,895,2311
CHHATTISGARH,KORIYA,2006,35,27,0,62,51,0,51,102,7,5,2,14,11,0,12,126,103,17,86,355,14,2,12,0,15,432,537,0,64,2,27,0,93,62,366,1368
CHHATTISGARH,MAHASAMUND,2006,21,16,0,37,32,0,32,64,3,2,1,6,3,1,12,131,198,51,147,543,21,1,16,1,7,202,361,2,64,3,20,0,89,113,650,1517
CHHATTISGARH,NARAYANPUR,2006,23,43,0,66,2,0,2,4,5,0,5,10,1,0,1,3,5,0,5,15,0,0,0,0,6,21,30,0,3,0,0,0,3,3,40,156
CHHATTISGARH,RAIGARH,2006,54,21,0,75,38,0,38,76,7,7,0,14,14,3,23,213,358,83,275,969,67,15,17,1,18,348,618,4,92,9,22,0,127,152,893,2369
CHHATTISGARH,RAIPUR,2006,106,66,2,174,130,0,130,260,54,42,12,108,6,0,48,662,1155,502,653,3026,126,44,97,9,39,1374,2132,25,228,34,98,0,385,443,3186,7932
CHHATTISGARH,RAJNANDGAON,2006,50,31,1,82,69,0,69,138,10,9,1,20,2,0,19,168,231,71,160,651,24,11,24,1,13,96,273,5,83,7,40,1,136,104,1579,2569
CHHATTISGARH,SARGUJA,2006,56,26,2,84,75,0,75,150,11,11,0,22,5,3,38,114,148,49,99,456,37,6,27,0,7,100,239,0,72,1,29,0,102,62,747,1566
CHHATTISGARH,SURAJPUR,2006,48,20,0,68,57,0,57,114,5,4,1,10,8,1,24,112,95,10,85,335,42,4,19,1,15,180,325,1,57,2,32,0,92,64,395,1182
GOA,NORTH GOA,2006,24,8,1,33,8,0,8,16,9,5,4,18,3,0,10,151,288,133,155,740,27,22,28,8,9,98,316,0,8,3,8,0,19,124,362,1199
GOA,SOUTH GOA,2006,15,9,0,24,13,0,13,26,7,5,2,14,4,0,7,101,206,90,116,524,36,13,27,1,29,72,287,0,10,4,6,0,20,109,336,1005
GUJARAT,AHMEDABAD COMMR.,2006,99,60,7,166,46,0,46,92,182,146,36,364,23,3,172,802,5388,2317,3071,11776,128,266,297,10,5,1371,2304,4,72,22,956,0,1054,227,9098,19238
GUJARAT,AHMEDABAD RURAL,2006,47,4,1,52,10,0,10,20,28,27,1,56,9,1,28,82,273,55,218,666,39,40,14,2,15,285,687,0,31,0,92,0,123,292,1727,3020
GUJARAT,AHWA-DANG,2006,7,1,0,8,3,0,3,6,0,0,0,0,2,0,1,2,16,0,16,37,11,0,1,0,2,22,52,0,6,0,11,0,17,16,179,280
GUJARAT,AMRELI,2006,20,11,3,34,15,0,15,30,31,30,1,62,2,0,14,109,169,39,130,463,30,17,17,10,7,312,489,3,20,0,112,0,135,96,1434,2432
GUJARAT,ANAND,2006,26,6,1,33,14,0,14,28,33,30,3,66,7,0,11,114,367,148,219,866,13,62,12,6,14,295,605,0,30,5,141,0,176,203,1693,3053
GUJARAT,BHARUCH,2006,37,9,1,47,7,0,7,14,7,6,1,14,10,0,8,121,312,107,205,763,18,49,13,6,15,269,580,0,8,0,66,0,74,210,1452,2618
GUJARAT,BHAVNAGAR,2006,59,40,1,100,26,0,26,52,128,116,12,256,47,0,170,457,1347,331,1016,3368,155,101,188,23,30,99,603,7,101,61,285,0,454,7,5125,8457
GUJARAT,DAHOD,2006,30,18,0,48,0,0,0,0,21,19,2,42,15,1,23,50,82,37,45,253,27,6,8,1,14,188,244,0,11,0,39,0,50,0,1191,1725
GUJARAT,GANDHINAGAR,2006,23,13,0,36,14,0,14,28,24,20,4,48,6,0,17,102,403,129,274,931,39,5,36,10,6,234,517,0,17,6,119,0,142,187,1580,2841
GUJARAT,HIMATNAGAR,2006,35,4,2,41,11,0,11,22,32,32,0,64,6,1,13,115,211,53,158,557,41,29,26,4,12,235,583,0,25,0,151,0,176,236,5336,6525
GUJARAT,JAMNAGAR,2006,29,11,0,40,13,0,13,26,21,18,3,42,5,0,22,180,361,152,209,929,37,22,23,5,11,386,488,0,14,11,206,0,231,4,2542,3903
GUJARAT,JUNAGADH,2006,54,19,0,73,6,0,6,12,52,44,8,104,15,0,34,185,470,143,327,1174,80,60,33,13,12,495,892,3,38,4,415,0,460,199,2496,4683
GUJARAT,KHEDA NORTH,2006,37,9,0,46,17,0,17,34,36,34,2,72,12,0,9,148,333,86,247,835,47,34,45,5,12,315,684,0,22,0,204,0,226,226,3039,4550
GUJARAT,KUTCH,2006,39,23,0,62,19,0,19,38,52,41,11,104,18,0,55,315,532,193,339,1452,63,56,48,3,18,405,864,3,37,0,343,0,383,271,3707,6007
GUJARAT,MEHSANA,2006,24,22,0,46,6,0,6,12,41,36,5,82,14,0,52,274,617,115,502,1574,76,36,70,4,12,491,838,3,28,0,219,0,250,149,2511,4649
GUJARAT,NARMADA,2006,11,8,0,19,2,0,2,4,6,6,0,12,2,0,1,25,30,10,20,88,10,4,3,1,4,100,169,0,6,0,10,0,16,47,373,643
GUJARAT,NAVSARI,2006,16,6,0,22,2,0,2,4,8,7,1,16,2,0,5,76,106,50,56,295,17,32,12,3,2,68,134,0,4,0,38,0,42,0,780,1177
GUJARAT,PALANPUR,2006,42,18,0,60,22,0,22,44,37,35,2,74,7,0,21,150,419,39,380,1016,54,28,15,4,11,1292,1584,1,43,0,188,0,232,180,2486,5018
GUJARAT,PANCHMAHAL,2006,62,13,0,75,6,0,6,12,44,42,2,88,5,0,19,115,205,81,124,549,37,27,24,2,20,300,410,0,24,0,101,0,125,0,2417,3421
GUJARAT,PATAN,2006,14,9,1,24,10,0,10,20,13,11,2,26,9,0,6,103,394,52,342,906,54,23,16,1,6,311,495,0,25,0,147,0,172,84,1453,2679
GUJARAT,PORBANDAR,2006,9,5,0,14,2,0,2,4,7,6,1,14,0,0,6,42,74,20,54,196,5,8,6,2,3,112,181,1,1,0,45,0,47,45,581,954
GUJARAT,RAJKOT COMMR.,2006,29,15,0,44,4,0,4,8,26,18,8,52,1,0,26,260,718,424,294,1723,46,12,39,18,3,369,581,1,5,12,165,0,183,94,1646,3489
GUJARAT,RAJKOT RURAL,2006,42,20,3,65,21,0,21,42,37,33,4,74,10,0,31,259,387,129,258,1074,41,106,17,10,16,427,915,1,34,5,300,0,340,298,2102,4167
GUJARAT,SURAT COMMR.,2006,103,30,1,134,31,0,31,62,130,86,44,260,15,2,72,500,2206,1457,749,5001,145,55,258,24,10,759,1587,22,46,6,249,0,323,336,3659,8659
GUJARAT,SURAT RURAL,2006,71,7,0,78,11,0,11,22,11,8,3,22,9,2,15,75,170,78,92,441,21,19,21,0,6,275,727,0,11,0,40,0,51,385,1217,2366
GUJARAT,SURENDRANAGAR,2006,30,15,0,45,17,0,17,34,23,20,3,46,6,0,20,118,259,54,205,662,55,47,8,3,6,381,691,1,34,2,81,0,118,191,1451,2748
GUJARAT,VADODARA COMMR.,2006,32,34,2,68,6,0,6,12,54,42,12,108,8,0,35,482,1319,678,641,3163,147,30,199,14,31,316,871,0,17,2,181,0,200,134,2629,5672
GUJARAT,VADODARA RURAL,2006,82,19,0,101,10,0,10,20,20,16,4,40,7,0,13,81,171,49,122,443,37,40,14,2,14,354,677,0,10,1,39,0,50,216,1486,2616
GUJARAT,VALSAD,2006,43,17,0,60,1,0,1,2,18,12,6,36,14,2,13,167,268,120,148,732,41,28,22,10,4,173,278,0,10,0,32,0,42,0,1203,2066
GUJARAT,W.RLY,2006,13,5,1,19,2,0,2,4,6,4,2,12,4,0,58,21,868,42,826,1819,20,4,44,0,0,46,120,0,6,1,2,0,9,6,209,1316
HARYANA,AMBALA,2006,39,12,2,53,19,0,19,38,22,16,6,44,7,6,18,308,438,207,231,1215,3,55,141,5,8,264,481,9,26,27,174,0,236,5,1078,2666
HARYANA,BHIWANI,2006,45,29,0,74,35,0,35,70,34,26,8,68,9,4,21,180,406,215,191,1026,159,23,93,1,17,303,603,19,38,8,100,0,165,7,988,2519
HARYANA,FARIDABAD,2006,58,45,7,110,40,0,40,80,86,66,20,172,7,30,36,369,1241,902,339,2924,138,106,45,2,11,244,558,14,35,144,146,0,339,12,1866,4682
HARYANA,FATEHABAD,2006,23,15,4,42,18,0,18,36,20,5,15,40,0,1,7,122,171,71,100,472,22,31,78,2,6,229,373,6,17,7,83,0,113,5,563,1430
HARYANA,GRP,2006,20,4,1,25,1,0,1,2,1,1,0,2,3,0,6,0,267,0,267,543,7,4,10,0,0,15,50,6,6,113,0,0,125,14,381,859
HARYANA,GURGAON,2006,93,63,4,160,30,0,30,60,70,51,19,140,22,41,69,560,2090,1601,489,4872,99,59,168,6,11,163,518,20,32,56,89,0,197,12,1771,5528
HARYANA,HISSAR,2006,58,58,3,119,23,0,23,46,31,26,5,62,1,9,21,223,517,281,236,1288,51,20,109,0,7,416,605,17,19,0,158,0,194,2,1374,3117
HARYANA,JHAJJAR,2006,51,34,0,85,15,0,15,30,10,9,1,20,0,1,19,98,185,101,84,488,45,23,33,0,5,162,451,16,14,9,58,0,97,183,296,1257
HARYANA,JIND,2006,42,27,6,75,32,0,32,64,15,7,8,30,2,11,6,107,255,155,100,636,103,40,38,1,7,161,351,13,17,12,53,0,95,1,685,1634
HARYANA,KAITHAL,2006,24,11,1,36,25,0,25,50,14,6,8,28,4,5,18,127,280,102,178,714,0,49,18,1,5,196,272,9,14,0,149,0,172,3,601,1554
HARYANA,KARNAL,2006,32,29,6,67,51,0,51,102,40,23,17,80,6,11,21,238,703,376,327,1682,60,22,133,3,15,790,1284,13,35,1,214,0,263,261,459,3143
HARYANA,KURUKSHETRA,2006,24,19,4,47,34,0,34,68,24,15,9,48,4,2,15,213,533,281,252,1300,3,78,68,0,10,226,390,5,10,37,116,0,168,5,1070,2500
HARYANA,MAHENDRAGARH,2006,28,12,2,42,17,0,17,34,26,16,10,52,7,0,7,95,181,75,106,471,90,18,16,0,9,147,285,10,32,0,41,0,83,5,1110,1853
HARYANA,MEWAT,2006,16,26,3,45,35,0,35,70,14,4,10,28,4,35,6,27,191,89,102,454,91,9,43,2,7,176,330,8,24,7,124,0,163,2,719,1569
HARYANA,PALWAL,2006,33,24,1,58,26,0,26,52,23,17,6,46,4,5,27,73,233,159,74,575,69,20,52,1,2,143,441,5,21,0,47,0,73,154,560,1523
HARYANA,PANCHKULA,2006,14,6,0,20,10,0,10,20,15,13,2,30,0,0,9,119,222,110,112,572,2,6,23,1,0,45,77,2,13,0,63,0,78,0,800,1350
HARYANA,PANIPAT,2006,46,25,6,77,65,0,65,130,46,29,17,92,4,31,17,210,667,471,196,1596,70,84,20,4,0,198,598,19,18,13,104,0,154,222,631,2500
HARYANA,REWARI,2006,32,26,2,60,21,0,21,42,15,9,6,30,6,7,23,164,278,144,134,756,52,18,40,2,8,159,286,4,23,0,51,0,78,7,1065,2003
HARYANA,ROHTAK,2006,62,36,0,98,34,0,34,68,23,17,6,46,3,7,19,243,471,306,165,1214,43,29,110,3,2,189,579,22,13,29,80,0,144,203,605,2226
HARYANA,SIRSA,2006,37,28,2,67,18,0,18,36,11,2,9,22,4,5,13,171,263,121,142,719,23,27,38,0,6,348,448,4,14,0,129,0,147,6,700,1847
HARYANA,SONIPAT,2006,69,39,3,111,31,0,31,62,67,49,18,134,7,13,27,185,546,266,280,1324,12,12,107,1,14,331,718,26,46,28,165,0,265,241,970,2940
HARYANA,YAMUNANAGAR,2006,27,17,2,46,28,0,28,56,28,24,4,56,0,0,5,169,380,267,113,934,0,17,41,0,6,230,294,8,19,0,110,0,137,0,722,1809
HIMACHAL PRADESH,BILASPUR,2006,6,9,1,16,11,0,11,22,4,2,2,8,1,0,3,42,60,10,50,166,35,12,7,1,19,46,157,0,27,3,23,0,53,37,845,1192
HIMACHAL PRADESH,CHAMBA,2006,14,4,0,18,4,0,4,8,12,11,1,24,0,0,0,108,39,10,29,186,9,3,1,0,6,48,104,0,18,0,3,0,21,37,286,592
HIMACHAL PRADESH,G.R.P.,2006,0,0,0,0,0,0,0,0,0,0,0,0,0,0,1,1,0,0,0,2,0,0,0,0,0,0,0,0,0,0,0,0,0,0,4,6
HIMACHAL PRADESH,HAMIRPUR,2006,10,4,1,15,1,0,1,2,4,4,0,8,0,0,0,55,48,8,40,151,28,5,18,0,15,239,326,0,18,8,34,0,60,21,579,1088
HIMACHAL PRADESH,KANGRA,2006,19,19,3,41,12,0,12,24,25,22,3,50,2,0,1,91,113,33,80,320,116,11,31,2,21,161,348,0,34,9,57,0,100,6,1395,2128
HIMACHAL PRADESH,KINNAUR,2006,2,0,0,2,2,0,2,4,5,4,1,10,0,0,0,27,12,1,11,51,21,1,0,0,2,12,57,0,2,1,3,0,6,21,120,231
HIMACHAL PRADESH,KULLU,2006,5,4,3,12,10,0,10,20,9,9,0,18,0,0,7,57,62,7,55,188,55,4,6,0,8,46,170,0,24,0,16,0,40,51,469,836
HIMACHAL PRADESH,LAHAUL-SPITI,2006,1,0,0,1,0,0,0,0,1,1,0,2,0,0,1,2,2,0,2,7,1,2,0,0,2,5,14,0,0,0,1,0,1,4,36,58
HIMACHAL PRADESH,MANDI,2006,12,6,0,18,18,0,18,36,12,7,5,24,0,0,3,61,78,20,58,220,37,54,7,1,13,163,341,0,51,4,27,0,82,66,1279,1892
HIMACHAL PRADESH,SHIMLA,2006,16,13,0,29,34,0,34,68,28,26,2,56,2,0,11,134,176,38,138,499,88,20,20,0,15,74,297,0,39,0,30,0,69,80,1217,1997
HIMACHAL PRADESH,SIRMAUR,2006,10,9,1,20,3,0,3,6,6,4,2,12,1,0,0,32,63,22,41,159,73,3,17,0,5,51,204,1,23,3,26,0,53,55,384,766
HIMACHAL PRADESH,SOLAN,2006,10,3,4,17,9,0,9,18,18,13,5,36,1,0,2,80,87,42,45,257,75,15,14,0,5,318,496,1,28,2,21,0,52,69,680,1442
HIMACHAL PRADESH,UNA,2006,6,7,7,20,9,0,9,18,6,6,0,12,0,0,0,64,72,23,49,208,28,7,8,0,4,98,197,1,11,1,18,0,31,52,466,865
JAMMU & KASHMIR,ANANTNAG,2006,23,29,3,55,22,0,22,44,88,81,7,176,1,0,12,165,117,24,93,412,103,8,34,5,8,44,212,0,34,60,0,0,94,10,745,1511
JAMMU & KASHMIR,AWANTIPORA,2006,19,5,0,24,9,0,9,18,12,12,0,24,1,0,8,29,15,7,8,68,12,3,9,1,0,0,25,0,25,3,0,0,28,0,183,334
JAMMU & KASHMIR,BARAMULLA,2006,63,115,3,181,15,0,15,30,111,101,10,222,1,0,10,140,125,16,109,401,120,3,18,4,14,11,170,0,153,21,1,0,175,0,738,1666
JAMMU & KASHMIR,BORDER DISTRICT,2006,9,15,0,24,6,0,6,12,12,8,4,24,0,0,0,16,32,6,26,80,21,3,5,0,2,16,47,1,3,7,4,0,15,0,403,555
JAMMU & KASHMIR,BUDGAM,2006,12,31,3,46,5,0,5,10,54,53,1,108,0,0,8,82,184,24,160,458,129,2,11,0,5,1,166,0,121,14,1,0,136,18,472,1153
JAMMU & KASHMIR,CRIME JAMMU,2006,3,0,0,3,0,0,0,0,0,0,0,0,0,0,0,0,0,0,0,0,0,0,22,0,0,0,22,0,0,0,0,0,0,0,1,26
JAMMU & KASHMIR,CRIME SRINAGAR,2006,0,0,0,0,0,0,0,0,0,0,0,0,0,0,0,0,0,0,0,0,0,9,46,0,0,0,55,0,0,0,0,0,0,0,0,55
JAMMU & KASHMIR,DODA,2006,65,94,3,162,10,0,10,20,36,31,5,72,1,0,5,46,47,3,44,146,17,11,7,0,16,29,84,0,16,7,8,0,31,4,466,888
JAMMU & KASHMIR,GANDERBAL,2006,20,7,0,27,4,0,4,8,35,34,1,70,0,0,0,50,47,4,43,144,65,6,6,4,10,2,114,0,36,5,0,0,41,21,192,510
JAMMU & KASHMIR,HANDWARA,2006,17,29,10,56,8,0,8,16,27,23,4,54,0,0,4,20,37,2,35,98,46,0,13,0,9,8,76,0,73,6,2,0,81,0,184,493
JAMMU & KASHMIR,JAMMU,2006,25,51,10,86,21,0,21,42,58,52,6,116,1,0,0,170,382,164,218,935,64,23,83,2,12,27,302,3,28,59,41,0,131,91,2082,3233
JAMMU & KASHMIR,KARGIL,2006,1,0,0,1,0,0,0,0,4,4,0,8,0,0,0,9,7,0,7,23,3,0,2,0,1,0,15,0,2,0,1,0,3,9,68,107
JAMMU & KASHMIR,KATHUA,2006,6,22,1,29,12,0,12,24,27,26,1,54,1,0,3,54,56,16,40,170,31,5,26,0,7,24,95,3,17,7,12,0,39,2,790,1106
JAMMU & KASHMIR,KULGAM,2006,36,12,1,49,14,0,14,28,47,46,1,94,0,0,11,52,65,15,50,193,57,7,15,0,9,13,121,0,44,11,1,0,56,20,248,663
JAMMU & KASHMIR,KUPWARA,2006,16,56,1,73,11,0,11,22,31,27,4,62,1,0,0,21,41,3,38,104,53,7,19,5,11,3,98,0,77,11,2,0,90,0,263,629
JAMMU & KASHMIR,LEH,2006,2,5,1,8,3,0,3,6,5,5,0,10,0,0,0,16,5,1,4,26,4,1,3,0,0,2,10,0,5,0,0,0,5,0,148,200
JAMMU & KASHMIR,POONCH,2006,30,65,0,95,21,0,21,42,21,20,1,42,0,0,0,26,47,0,47,120,75,2,4,0,13,45,140,0,13,3,12,0,28,1,341,719
JAMMU & KASHMIR,PULWAMA,2006,24,61,0,85,9,0,9,18,57,50,7,114,1,0,24,73,124,15,109,346,193,4,20,5,12,75,320,0,37,7,1,0,45,11,208,946
JAMMU & KASHMIR,RAILWAYS,2006,0,0,0,0,0,0,0,0,0,0,0,0,0,0,0,0,10,0,10,20,0,0,0,0,1,0,2,0,0,0,0,0,0,1,8,20
JAMMU & KASHMIR,RAJOURI,2006,20,41,0,61,26,0,26,52,37,33,4,74,0,0,1,65,60,7,53,186,35,5,18,0,36,31,125,3,34,13,33,0,83,0,915,1373
JAMMU & KASHMIR,RAMBAN,2006,18,33,3,54,14,0,14,28,5,4,1,10,0,0,0,29,42,4,38,113,3,1,6,0,8,21,43,0,6,4,0,0,10,4,514,711
JAMMU & KASHMIR,REASI,2006,19,39,0,58,7,0,7,14,10,10,0,20,0,0,2,11,14,1,13,41,0,3,6,0,3,1,15,0,9,3,3,0,15,2,186,318
JAMMU & KASHMIR,SRINAGAR,2006,49,122,1,172,22,0,22,44,102,93,9,204,1,0,23,223,426,235,191,1099,141,14,78,9,22,14,305,0,208,95,10,0,313,27,1042,2629
JAMMU & KASHMIR,UDHAMPUR,2006,10,22,0,32,11,0,11,22,10,10,0,20,1,0,1,54,54,7,47,164,25,6,12,0,4,9,57,0,19,11,3,0,33,1,689,942
JHARKHAND,BOKARO,2006,38,7,0,45,24,0,24,48,49,43,6,98,34,0,38,109,499,81,418,1179,144,19,29,0,3,0,195,16,7,0,64,0,87,0,1242,2322
JHARKHAND,CHAIBASA,2006,129,35,1,165,53,0,53,106,12,8,4,24,16,0,33,33,147,0,147,376,38,2,24,0,2,54,121,7,7,0,17,0,31,1,421,1032
JHARKHAND,CHATRA,2006,30,0,0,30,13,0,13,26,11,11,0,22,18,0,22,22,63,13,50,188,82,0,9,0,2,0,93,16,3,0,7,0,26,0,474,772
JHARKHAND,DEOGHAR,2006,33,6,4,43,33,0,33,66,8,4,4,16,9,0,19,109,199,31,168,535,164,14,13,0,1,101,335,19,4,14,27,0,64,42,961,1780
JHARKHAND,DHANBAD,2006,86,64,16,166,37,0,37,74,65,58,7,130,50,5,61,158,771,175,596,1816,265,21,71,2,10,401,779,32,28,14,31,0,105,9,1510,3707
JHARKHAND,DHANBAD RLY.,2006,11,0,0,11,0,0,0,0,0,0,0,0,27,2,23,4,127,9,118,310,7,0,4,0,0,0,11,4,3,0,1,0,8,0,87,300
JHARKHAND,DUMKA,2006,50,18,4,72,55,0,55,110,28,27,1,56,9,0,9,62,181,57,124,442,110,14,20,0,6,179,437,7,46,0,30,1,84,108,585,1522
JHARKHAND,GARHWA,2006,49,5,4,58,26,0,26,52,14,7,7,28,16,2,17,32,87,5,82,241,174,13,20,0,2,1,227,16,0,0,13,0,29,17,660,1168
JHARKHAND,GIRIDIH,2006,56,145,1,202,56,0,56,112,35,18,17,70,59,2,34,100,327,25,302,849,287,10,47,0,5,72,528,39,65,0,68,0,172,107,1174,2689
JHARKHAND,GODDA,2006,40,79,5,124,33,0,33,66,25,0,25,50,7,0,14,50,140,0,140,351,137,15,15,0,15,61,243,8,16,0,47,0,71,0,524,1231
JHARKHAND,GUMLA,2006,126,58,3,187,55,0,55,110,26,23,3,52,18,1,25,16,89,16,73,238,38,5,11,6,8,0,217,1,12,0,12,0,25,149,332,991
JHARKHAND,HAZARIBAGH,2006,97,103,12,212,45,0,45,90,77,54,23,154,73,16,88,161,576,135,441,1490,306,0,160,3,31,217,838,39,70,0,69,0,178,121,770,3034
JHARKHAND,JAMSHEDPUR,2006,90,95,6,191,54,0,54,108,43,24,19,86,20,2,36,84,754,100,654,1650,124,67,105,11,13,425,840,16,43,2,90,0,151,95,1017,3192
JHARKHAND,JAMSHEDPUR RLY.,2006,5,0,0,5,2,0,2,4,0,0,0,0,3,0,10,6,185,19,166,389,1,0,6,0,0,6,13,0,1,0,0,0,1,0,66,291
JHARKHAND,JAMTARA,2006,16,34,4,54,21,0,21,42,15,12,3,30,4,0,3,23,95,9,86,220,78,8,7,0,9,106,228,4,4,0,14,0,22,20,211,676
JHARKHAND,KODERMA,2006,38,18,3,59,21,0,21,42,19,10,9,38,15,2,13,28,112,18,94,282,68,6,40,0,1,3,165,10,2,1,8,0,21,47,314,769
JHARKHAND,LATEHAR,2006,24,10,5,39,12,0,12,24,9,6,3,18,27,4,26,16,75,1,74,223,46,3,4,1,2,44,115,2,1,0,4,0,7,15,213,543
JHARKHAND,LOHARDAGGA,2006,33,17,2,52,21,0,21,42,13,10,3,26,13,2,22,18,81,17,64,217,28,11,14,1,4,80,164,0,20,0,29,0,49,26,132,567
JHARKHAND,PAKUR,2006,41,120,5,166,28,0,28,56,19,17,2,38,2,0,9,13,85,8,77,194,95,5,22,0,7,94,246,3,13,0,34,0,50,23,113,731
JHARKHAND,PALAMU,2006,90,47,3,140,32,0,32,64,28,10,18,56,14,1,33,79,140,16,124,407,136,13,22,0,17,548,736,19,0,7,32,0,58,0,305,1566
JHARKHAND,RANCHI,2006,253,60,16,329,79,0,79,158,94,40,54,188,73,6,190,221,1210,373,837,2910,229,65,135,7,30,550,1336,14,36,2,40,4,96,320,1668,5302
JHARKHAND,SAHEBGANJ,2006,36,43,0,79,53,0,53,106,22,15,7,44,3,0,12,30,103,9,94,251,54,7,34,3,8,74,200,5,19,0,12,0,36,20,303,841
JHARKHAND,SARAIKELA,2006,52,77,2,131,17,0,17,34,14,4,10,28,15,0,25,38,86,22,64,250,30,18,13,0,2,39,136,2,4,0,15,0,21,34,417,900
JHARKHAND,SIMDEGA,2006,69,37,1,107,29,0,29,58,9,9,0,18,11,0,17,16,41,7,34,126,9,3,8,0,0,0,20,2,10,4,4,0,20,0,168,438
KARNATAKA,BAGALKOT,2006,35,25,1,61,12,0,12,24,20,13,7,40,5,6,20,85,128,32,96,372,147,11,37,3,7,276,481,3,45,1,59,0,108,0,1136,2062
KARNATAKA,BANGALORE COMMR.,2006,218,324,7,549,33,0,33,66,99,29,70,198,37,204,647,1666,7354,3501,3853,17262,710,192,1554,55,5,2640,5269,50,143,2,290,0,485,113,9941,26284
KARNATAKA,BANGALORE RURAL,2006,175,104,1,280,26,0,26,52,34,22,12,68,27,0,49,362,920,284,636,2278,582,30,112,0,37,1047,1808,26,121,0,99,0,246,0,5026,8778
KARNATAKA,BELGAUM,2006,98,91,0,189,22,0,22,44,35,23,12,70,15,0,48,292,434,168,266,1223,358,20,197,8,17,956,1591,13,107,2,152,0,274,35,3243,6143
KARNATAKA,BELLARY,2006,56,44,1,101,15,0,15,30,23,22,1,46,5,3,31,155,268,96,172,730,224,15,49,5,5,566,872,13,59,0,70,0,142,8,2497,4112
KARNATAKA,BIDAR,2006,38,53,6,97,8,0,8,16,20,13,7,40,6,0,20,148,232,53,179,638,209,11,39,1,18,1079,1357,10,82,2,69,0,163,0,1532,3583
KARNATAKA,BIJAPUR,2006,63,59,0,122,18,0,18,36,26,19,7,52,2,12,22,123,153,38,115,465,319,16,64,1,17,622,1039,4,89,0,126,0,219,0,1426,3162
KARNATAKA,CHAMARAJNAGAR,2006,20,15,1,36,16,0,16,32,7,5,2,14,0,0,1,40,109,20,89,259,70,4,10,4,0,394,482,1,35,0,25,0,61,0,548,1300
KARNATAKA,CHICKMAGALUR,2006,40,42,2,84,17,0,17,34,11,9,2,22,4,0,15,246,254,45,209,773,136,8,35,3,10,928,1123,4,71,8,89,0,172,3,1443,3369
KARNATAKA,CHITRADURGA,2006,38,21,3,62,16,0,16,32,19,17,2,38,2,0,9,127,276,54,222,690,193,7,26,0,2,709,937,3,52,0,28,0,83,0,2000,3531
KARNATAKA,DAKSHIN KANNADA,2006,28,44,0,72,17,0,17,34,12,5,7,24,7,0,20,208,237,105,132,709,419,5,56,8,28,441,968,2,47,6,34,0,89,11,2407,4037
KARNATAKA,DAVANAGERE,2006,23,13,4,40,17,0,17,34,14,12,2,28,10,0,25,173,272,55,217,752,147,25,46,5,0,554,783,11,60,6,79,0,156,6,1322,2812
KARNATAKA,DHARWAD COMMR.,2006,23,18,0,41,3,0,3,6,15,8,7,30,4,10,60,136,338,138,200,886,67,10,105,4,3,198,394,1,13,1,34,0,49,7,1075,2125
KARNATAKA,DHARWAD RURAL,2006,34,9,2,45,4,0,4,8,8,2,6,16,1,0,5,14,58,6,52,136,64,8,18,0,0,126,216,1,15,0,12,0,28,0,614,993
KARNATAKA,GADAG,2006,20,12,1,33,1,0,1,2,5,3,2,10,2,0,7,64,84,28,56,241,115,7,21,2,1,169,422,4,20,1,17,0,42,107,478,1138
KARNATAKA,GULBARGA,2006,99,125,2,226,18,0,18,36,45,28,17,90,7,3,35,190,278,92,186,791,494,4,90,2,58,1183,1843,9,78,0,122,0,209,12,2239,5093
KARNATAKA,HASSAN,2006,61,38,1,100,13,0,13,26,11,7,4,22,6,0,25,230,281,88,193,823,126,11,30,2,13,1040,1222,7,62,0,62,0,131,0,2280,4299
KARNATAKA,HAVERI,2006,27,10,2,39,5,0,5,10,13,4,9,26,11,0,8,75,100,28,72,294,173,7,26,5,0,198,582,1,37,0,17,0,55,173,951,1839
KARNATAKA,K.G.F.,2006,14,26,0,40,3,0,3,6,8,6,2,16,0,0,5,67,95,29,66,262,37,3,10,1,0,180,231,4,18,0,10,0,32,0,287,768
KARNATAKA,KODAGU,2006,27,33,1,61,6,0,6,12,6,1,5,12,0,0,2,87,57,6,51,203,38,4,20,3,1,433,500,0,21,2,26,0,49,1,573,1341
KARNATAKA,KOLAR,2006,96,59,1,156,13,0,13,26,27,19,8,54,8,3,24,139,404,116,288,982,279,11,39,1,0,701,1037,16,50,0,47,0,113,6,1487,3411
KARNATAKA,KOPPAL,2006,25,9,11,45,6,0,6,12,7,7,0,14,7,0,6,78,84,23,61,259,118,1,22,3,1,195,340,3,28,0,23,0,54,0,912,1539
KARNATAKA,MANDYA,2006,58,46,3,107,19,0,19,38,14,13,1,28,3,0,14,177,289,80,209,772,192,2,40,4,0,767,1005,8,79,0,89,0,176,0,2120,3924
KARNATAKA,MYSORE COMMR.,2006,33,45,0,78,15,0,15,30,8,5,3,16,4,0,107,139,530,314,216,1310,71,4,63,5,0,333,476,10,14,0,94,0,118,0,1221,2696
KARNATAKA,MYSORE RURAL,2006,60,43,4,107,10,0,10,20,8,2,6,16,5,0,5,119,197,31,166,523,155,11,20,1,0,741,928,13,43,0,66,0,122,0,1367,2868
KARNATAKA,RAICHUR,2006,32,46,5,83,13,0,13,26,18,12,6,36,2,0,13,136,123,32,91,397,204,13,85,1,8,556,880,6,76,5,85,0,172,13,1349,2789
KARNATAKA,RAILWAYS,2006,22,2,0,24,0,0,0,0,2,0,2,4,3,0,9,2,401,3,398,816,5,2,7,5,0,23,42,2,4,0,1,0,7,0,53,543
KARNATAKA,SHIMOGA,2006,50,52,0,102,23,0,23,46,21,14,7,42,7,4,66,254,348,114,234,1027,168,6,36,1,9,1082,1314,5,61,2,191,0,259,12,2005,4403
KARNATAKA,TUMKUR,2006,62,41,4,107,13,0,13,26,15,5,10,30,4,2,29,207,403,116,287,1048,157,10,26,1,16,806,1039,10,87,0,47,0,144,23,2308,4271
KARNATAKA,UDUPI,2006,21,10,1,32,11,0,11,22,7,3,4,14,5,0,16,124,108,38,70,361,134,4,14,3,8,273,440,4,17,0,24,0,45,4,1430,2218
KARNATAKA,UTTAR KANNADA,2006,31,25,4,60,7,0,7,14,5,0,5,10,3,0,6,104,86,26,60,285,72,9,13,2,4,272,372,0,49,0,42,0,91,0,1545,2279
KERALA,ALAPUZHA,2006,27,33,6,66,15,0,15,30,18,14,4,36,11,0,32,207,254,112,142,758,392,21,227,0,22,1206,1870,1,177,14,227,0,419,2,4808,7700
KERALA,CBCID,2006,16,1,1,18,1,0,1,2,1,1,0,2,1,0,1,1,5,1,4,13,0,6,17,61,0,4,88,0,0,0,2,0,2,0,23,141
KERALA,ERNAKULAM COMMR.,2006,13,12,8,33,14,0,14,28,11,8,3,22,6,0,44,187,340,109,231,917,180,10,323,0,5,420,940,0,65,20,87,0,172,2,3952,5699
KERALA,ERNAKULAM RURAL,2006,28,16,5,49,25,0,25,50,14,9,5,28,8,4,50,228,323,138,185,936,293,12,101,0,13,1054,1477,1,87,5,124,0,217,4,6147,8542
KERALA,IDUKKI,2006,31,7,1,39,30,0,30,60,14,11,3,28,7,0,15,200,214,34,180,650,193,15,116,0,10,1302,1636,2,133,12,131,0,278,0,2364,4797
KERALA,KANNUR,2006,20,29,0,49,37,0,37,74,16,8,8,32,6,0,36,216,229,103,126,716,737,11,132,0,83,1097,2066,0,116,12,227,0,355,6,2451,5461
KERALA,KASARGOD,2006,15,12,0,27,27,0,27,54,8,4,4,16,5,7,19,188,170,78,92,559,338,4,73,0,18,562,999,0,81,4,149,0,234,4,1378,3062
KERALA,KOLLAM,2006,34,39,14,87,75,0,75,150,35,28,7,70,8,20,75,485,532,194,338,1652,624,17,151,2,51,2504,3352,1,351,10,445,0,807,3,4912,10388
KERALA,KOTTAYAM,2006,21,18,5,44,30,0,30,60,22,19,3,44,8,0,46,394,405,135,270,1258,292,35,364,1,17,1815,2527,2,196,29,186,0,413,3,4297,8186
KERALA,KOZHIKODE COMMR.,2006,7,9,4,20,19,0,19,38,12,8,4,24,4,5,29,258,382,197,185,1060,220,14,125,0,5,498,862,3,51,8,134,0,196,0,1905,3692
KERALA,KOZHIKODE RURAL,2006,6,21,3,30,40,0,40,80,11,8,3,22,6,0,13,190,217,96,121,643,492,4,160,0,35,996,1688,4,128,11,234,0,377,1,1944,4516
KERALA,MALAPPURAM,2006,19,15,3,37,45,0,45,90,10,5,5,20,12,8,23,247,475,216,259,1240,498,21,259,1,37,755,1572,1,145,12,458,0,616,1,3482,6527
KERALA,PALAKKAD,2006,44,30,7,81,59,0,59,118,8,2,6,16,6,10,32,241,262,79,183,813,329,51,196,0,15,1121,1720,4,52,17,363,0,436,8,2765,5620
KERALA,PATHANAMTHITTA,2006,18,8,1,27,24,0,24,48,15,9,6,30,3,0,26,205,154,60,94,542,182,13,120,0,7,962,1284,0,145,9,129,0,283,0,2412,4433
KERALA,RAILWAYS,2006,0,0,0,0,0,0,0,0,0,0,0,0,0,1,6,0,153,1,152,313,1,0,1,0,0,13,15,0,5,0,0,0,5,0,24,204
KERALA,THRISSUR,2006,44,48,9,101,55,0,55,110,18,6,12,36,15,33,77,228,430,166,264,1213,602,34,408,2,63,1002,2118,3,220,22,302,0,547,7,6156,9778
KERALA,TRIVANDRUM COMMR.,2006,14,28,3,45,28,0,28,56,28,20,8,56,6,24,68,200,371,149,222,1040,338,9,243,0,9,873,1473,1,133,10,107,0,251,1,2420,4914
KERALA,TRIVANDRUM RURAL,2006,27,13,16,56,41,0,41,82,49,40,9,98,14,13,87,447,382,118,264,1325,500,14,242,0,34,2208,3001,1,388,19,281,0,689,3,4495,9274
KERALA,WAYANADU,2006,9,8,1,18,36,0,36,72,4,2,2,8,3,0,12,123,133,28,105,404,154,8,58,1,11,713,949,1,70,8,122,0,201,4,842,2321
MADHYA PRADESH,ANUPPUR,2006,32,11,0,43,38,0,38,76,9,7,2,18,3,1,10,102,112,8,104,340,17,3,16,1,5,305,359,7,81,3,35,0,126,12,684,1487
MADHYA PRADESH,ASHOK NAGAR,2006,33,33,6,72,54,0,54,108,8,6,2,16,1,0,10,116,162,36,126,451,36,2,13,0,13,826,926,6,120,5,23,0,154,36,762,2265
MADHYA PRADESH,BALAGHAT,2006,60,22,1,83,67,0,67,134,5,3,2,10,1,1,10,106,129,36,93,376,32,3,15,1,9,388,517,6,111,10,41,0,168,69,1208,2295
MADHYA PRADESH,BARWANI,2006,39,29,7,75,48,0,48,96,2,2,0,4,0,1,16,133,246,73,173,642,35,5,13,0,10,289,470,4,103,15,32,0,154,118,1247,2392
MADHYA PRADESH,BETUL,2006,65,24,1,90,142,0,142,284,27,24,3,54,1,0,23,180,235,49,186,674,19,0,25,0,14,478,639,13,134,25,71,0,243,103,1711,3291
MADHYA PRADESH,BHIND,2006,72,103,8,183,34,0,34,68,13,6,7,26,5,5,90,173,216,68,148,705,76,9,24,0,14,685,936,32,71,1,69,0,173,128,2028,3856
MADHYA PRADESH,BHOPAL,2006,62,89,0,151,70,0,70,140,49,42,7,98,9,2,147,846,1607,766,841,4218,65,12,127,6,17,527,965,22,193,44,103,0,362,211,8808,13016
MADHYA PRADESH,BHOPAL RLY.,2006,4,2,0,6,1,0,1,2,4,1,3,8,0,0,13,12,1041,14,1027,2107,1,3,5,3,1,17,34,2,10,3,1,0,16,4,290,1417
MADHYA PRADESH,BURHANPUR,2006,13,6,0,19,21,0,21,42,4,4,0,8,0,3,5,51,120,31,89,299,15,8,10,0,7,105,176,3,45,15,28,0,91,31,775,1265
MADHYA PRADESH,CHHATARPUR,2006,71,72,5,148,59,0,59,118,23,20,3,46,1,1,52,275,214,0,214,757,50,2,22,2,22,564,761,19,170,18,70,0,277,99,2856,4667
MADHYA PRADESH,CHHINDWARA,2006,76,38,8,122,125,0,125,250,16,14,2,32,3,2,14,134,291,87,204,735,38,2,32,0,11,1172,1376,13,188,29,79,0,309,121,1463,3855
MADHYA PRADESH,DAMOH,2006,44,52,0,96,40,0,40,80,4,1,3,8,4,4,27,108,131,42,89,405,17,2,6,0,6,1120,1203,40,116,0,51,0,207,52,620,2444
MADHYA PRADESH,DATIYA,2006,50,58,0,108,23,0,23,46,18,7,11,36,1,4,48,115,177,30,147,522,27,5,26,0,11,481,617,12,73,0,21,0,106,67,1121,2338
MADHYA PRADESH,DEWAS,2006,43,72,1,116,85,0,85,170,21,16,5,42,5,2,26,275,726,177,549,1760,84,26,41,1,21,403,725,10,168,31,136,0,345,149,3094,5420
MADHYA PRADESH,DHAR,2006,58,65,3,126,103,0,103,206,35,31,4,70,10,6,43,249,487,154,333,1282,72,27,20,0,33,692,1014,30,183,10,47,0,270,170,2492,4835
MADHYA PRADESH,DINDORI,2006,27,5,3,35,26,0,26,52,0,0,0,0,0,0,1,33,16,5,11,66,2,1,4,0,1,156,187,2,51,0,15,0,68,23,294,660
MADHYA PRADESH,GUNA,2006,37,45,6,88,69,0,69,138,13,12,1,26,3,3,28,165,247,49,198,693,70,8,22,1,16,938,1172,7,162,17,48,0,234,117,1472,3494
MADHYA PRADESH,GWALIOR,2006,107,152,13,272,77,0,77,154,41,33,8,82,8,14,222,675,1581,896,685,4081,138,49,109,0,20,1021,1544,32,186,13,172,0,403,207,5171,10008
MADHYA PRADESH,HARDA,2006,16,26,0,42,25,0,25,50,7,5,2,14,1,1,13,83,167,56,111,432,13,1,3,0,0,420,437,5,37,2,16,0,60,0,448,1284
MADHYA PRADESH,HOSHANGABAD,2006,47,46,3,96,57,0,57,114,12,8,4,24,2,4,32,252,386,122,264,1062,22,8,26,1,7,398,462,12,112,14,29,0,167,0,1596,3066
MADHYA PRADESH,INDORE,2006,81,126,2,209,90,0,90,180,39,33,6,78,10,9,111,920,3335,2017,1318,7720,144,46,129,4,43,1460,2221,22,253,68,263,0,606,395,8577,16127
MADHYA PRADESH,INDORE RLY.,2006,2,1,0,3,3,0,3,6,0,0,0,0,0,0,8,0,138,0,138,284,0,0,0,0,0,4,4,0,4,2,1,0,7,0,102,265
MADHYA PRADESH,JABALPUR,2006,65,132,9,206,103,0,103,206,39,32,7,78,4,7,97,483,908,528,380,2407,111,31,152,3,26,4728,5277,31,228,94,127,0,480,226,2595,10199
MADHYA PRADESH,JABALPUR RLY.,2006,4,1,4,9,1,0,1,2,1,1,0,2,1,4,12,2,223,3,220,465,0,2,8,0,0,2,12,0,7,3,0,0,10,0,121,396
MADHYA PRADESH,JHABUA,2006,117,63,3,183,32,0,32,64,20,17,3,40,1,0,7,70,170,48,122,418,28,1,10,0,30,478,547,4,46,2,22,0,74,0,1169,2273
MADHYA PRADESH,KATNI,2006,49,33,3,85,32,0,32,64,7,6,1,14,1,1,11,132,195,89,106,535,24,5,46,0,10,1081,1266,18,142,11,48,0,219,100,922,2871
MADHYA PRADESH,KHANDWA,2006,30,55,0,85,60,0,60,120,21,19,2,42,3,0,18,421,444,92,352,1330,55,9,23,0,9,45,237,8,179,20,61,0,268,96,2442,3999
MADHYA PRADESH,KHARGON,2006,44,25,1,70,47,0,47,94,8,0,8,16,1,0,18,235,620,83,537,1494,41,13,14,0,9,454,666,26,139,24,39,0,228,135,2025,3918
MADHYA PRADESH,MANDLA,2006,27,19,1,47,62,0,62,124,7,6,1,14,0,0,5,73,61,24,37,200,13,3,12,0,6,300,426,4,81,9,24,0,118,92,760,1559
MADHYA PRADESH,MANDSAUR,2006,18,25,0,43,37,0,37,74,18,11,7,36,2,4,31,131,391,113,278,950,55,13,29,5,13,354,540,11,130,15,62,0,218,71,1750,3165
MADHYA PRADESH,MORENA,2006,66,85,2,153,34,0,34,68,30,15,15,60,5,5,48,167,405,176,229,1035,151,0,26,2,13,1767,2093,21,77,3,59,0,160,134,1780,4880
MADHYA PRADESH,NARSINGHPUR,2006,32,41,3,76,65,0,65,130,4,4,0,8,0,0,13,67,101,37,64,282,12,4,6,0,19,767,905,14,122,11,38,0,185,97,556,1972
MADHYA PRADESH,NEEMUCH,2006,17,14,0,31,22,0,22,44,8,4,4,16,2,0,6,102,268,75,193,646,21,33,18,0,5,424,556,4,34,7,42,0,87,55,734,1816
MADHYA PRADESH,PANNA,2006,30,31,1,62,41,0,41,82,8,3,5,16,4,3,11,95,74,17,57,261,15,5,8,1,7,101,182,14,68,0,20,0,102,45,921,1503
MADHYA PRADESH,RAISEN,2006,51,46,0,97,74,0,74,148,14,11,3,28,1,0,23,129,252,60,192,657,23,1,14,0,7,392,554,18,172,17,52,0,259,117,2273,3676
MADHYA PRADESH,RAJGARH,2006,28,29,0,57,83,0,83,166,12,6,6,24,0,1,31,162,361,86,275,916,101,13,8,1,49,305,560,9,146,35,101,0,291,83,2799,4357
MADHYA PRADESH,RATLAM,2006,40,55,0,95,62,0,62,124,20,14,6,40,4,2,33,148,417,108,309,1021,35,21,37,1,17,301,502,9,125,24,78,0,236,90,2185,3704
MADHYA PRADESH,REWA,2006,45,28,0,73,47,0,47,94,23,18,5,46,3,3,49,454,432,113,319,1373,65,7,47,3,23,803,1076,46,125,2,51,0,224,128,2075,4459
MADHYA PRADESH,SAGAR,2006,76,95,0,171,116,0,116,232,31,30,1,62,3,3,49,363,520,127,393,1458,62,7,22,0,43,2570,2851,28,284,19,131,0,462,147,2403,6972
MADHYA PRADESH,SATNA,2006,74,52,0,126,72,0,72,144,18,10,8,36,8,3,30,482,413,144,269,1349,40,11,37,1,27,965,1307,39,198,11,92,0,340,226,2949,5748
MADHYA PRADESH,SEONI,2006,36,23,0,59,57,0,57,114,6,5,1,12,1,1,11,117,116,34,82,362,41,9,11,0,6,353,518,11,105,9,35,0,160,98,1422,2468
MADHYA PRADESH,SHAHDOL,2006,33,22,1,56,67,0,67,134,4,4,0,8,1,5,21,207,171,42,129,576,27,5,22,0,9,255,318,16,140,9,69,0,234,0,1408,2492
MADHYA PRADESH,SHAJAPUR,2006,28,41,3,72,58,0,58,116,19,10,9,38,6,4,61,244,585,139,446,1485,51,20,20,1,33,1207,1434,11,150,27,62,0,250,102,811,3544
MADHYA PRADESH,SHEOPUR,2006,12,13,0,25,19,0,19,38,8,4,4,16,2,0,3,34,121,14,107,281,26,0,3,0,1,264,322,2,34,0,31,0,67,28,558,1159
MADHYA PRADESH,SHIVPURI,2006,72,65,2,139,83,0,83,166,22,17,5,44,5,4,39,241,319,99,220,927,70,14,22,0,37,755,1013,33,170,7,50,0,260,115,2521,4646
MADHYA PRADESH,SIDHI,2006,72,25,1,98,66,0,66,132,31,31,0,62,2,1,27,296,317,50,267,960,34,13,55,0,12,622,862,21,129,2,47,0,199,126,2237,4136
MADHYA PRADESH,SIHORE,2006,31,47,1,79,66,0,66,132,14,11,3,28,2,1,24,174,375,95,280,951,46,13,21,0,10,290,508,14,99,6,48,0,167,128,1927,3337
MADHYA PRADESH,TIKAMGARH,2006,37,31,0,68,52,0,52,104,9,5,4,18,4,0,28,156,170,29,141,528,43,2,11,0,49,1034,1234,22,131,4,34,0,191,95,1168,3080
MADHYA PRADESH,UJJAIN,2006,65,128,0,193,79,0,79,158,39,34,5,78,8,4,86,413,1111,292,819,2733,87,32,110,0,35,705,1090,12,175,39,157,0,383,121,4052,7458
MADHYA PRADESH,UMARIYA,2006,26,9,33,68,21,0,21,42,0,0,0,0,2,1,4,115,98,22,76,318,10,1,6,0,10,210,240,4,56,4,13,0,77,3,623,1249
MADHYA PRADESH,VIDISHA,2006,45,60,3,108,85,0,85,170,17,14,3,34,7,1,25,244,331,97,234,939,48,9,36,0,19,728,893,15,180,23,45,0,263,53,1954,3928
MAHARASHTRA,AHMEDNAGAR,2006,86,49,3,138,68,0,68,136,36,22,14,72,36,2,100,400,1341,334,1007,3220,277,33,107,4,46,710,1715,0,129,0,467,0,596,538,1741,6173
MAHARASHTRA,AKOLA,2006,47,52,0,99,25,0,25,50,28,26,2,56,4,1,39,305,995,126,869,2339,134,23,80,4,36,843,1250,1,95,14,135,0,245,130,1231,4222
MAHARASHTRA,AMRAVATI COMMR.,2006,27,14,0,41,21,0,21,42,17,15,2,34,5,4,26,196,735,136,599,1701,81,18,55,1,9,429,660,3,36,24,76,0,139,67,747,2591
MAHARASHTRA,AMRAVATI RURAL,2006,67,32,2,101,44,0,44,88,22,20,2,44,3,0,24,266,845,51,794,1983,89,11,56,0,60,797,1147,4,118,35,131,0,288,134,1066,3806
MAHARASHTRA,AURANGABAD COMMR.,2006,31,24,0,55,33,0,33,66,22,17,5,44,11,4,73,224,666,213,453,1644,144,33,158,3,15,384,870,3,39,22,107,0,171,133,637,2766
MAHARASHTRA,AURANGABAD RURAL,2006,42,17,1,60,10,0,10,20,11,8,3,22,12,5,29,139,314,53,261,813,192,15,34,1,24,668,1146,39,56,12,255,0,362,212,503,2591
MAHARASHTRA,BEED,2006,63,46,1,110,24,0,24,48,34,23,11,68,28,2,94,379,753,171,582,2009,439,18,56,1,40,1005,1816,12,98,10,310,0,430,257,710,4380
MAHARASHTRA,BHANDARA,2006,35,18,2,55,40,0,40,80,15,10,5,30,0,2,16,183,443,41,402,1087,94,17,31,6,53,363,706,4,54,29,89,0,176,142,947,2583
MAHARASHTRA,BULDHANA,2006,53,64,2,119,23,0,23,46,10,5,5,20,7,2,32,214,704,101,603,1663,177,25,89,2,68,905,1443,13,128,41,192,0,374,177,1224,4152
MAHARASHTRA,CHANDRAPUR,2006,42,20,1,63,30,0,30,60,17,14,3,34,7,0,27,377,774,112,662,1959,122,19,55,2,49,664,1147,6,81,47,123,0,257,236,1004,3703
MAHARASHTRA,DHULE,2006,38,33,4,75,12,0,12,24,8,8,0,16,10,2,19,131,357,72,285,876,102,24,78,2,13,411,858,6,33,12,189,0,240,228,804,2516
MAHARASHTRA,GADCHIROLI,2006,59,52,4,115,14,0,14,28,10,8,2,20,12,0,8,100,124,8,116,368,28,9,18,1,45,241,417,2,52,5,47,0,106,75,372,1278
MAHARASHTRA,GONDIA,2006,31,13,2,46,23,0,23,46,22,22,0,44,12,0,25,220,398,49,349,1053,63,17,27,2,41,393,665,5,106,12,55,0,178,122,707,2296
MAHARASHTRA,HINGOLI,2006,41,25,2,68,15,0,15,30,12,10,2,24,8,3,38,93,234,28,206,610,112,2,29,0,28,404,647,8,41,2,100,0,151,72,521,1790
MAHARASHTRA,JALGAON,2006,75,53,4,132,52,0,52,104,21,21,0,42,25,2,37,229,624,128,496,1541,206,78,208,7,12,632,1479,14,111,25,305,0,455,336,1387,4443
MAHARASHTRA,JALNA,2006,52,25,0,77,19,0,19,38,13,6,7,26,10,6,51,178,454,109,345,1153,174,13,59,3,20,558,960,19,58,8,248,0,333,133,910,3011
MAHARASHTRA,KOLHAPUR,2006,65,45,3,113,33,0,33,66,29,22,7,58,18,3,27,294,742,261,481,1826,182,100,188,5,15,521,1298,25,71,15,132,0,243,287,981,3781
MAHARASHTRA,LATUR,2006,54,40,0,94,15,0,15,30,22,22,0,44,7,7,45,276,391,112,279,1117,194,20,58,1,33,957,1473,65,53,5,144,0,267,210,1305,3902
MAHARASHTRA,MUMBAI COMMR.,2006,239,135,5,379,165,0,165,330,190,129,61,380,29,61,292,3111,11685,3552,8133,26863,278,510,1701,137,15,3797,7216,17,357,102,327,1,804,778,7138,31070
MAHARASHTRA,MUMBAI RLY.,2006,16,0,2,18,5,0,5,10,5,4,1,10,0,1,28,1,1678,0,1678,3386,9,4,22,2,0,35,72,0,17,0,0,0,17,0,72,1897
MAHARASHTRA,NAGPUR COMMR.,2006,85,51,4,140,51,0,51,102,58,42,16,116,22,40,169,1275,2602,882,1720,6710,247,57,326,11,14,1006,1944,7,72,42,180,0,301,283,3389,9991
MAHARASHTRA,NAGPUR RLY.,2006,7,3,0,10,0,0,0,0,2,2,0,4,9,0,24,1,874,7,867,1782,16,1,5,6,3,17,52,1,5,2,0,0,8,4,109,1089
MAHARASHTRA,NAGPUR RURAL,2006,74,24,1,99,37,0,37,74,24,15,9,48,9,7,40,239,948,72,876,2191,144,21,67,4,44,639,1290,5,120,45,67,0,237,371,1584,4514
MAHARASHTRA,NANDED,2006,71,73,7,151,33,0,33,66,35,21,14,70,17,1,74,344,518,123,395,1472,330,14,119,0,74,1292,1986,16,82,0,221,0,319,157,1350,4828
MAHARASHTRA,NANDURBAR,2006,26,14,1,41,21,0,21,42,9,6,3,18,8,0,7,62,156,27,129,389,95,5,44,0,3,233,484,0,22,6,96,0,124,104,354,1266
MAHARASHTRA,NASIK COMMR.,2006,38,14,1,53,14,0,14,28,32,22,10,64,5,2,48,438,925,368,557,2343,135,19,128,6,5,222,687,2,36,15,119,0,172,172,575,2951
MAHARASHTRA,NASIK RURAL,2006,77,40,2,119,62,0,62,124,28,24,4,56,19,4,56,226,605,137,468,1515,345,45,111,8,21,837,1882,7,123,43,331,0,504,515,1262,4767
MAHARASHTRA,NAVI MUMBAI,2006,59,20,0,79,18,0,18,36,19,9,10,38,14,24,109,423,1226,629,597,3022,121,56,164,10,9,424,1168,7,39,11,59,0,116,384,798,3994
MAHARASHTRA,OSMANABAD,2006,58,27,0,85,37,0,37,74,10,7,3,20,26,3,39,257,506,59,447,1337,177,27,98,0,23,761,1298,3,57,5,150,0,215,212,751,3227
MAHARASHTRA,PARBHANI,2006,69,47,0,116,18,0,18,36,18,11,7,36,18,3,48,183,292,80,212,836,120,9,72,1,18,885,1209,10,73,4,162,0,249,104,358,2512
MAHARASHTRA,PUNE COMMR.,2006,104,99,4,207,77,0,77,154,108,74,34,216,31,21,219,1047,4068,2181,1887,9454,497,81,533,16,13,1236,2830,6,104,87,236,0,433,454,2443,11484
MAHARASHTRA,PUNE RLY.,2006,3,0,0,3,1,0,1,2,1,1,0,2,5,0,9,0,229,0,229,472,2,1,1,1,0,4,12,0,1,1,0,0,2,3,28,290
MAHARASHTRA,PUNE RURAL,2006,124,62,3,189,38,0,38,76,40,27,13,80,45,26,85,378,920,350,570,2374,185,46,148,2,34,602,1887,15,93,19,161,0,288,870,1677,5573
MAHARASHTRA,RAIGAD,2006,54,27,3,84,25,0,25,50,15,12,3,30,27,2,28,198,480,66,414,1215,159,31,56,5,9,339,905,0,43,15,58,0,116,306,709,2589
MAHARASHTRA,RATNAGIRI,2006,16,7,2,25,25,0,25,50,9,8,1,18,5,1,9,194,273,51,222,755,105,33,48,5,20,205,544,1,32,24,52,0,109,128,440,1634
MAHARASHTRA,SANGLI,2006,61,34,1,96,24,0,24,48,21,14,7,42,10,0,22,226,519,150,369,1296,128,28,171,8,19,371,1022,8,51,4,99,0,162,297,566,2668
MAHARASHTRA,SATARA,2006,64,40,6,110,34,1,33,68,41,32,9,82,20,4,74,373,1043,221,822,2557,167,45,82,9,36,493,1197,8,88,10,255,0,361,365,1386,4643
MAHARASHTRA,SINDHUDURG,2006,15,6,2,23,9,0,9,18,4,4,0,8,1,0,3,80,126,21,105,336,39,12,44,0,11,128,309,3,13,10,13,0,39,75,222,816
MAHARASHTRA,SOLAPUR COMMR.,2006,15,28,0,43,12,0,12,24,16,9,7,32,9,3,49,223,351,131,220,986,92,9,115,5,7,189,506,2,22,10,59,0,93,89,481,1786
MAHARASHTRA,SOLAPUR RURAL,2006,77,38,1,116,54,0,54,108,32,24,8,64,31,11,47,210,522,116,406,1343,243,17,34,4,31,596,1320,10,81,29,103,0,223,395,1086,3652
MAHARASHTRA,THANE COMMR.,2006,106,89,3,198,62,0,62,124,90,65,25,180,25,25,162,1156,2285,950,1335,5938,300,86,481,21,13,1208,2411,4,150,41,269,0,464,302,1346,8224
MAHARASHTRA,THANE RURAL,2006,152,46,8,206,68,0,68,136,35,14,21,70,46,25,104,471,700,230,470,2046,294,52,143,7,33,730,1886,6,137,43,147,0,333,627,1096,4970
MAHARASHTRA,WARDHA,2006,49,28,3,80,31,0,31,62,22,21,1,44,6,7,28,227,643,50,593,1554,147,24,55,1,62,772,1217,2,96,35,134,0,267,156,1602,4130
MAHARASHTRA,WASHIM,2006,28,19,0,47,12,0,12,24,11,11,0,22,3,0,25,80,362,51,311,832,82,3,23,1,18,502,709,10,64,12,134,0,220,80,542,2011
MAHARASHTRA,YAVATMAL,2006,61,87,10,158,66,0,66,132,37,34,3,74,8,7,66,250,1043,132,911,2417,186,15,57,2,46,999,1518,8,142,51,201,0,402,213,1673,5228
MANIPUR,BISHNUPUR,2006,14,27,1,42,1,0,1,2,9,5,4,18,0,0,0,1,18,1,17,37,4,8,6,0,4,38,61,0,6,0,2,0,8,1,149,289
MANIPUR,CHANDEL,2006,14,12,0,26,2,0,2,4,2,0,2,4,0,1,2,1,6,1,5,16,2,0,2,1,4,4,13,0,1,0,0,0,1,0,17,71
MANIPUR,CHURACHANDPUR,2006,43,30,1,74,20,0,20,40,1,0,1,2,0,6,0,5,23,0,23,57,0,0,1,0,6,8,16,0,5,0,0,0,5,1,114,264
MANIPUR,IMPHAL EAST,2006,31,57,0,88,3,0,3,6,26,21,5,52,0,0,0,8,51,10,41,110,9,1,5,1,39,56,111,0,14,0,0,0,14,0,233,534
MANIPUR,IMPHAL WEST,2006,41,74,0,115,9,0,9,18,51,29,22,102,1,19,5,34,148,86,62,355,22,15,40,6,39,106,228,0,15,0,5,0,20,0,428,1058
MANIPUR,SENAPATI,2006,13,7,1,21,0,0,0,0,6,0,6,12,1,0,1,0,19,2,17,40,2,2,0,1,0,1,6,0,0,0,0,0,0,0,54,108
MANIPUR,TAMENGLONG,2006,9,5,0,14,0,0,0,0,0,0,0,0,0,1,0,0,6,0,6,13,2,0,0,0,5,0,8,0,0,0,0,0,0,1,11,40
MANIPUR,THOUBAL,2006,36,52,1,89,5,0,5,10,35,24,11,70,0,0,0,6,18,5,13,42,17,10,27,0,7,79,140,0,1,0,3,0,4,0,167,464
MANIPUR,UKHRUL,2006,4,1,0,5,0,0,0,0,0,0,0,0,0,0,0,0,1,0,1,2,2,4,1,0,5,4,16,0,0,0,0,0,0,0,34,56
MEGHALAYA,GARO HILLS EAST,2006,18,8,2,28,3,0,3,6,6,1,5,12,10,4,8,9,25,1,24,81,0,1,2,1,1,6,11,0,7,0,0,0,7,0,37,148
MEGHALAYA,GARO HILLS SOUTH,2006,3,2,0,5,0,0,0,0,4,0,4,8,4,0,4,3,18,0,18,47,0,1,1,1,0,3,6,0,1,0,0,0,1,0,8,53
MEGHALAYA,GARO HILLS WEST,2006,15,7,0,22,10,0,10,20,13,6,7,26,8,0,1,12,41,7,34,103,7,0,5,2,7,39,74,0,14,0,0,0,14,14,47,242
MEGHALAYA,JAINTIA HILLS,2006,51,3,2,56,19,0,19,38,3,0,3,6,7,0,5,13,41,10,31,107,0,4,1,0,5,38,67,0,4,0,0,0,4,19,71,286
MEGHALAYA,KHASI HILLS EAST,2006,45,16,4,65,30,0,30,60,28,18,10,56,8,0,35,96,275,109,166,689,0,10,64,3,14,43,167,6,23,0,13,0,42,33,155,901
MEGHALAYA,KHASI HILLS WEST,2006,12,5,0,17,6,0,6,12,1,0,1,2,12,0,7,7,21,0,21,68,0,0,4,0,0,0,4,0,0,0,0,0,0,0,43,118
MEGHALAYA,RI-BHOI,2006,13,1,0,14,6,0,6,12,2,0,2,4,8,0,5,0,49,8,41,111,0,0,6,0,1,9,18,0,8,0,0,0,8,2,77,187
MIZORAM,AIZAWL,2006,7,9,5,21,31,0,31,62,2,0,2,4,0,0,3,200,407,32,375,1017,0,14,50,5,12,33,134,0,24,0,1,0,25,20,175,998
MIZORAM,CHAMPHAI,2006,2,0,1,3,12,0,12,24,0,0,0,0,0,0,1,42,73,8,65,189,0,3,7,3,4,11,34,0,6,0,0,0,6,6,0,171
MIZORAM,KOLASIB,2006,4,1,0,5,8,0,8,16,2,0,2,4,6,0,0,32,72,0,72,182,0,4,6,2,4,9,25,0,6,0,0,0,6,0,97,253
MIZORAM,LAWNGTLAI,2006,3,0,0,3,1,0,1,2,0,0,0,0,1,0,0,14,18,18,0,51,0,3,1,0,0,3,7,0,2,0,0,0,2,0,41,87
MIZORAM,LUNGLEI,2006,2,1,0,3,9,0,9,18,0,0,0,0,0,0,1,78,90,0,90,259,0,3,6,0,1,4,14,0,7,0,0,0,7,0,35,237
MIZORAM,MAMIT,2006,5,4,1,10,2,0,2,4,1,0,1,2,0,0,3,14,19,0,19,55,0,1,0,0,0,3,4,0,1,0,0,0,1,0,11,65
MIZORAM,SAIHA,2006,1,0,0,1,5,0,5,10,1,1,0,2,0,0,1,17,55,1,54,128,0,1,5,0,3,7,16,0,3,0,0,0,3,0,86,185
MIZORAM,SERCHHIP,2006,1,4,0,5,4,0,4,8,0,0,0,0,0,0,1,25,24,1,23,74,0,1,3,0,1,2,7,0,2,0,0,0,2,0,9,77
NAGALAND,DIMAPUR,2006,25,7,0,32,5,0,5,10,15,2,13,30,4,0,65,21,150,82,68,390,0,11,14,4,10,9,72,0,2,2,3,0,7,24,54,425
NAGALAND,KIPHIRE,2006,1,0,0,1,0,0,0,0,0,0,0,0,0,0,0,0,1,0,1,2,0,0,0,1,0,0,1,0,0,0,0,0,0,0,6,9
NAGALAND,KOHIMA,2006,31,19,0,50,8,0,8,16,10,0,10,20,6,0,10,19,67,24,43,169,1,2,16,2,0,0,21,0,0,0,0,0,0,0,75,266
NAGALAND,MOKOKCHUNG,2006,9,1,1,11,0,0,0,0,3,0,3,6,0,0,1,3,13,0,13,30,0,0,0,1,1,9,14,0,0,0,0,0,0,3,4,49
NAGALAND,MON,2006,15,3,5,23,2,0,2,4,2,0,2,4,4,0,2,6,16,0,16,44,0,1,2,0,3,10,16,0,0,0,0,0,0,0,6,77
NAGALAND,PEREN,2006,11,8,1,20,0,0,0,0,0,0,0,0,1,0,2,2,7,0,7,19,0,0,1,0,0,3,4,0,1,0,0,0,1,0,2,39
NAGALAND,PHEK,2006,9,2,1,12,5,0,5,10,0,0,0,0,1,0,2,3,11,1,10,28,0,2,2,0,0,7,11,0,0,0,0,0,0,0,11,56
NAGALAND,TUENSANG,2006,4,1,0,5,1,0,1,2,0,0,0,0,0,0,1,7,5,0,5,18,5,0,2,2,1,1,11,0,0,0,0,0,0,0,15,45
NAGALAND,WOKHA,2006,4,2,0,6,0,0,0,0,1,1,0,2,0,0,1,2,30,1,29,63,1,2,0,0,1,7,12,0,0,0,0,0,0,1,12,64
NAGALAND,ZUNHEBOTO,2006,14,3,0,17,2,0,2,4,0,0,0,0,0,0,0,7,27,5,22,61,0,0,0,0,0,4,4,0,0,0,0,0,0,0,16,73
ODISHA,ANGUL,2006,39,43,1,83,41,0,41,82,16,13,3,32,15,4,47,107,316,35,281,805,144,11,39,0,12,26,362,12,97,13,36,0,158,130,955,2104
ODISHA,BALASORE,2006,35,40,3,78,59,0,59,118,50,46,4,100,3,2,29,195,261,48,213,751,48,17,58,1,28,354,509,46,145,26,28,0,245,3,1556,2987
ODISHA,BARAGARH,2006,37,28,3,68,17,0,17,34,13,11,2,26,11,2,25,66,133,21,112,370,75,5,21,0,17,35,245,17,69,7,17,0,110,92,535,1225
ODISHA,BERHAMPUR,2006,18,39,0,57,12,0,12,24,15,9,6,30,11,9,41,101,173,57,116,508,49,7,39,0,10,85,241,9,87,5,11,0,112,51,412,1184
ODISHA,BHADRAK,2006,39,32,0,71,45,0,45,90,20,19,1,40,4,1,16,61,98,13,85,278,31,12,40,0,15,15,177,23,58,18,17,0,116,64,1033,1642
ODISHA,BOLANGIR,2006,32,29,4,65,40,0,40,80,37,20,17,74,8,1,26,79,149,24,125,412,61,4,40,0,8,205,318,7,140,14,23,0,184,0,807,1714
ODISHA,BOUDH,2006,8,4,0,12,4,0,4,8,3,2,1,6,0,0,5,23,36,0,36,100,15,9,3,0,7,175,209,1,49,6,9,0,65,0,107,464
ODISHA,CUTTACK,2006,44,0,0,44,46,0,46,92,56,51,5,112,8,8,90,288,652,255,397,1698,65,22,124,0,16,192,938,49,48,4,36,0,137,519,1642,3909
ODISHA,DEOGARH,2006,9,10,0,19,18,0,18,36,7,5,2,14,3,2,18,40,54,2,52,171,21,0,11,0,11,155,233,2,69,4,13,0,88,35,161,643
ODISHA,DHENKANAL,2006,34,14,0,48,32,0,32,64,13,8,5,26,12,2,49,81,149,12,137,442,98,5,24,1,19,64,284,12,130,12,23,0,177,73,753,1600
ODISHA,GAJAPATI,2006,14,0,0,14,7,0,7,14,8,4,4,16,4,0,6,30,31,4,27,102,33,3,9,0,6,16,118,3,30,0,8,0,41,51,184,443
ODISHA,GANJAM,2006,60,56,0,116,33,0,33,66,25,15,10,50,9,2,47,124,154,21,133,490,76,15,24,0,19,185,381,20,176,6,24,0,226,62,886,2003
ODISHA,JAGATSINGHPUR,2006,25,4,3,32,12,0,12,24,21,19,2,42,8,5,30,60,134,35,99,371,21,12,38,0,11,139,370,17,7,1,8,0,33,149,481,1186
ODISHA,JAJPUR,2006,48,15,0,63,35,0,35,70,39,36,3,78,7,0,46,128,198,46,152,577,64,13,47,0,21,346,606,29,69,8,31,0,137,115,904,2163
ODISHA,JHARSUGUDA,2006,16,19,0,35,13,0,13,26,5,5,0,10,6,3,18,89,178,36,142,472,44,10,13,2,7,556,692,3,63,6,7,0,79,60,180,1298
ODISHA,KALAHANDI,2006,30,14,0,44,49,0,49,98,15,13,2,30,4,0,29,59,88,9,79,268,89,7,57,0,8,120,349,12,42,5,28,0,87,68,575,1299
ODISHA,KANDHAMAL,2006,19,13,0,32,28,0,28,56,16,13,3,32,2,0,12,46,62,5,57,184,25,6,11,0,9,388,440,2,88,4,38,0,132,1,120,890
ODISHA,KENDRAPARA,2006,53,6,0,59,30,0,30,60,12,9,3,24,10,1,33,80,78,9,69,280,18,0,25,0,5,57,108,36,10,1,12,0,59,3,703,1173
ODISHA,KEONJHAR,2006,84,59,0,143,53,0,53,106,35,32,3,70,12,0,61,87,187,30,157,534,56,21,28,0,21,25,522,10,152,13,20,0,195,371,780,2075
ODISHA,KHURDA,2006,56,36,1,93,58,0,58,116,62,46,16,124,21,5,218,469,1192,569,623,3097,91,36,400,4,20,1592,2301,35,62,10,59,0,166,158,1422,6007
ODISHA,KORAPUT,2006,43,35,6,84,57,0,57,114,37,36,1,74,11,1,23,84,151,18,133,421,37,10,36,0,11,46,236,5,130,5,54,0,194,96,654,1532
ODISHA,MALKANGIR,2006,49,31,2,82,17,0,17,34,8,8,0,16,1,0,3,19,34,4,30,91,14,8,6,0,3,44,91,3,31,0,8,0,42,16,185,482
ODISHA,MAYURBHANJ,2006,84,42,8,134,88,0,88,176,38,37,1,76,4,6,46,113,224,14,210,617,17,27,45,3,18,35,259,25,159,15,61,0,260,114,976,2148
ODISHA,NAYAGARH,2006,35,12,0,47,17,0,17,34,21,16,5,42,4,4,13,72,125,17,108,343,27,5,32,0,13,381,492,12,16,4,12,0,44,34,285,1124
ODISHA,NOWRANGPUR,2006,16,5,0,21,24,0,24,48,17,17,0,34,0,0,8,32,60,11,49,160,27,4,9,0,4,53,136,5,53,5,17,0,80,39,357,735
ODISHA,NUAPADA,2006,13,4,3,20,9,0,9,18,6,3,3,12,2,1,10,34,70,5,65,187,25,7,8,2,5,12,74,6,38,5,17,0,66,15,391,683
ODISHA,PURI,2006,29,9,0,38,19,0,19,38,33,29,4,66,12,0,67,183,314,56,258,890,51,5,32,0,19,131,326,30,17,7,17,0,71,88,1403,2466
ODISHA,RAYAGADA,2006,37,16,0,53,22,0,22,44,13,10,3,26,3,0,18,35,69,12,57,194,54,5,15,1,3,22,172,7,53,4,23,12,99,72,416,900
ODISHA,ROURKELA,2006,12,22,0,34,20,0,20,40,18,14,4,36,2,1,22,66,255,76,179,601,14,7,54,1,0,233,360,10,81,10,10,0,111,51,531,1420
ODISHA,SAMBALPUR,2006,43,59,0,102,25,0,25,50,13,8,5,26,24,8,64,147,297,50,247,837,75,11,31,0,12,102,370,7,106,19,17,0,149,139,1106,2305
ODISHA,SONEPUR,2006,15,16,0,31,13,0,13,26,6,3,3,12,3,0,9,29,45,8,37,131,20,1,10,0,6,16,70,2,58,4,1,0,65,17,184,455
ODISHA,SRP(CUTTACK),2006,5,0,0,5,1,0,1,2,5,3,2,10,2,1,16,8,303,24,279,633,1,0,8,0,0,27,36,0,7,0,1,0,8,0,105,490
ODISHA,SRP(ROURKELA),2006,5,2,1,8,2,0,2,4,3,2,1,6,1,2,4,3,106,9,97,222,6,0,0,1,0,6,18,0,5,0,0,0,5,5,114,266
ODISHA,SUNDARGARH,2006,73,38,1,112,39,0,39,78,18,15,3,36,12,5,35,82,191,36,155,516,43,8,27,0,7,388,727,0,70,6,8,0,84,254,472,1777
PUNJAB,AMRITSAR,2006,44,44,5,93,13,0,13,26,25,19,6,50,5,9,16,138,349,167,182,866,0,21,170,10,0,151,454,5,6,0,55,0,66,102,359,1527
PUNJAB,BARNALA,2006,12,9,6,27,5,0,5,10,6,3,3,12,0,1,3,29,33,15,18,99,0,7,67,1,0,112,254,1,7,0,6,0,14,67,158,530
PUNJAB,BATALA,2006,26,26,4,56,31,0,31,62,16,14,2,32,0,2,0,76,101,18,83,280,0,11,187,2,0,166,428,5,15,0,44,0,64,62,468,1242
PUNJAB,BHATINDA,2006,54,55,15,124,19,0,19,38,27,22,5,54,1,4,3,127,156,80,76,447,0,17,169,3,5,223,418,5,22,1,45,0,73,1,489,1441
PUNJAB,FARIDKOT,2006,18,30,1,49,9,0,9,18,13,5,8,26,0,0,3,73,125,27,98,326,0,6,76,1,1,173,257,5,25,1,19,0,50,0,321,900
PUNJAB,FATEHGARH SAHIB,2006,17,11,4,32,10,0,10,20,4,3,1,8,0,6,4,33,59,27,32,161,0,5,72,0,0,132,326,4,5,0,27,0,36,117,158,668
PUNJAB,FEROZPUR,2006,68,47,4,119,18,0,18,36,26,21,5,52,0,1,1,129,175,59,116,481,0,19,218,5,7,474,833,7,0,27,47,0,81,110,370,1753
PUNJAB,G.R.P,2006,12,2,2,16,1,0,1,2,0,0,0,0,0,0,1,0,51,8,43,103,0,2,14,0,1,16,33,3,2,0,0,0,5,0,195,302
PUNJAB,GURDASPUR,2006,30,21,11,62,25,0,25,50,16,12,4,32,0,0,2,46,72,17,55,192,0,7,68,2,2,119,336,14,12,0,31,0,57,138,517,1133
PUNJAB,HOSHIARPUR,2006,36,47,5,88,25,0,25,50,25,15,10,50,4,2,7,81,115,32,83,324,0,14,176,3,5,257,622,13,14,1,57,0,85,167,297,1351
PUNJAB,JAGRAON,2006,23,30,3,56,18,0,18,36,12,6,6,24,0,3,1,73,93,24,69,263,0,7,69,0,0,167,318,1,11,1,21,0,34,75,289,897
PUNJAB,JALANDHAR,2006,80,122,19,221,52,0,52,104,125,95,30,250,5,11,24,316,632,243,389,1620,1,8,436,13,19,589,1293,6,30,2,93,0,131,227,861,3671
PUNJAB,KAPURTHALA,2006,28,29,1,58,13,0,13,26,21,15,6,42,2,2,15,105,135,41,94,394,0,5,164,5,5,239,518,6,12,0,23,0,41,100,291,1201
PUNJAB,KHANNA,2006,17,28,3,48,5,0,5,10,13,11,2,26,4,3,2,72,96,28,68,273,0,3,68,1,3,164,366,2,0,0,12,0,14,127,387,1010
PUNJAB,LUDHIANA,2006,63,79,8,150,41,0,41,82,100,61,39,200,3,20,13,197,517,295,222,1267,0,37,340,2,6,281,922,12,25,17,93,0,147,256,977,3087
PUNJAB,MAJITHA,2006,51,36,2,89,13,0,13,26,21,16,5,42,2,1,5,41,53,14,39,155,0,11,109,3,0,117,323,4,13,2,22,0,41,83,201,790
PUNJAB,MANSA,2006,27,29,20,76,17,0,17,34,9,5,4,18,0,3,1,31,46,30,16,127,0,8,66,1,0,150,225,1,9,0,9,0,19,0,229,656
PUNJAB,MOGA,2006,31,42,10,83,11,0,11,22,28,22,6,56,2,2,10,100,132,30,102,378,2,20,221,2,0,254,567,1,24,0,25,0,50,68,326,1311
PUNJAB,MUKTSAR,2006,23,23,5,51,14,0,14,28,17,10,7,34,0,2,7,64,93,39,54,259,0,17,47,1,3,160,272,5,5,0,17,0,27,44,170,717
PUNJAB,NAWAN SHAHR,2006,18,31,1,50,8,0,8,16,7,6,1,14,2,3,10,48,80,21,59,223,0,3,81,0,0,191,353,1,5,0,19,0,25,78,141,727
PUNJAB,PATIALA,2006,43,55,12,110,29,0,29,58,26,23,3,52,0,2,2,163,274,155,119,715,0,21,175,2,8,393,882,4,27,1,39,0,71,283,844,2403
PUNJAB,ROPAR,2006,12,1,1,14,8,0,8,16,10,7,3,20,0,1,1,24,50,14,36,126,0,6,60,0,1,72,275,5,9,1,21,0,36,136,241,660
PUNJAB,SANGRUR,2006,23,32,12,67,24,0,24,48,14,10,4,28,0,6,2,80,93,40,53,274,0,17,136,2,2,185,469,7,18,4,46,0,75,127,295,1125
PUNJAB,SAS NGR,2006,30,29,9,68,10,0,10,20,15,6,9,30,0,2,0,190,311,110,201,814,0,4,128,0,0,149,758,6,0,2,3,2,13,477,769,2136
PUNJAB,TARN TARAN,2006,31,40,2,73,23,0,23,46,15,11,4,30,5,4,9,41,105,27,78,269,0,5,76,7,0,170,332,7,18,0,27,0,52,74,171,830
RAJASTHAN,AJMER,2006,44,64,4,112,53,0,53,106,90,90,0,180,1,3,27,282,893,444,449,2099,69,29,460,4,9,327,1291,9,114,1,405,0,529,393,3242,6523
RAJASTHAN,ALWAR,2006,75,83,4,162,81,0,81,162,102,68,34,204,0,11,38,160,1093,536,557,2395,72,31,635,3,19,2084,3204,36,111,0,314,0,461,360,1931,7243
RAJASTHAN,BANSWARA,2006,29,22,1,52,27,0,27,54,38,36,2,76,0,13,14,69,91,33,58,278,85,3,63,2,17,1087,1358,5,79,3,93,0,180,101,647,2489
RAJASTHAN,BARAN,2006,33,78,1,112,37,0,37,74,44,40,4,88,0,2,8,103,243,69,174,599,21,11,120,0,14,382,632,5,114,2,169,0,290,84,1084,2555
RAJASTHAN,BARMER,2006,20,24,5,49,12,0,12,24,26,21,5,52,0,0,3,94,197,70,127,491,10,17,146,0,18,636,928,7,85,0,74,0,166,101,1122,2597
RAJASTHAN,BHARATPUR,2006,75,60,4,139,35,0,35,70,82,66,16,164,3,6,15,55,768,255,513,1615,1,17,435,2,21,524,1189,16,40,0,274,0,330,189,3512,6134
RAJASTHAN,BHILWARA,2006,36,61,1,98,40,0,40,80,97,76,21,194,0,1,57,319,679,284,395,1735,39,4,317,1,14,124,726,9,81,0,221,0,311,227,2307,4635
RAJASTHAN,BIKANER,2006,35,102,0,137,29,0,29,58,28,27,1,56,0,0,10,182,403,106,297,998,5,9,303,2,11,434,941,16,63,0,287,0,366,177,1637,3733
RAJASTHAN,BUNDI,2006,22,52,1,75,39,0,39,78,64,53,11,128,4,1,13,80,211,80,131,520,48,6,170,1,7,655,995,5,103,0,260,0,368,108,1160,3010
RAJASTHAN,CHITTORGARH,2006,51,47,6,104,65,0,65,130,154,127,27,308,1,8,40,269,572,204,368,1462,103,23,301,1,34,1907,2585,9,151,3,437,0,600,216,1608,6006
RAJASTHAN,CHURU,2006,18,22,5,45,17,0,17,34,19,11,8,38,2,0,2,62,150,26,124,366,17,9,184,0,13,582,900,10,16,0,183,0,209,95,876,2282
RAJASTHAN,DAUSA,2006,25,17,0,42,16,0,16,32,35,19,16,70,0,0,10,87,542,246,296,1181,74,7,204,2,5,1,485,14,34,0,105,0,153,192,2278,3648
RAJASTHAN,DHOLPUR,2006,42,58,1,101,28,0,28,56,41,33,8,82,0,9,10,39,312,107,205,682,34,8,115,1,11,1264,1545,25,33,0,116,0,174,112,690,2949
RAJASTHAN,DUNGARPUR,2006,23,14,1,38,18,0,18,36,25,20,5,50,1,1,6,28,56,13,43,148,94,11,27,0,11,110,339,2,64,0,47,0,113,86,971,1596
RAJASTHAN,G.R.P.,2006,7,5,0,12,0,0,0,0,10,5,5,20,2,1,11,1,547,13,534,1109,4,3,4,1,0,2,15,0,19,0,0,0,19,1,414,1032
RAJASTHAN,GANGANAGAR,2006,67,101,0,168,39,0,39,78,38,35,3,76,1,2,15,185,369,107,262,941,10,13,583,4,9,1018,1783,16,64,1,457,0,538,146,1669,4807
RAJASTHAN,HANUMANGARH,2006,44,61,1,106,31,0,31,62,24,14,10,48,0,2,13,104,245,53,192,609,4,13,381,3,10,391,894,10,65,0,257,0,332,92,1332,3083
RAJASTHAN,JAIPUR EAST,2006,18,21,1,40,19,0,19,38,55,51,4,110,1,5,20,289,1628,896,732,3571,173,50,434,3,7,39,899,6,40,2,156,0,204,193,2210,5370
RAJASTHAN,JAIPUR NORTH,2006,22,25,0,47,18,0,18,36,48,48,0,96,1,0,12,140,844,460,384,1841,64,54,381,0,2,341,968,8,42,0,151,0,201,126,1435,3714
RAJASTHAN,JAIPUR RURAL,2006,59,38,4,101,34,0,34,68,85,57,28,170,3,4,15,181,821,314,507,1845,158,30,635,2,42,786,2258,14,98,1,169,0,282,605,4203,7987
RAJASTHAN,JAIPUR SOUTH,2006,19,17,1,37,21,0,21,42,57,38,19,114,3,0,14,199,1142,592,550,2500,63,145,620,7,2,299,1321,9,28,0,144,0,181,185,1764,4739
RAJASTHAN,JAISALMER,2006,4,6,0,10,1,0,1,2,7,3,4,14,0,0,4,52,125,14,111,306,16,2,48,0,6,0,117,5,14,0,15,1,35,45,500,851
RAJASTHAN,JALORE,2006,21,22,2,45,10,0,10,20,23,17,6,46,0,0,5,73,156,24,132,390,12,12,121,4,14,58,305,10,41,0,81,0,132,84,1357,2106
RAJASTHAN,JHALAWAR,2006,28,80,3,111,42,0,42,84,66,51,15,132,2,14,17,116,350,132,218,849,41,7,92,1,30,817,1088,10,151,3,189,0,353,100,975,3134
RAJASTHAN,JHUNJHUNU,2006,34,18,0,52,44,0,44,88,20,13,7,40,0,0,6,125,264,53,211,659,29,11,249,0,24,573,1004,17,38,0,157,0,212,118,1883,3610
RAJASTHAN,JODHPUR CITY,2006,15,42,0,57,18,0,18,36,37,28,9,74,1,0,26,237,725,411,314,1714,19,28,447,4,7,604,1241,10,53,3,209,0,275,132,843,3460
RAJASTHAN,JODHPUR RURAL,2006,29,35,2,66,19,0,19,38,21,15,6,42,1,0,12,98,198,26,172,507,26,4,130,0,17,1060,1406,17,59,0,58,0,134,169,550,2505
RAJASTHAN,KARAULI,2006,21,29,2,52,29,0,29,58,59,31,28,118,0,4,10,34,361,158,203,770,12,5,144,1,16,12,272,19,39,0,99,0,157,82,2313,3291
RAJASTHAN,KOTA CITY,2006,11,134,4,149,18,0,18,36,85,70,15,170,2,2,40,186,893,531,362,2016,10,15,340,0,9,198,673,12,49,3,272,0,336,101,1661,4045
RAJASTHAN,KOTA RURAL,2006,21,90,1,112,19,0,19,38,27,19,8,54,2,1,9,81,222,79,143,537,20,5,88,0,8,191,397,4,91,3,132,0,230,85,980,2080
RAJASTHAN,NAGAUR,2006,56,31,4,91,35,0,35,70,49,37,12,98,3,0,19,142,419,91,328,1002,12,9,275,2,26,140,646,12,193,0,221,0,426,182,2602,4432
RAJASTHAN,PALI,2006,35,46,3,84,30,0,30,60,68,62,6,136,1,0,24,216,364,85,279,969,20,30,248,3,15,50,622,10,131,1,220,0,362,256,2566,4337
RAJASTHAN,RAJSAMAND,2006,12,9,2,23,6,0,6,12,36,30,6,72,0,3,17,107,187,54,133,501,35,9,154,0,16,1042,1397,2,37,1,159,0,199,141,481,2456
RAJASTHAN,SAWAI MADHOPUR,2006,24,24,1,49,20,0,20,40,47,35,12,94,0,0,19,104,469,256,213,1061,5,2,190,1,10,44,328,7,44,0,136,0,187,76,2264,3487
RAJASTHAN,SIKAR,2006,45,34,1,80,29,0,29,58,60,34,26,120,0,1,11,150,340,86,254,842,53,7,332,0,31,496,1157,9,31,0,165,0,205,238,2123,4156
RAJASTHAN,SIROHI,2006,17,20,1,38,20,0,20,40,26,25,1,52,1,1,7,95,130,33,97,364,35,16,123,1,5,393,714,7,50,1,99,0,157,141,645,1834
RAJASTHAN,TONK,2006,17,31,1,49,12,0,12,24,56,50,6,112,0,0,11,78,334,126,208,757,54,15,237,0,9,1246,1731,5,18,2,249,2,276,170,1330,3877
RAJASTHAN,UDAIPUR,2006,55,71,11,137,74,0,74,148,121,98,23,242,1,2,41,263,546,209,337,1399,220,24,455,0,32,1379,2435,7,99,1,258,0,365,325,2214,6199
SIKKIM,EAST,2006,10,10,1,21,10,0,10,20,5,4,1,10,0,0,3,48,60,7,53,171,5,7,20,1,1,40,91,0,6,0,4,0,10,17,96,344
SIKKIM,NORTH,2006,1,1,0,2,3,0,3,6,0,0,0,0,0,0,0,4,4,0,4,12,0,1,0,0,0,6,10,0,0,0,0,0,0,3,11,34
SIKKIM,SOUTH,2006,6,2,0,8,5,0,5,10,2,2,0,4,0,0,5,18,39,1,38,101,6,0,5,0,0,27,48,0,5,0,2,0,7,10,59,191
SIKKIM,WEST,2006,4,3,1,8,2,0,2,4,1,1,0,2,0,0,1,14,10,0,10,35,1,2,12,0,0,23,47,0,3,0,0,0,3,9,48,134
TAMIL NADU,CHENNAI,2006,131,193,5,329,29,0,29,58,59,41,18,118,5,0,58,560,2363,351,2012,5349,130,14,535,14,1,1198,3222,32,87,88,213,0,420,1330,9123,16168
TAMIL NADU,CHENNAI RLY.,2006,0,0,0,0,1,0,1,2,0,0,0,0,0,0,2,1,72,0,72,147,4,1,4,1,0,18,31,0,2,3,1,0,6,3,233,346
TAMIL NADU,COIMBATORE RURAL,2006,79,46,0,125,18,0,18,36,36,20,16,72,16,0,25,171,952,290,662,2116,91,12,88,2,0,567,1567,8,60,26,67,0,161,807,4364,7435
TAMIL NADU,COIMBATORE URBAN,2006,28,13,0,41,8,0,8,16,7,3,4,14,2,0,24,181,892,211,681,1991,14,11,95,10,1,172,564,5,11,11,30,0,57,261,2198,3974
TAMIL NADU,CUDDALORE,2006,52,80,0,132,21,0,21,42,33,33,0,66,7,0,7,64,354,78,276,786,139,1,20,0,20,548,1090,8,28,65,25,0,126,362,4203,6037
TAMIL NADU,DHARMAPURI,2006,33,34,4,71,9,0,9,18,16,11,5,32,2,0,7,22,133,48,85,297,151,4,31,0,31,626,997,4,33,8,28,0,73,154,1340,2670
TAMIL NADU,DINDIGUL,2006,40,40,0,80,11,0,11,22,40,38,2,80,2,0,14,76,378,70,308,848,28,2,70,1,9,371,835,4,29,8,43,0,84,354,3200,4720
TAMIL NADU,ERODE,2006,43,19,1,63,13,0,13,26,20,14,6,40,6,4,8,87,520,104,416,1145,36,7,46,3,21,425,1153,7,35,3,30,0,75,615,3882,5831
TAMIL NADU,KANCHIPURAM,2006,35,64,0,99,12,0,12,24,16,13,3,32,3,0,24,109,370,71,299,876,53,0,12,0,18,267,1056,12,25,5,22,0,64,706,3722,5475
TAMIL NADU,KANYAKUMARI,2006,23,34,1,58,3,0,3,6,18,13,5,36,0,0,5,135,320,28,292,780,0,1,74,3,18,334,629,4,21,22,28,0,75,199,1818,3061
TAMIL NADU,KARUR,2006,19,13,0,32,5,0,5,10,14,14,0,28,0,0,14,59,231,120,111,535,19,2,22,1,7,180,467,0,7,6,21,0,34,236,1569,2425
TAMIL NADU,KRISHNAGIRI,2006,47,41,0,88,14,0,14,28,29,26,3,58,3,0,17,75,409,242,167,913,121,18,24,0,12,521,1055,7,24,10,23,0,64,359,2181,3935
TAMIL NADU,MADURAI RURAL,2006,36,33,1,70,28,0,28,56,60,25,35,120,4,0,24,99,319,42,277,765,100,10,86,3,10,373,896,2,49,10,38,0,99,314,2849,4448
TAMIL NADU,MADURAI URBAN,2006,23,33,0,56,9,0,9,18,19,7,12,38,3,0,7,62,439,91,348,950,10,10,130,3,6,100,384,4,12,15,35,0,66,125,1419,2464
TAMIL NADU,NAGAPATTINAM,2006,30,42,0,72,9,0,9,18,18,14,4,36,4,0,6,52,240,30,210,542,42,3,67,2,15,398,662,6,73,11,9,0,99,135,2658,3820
TAMIL NADU,NAMAKKAL,2006,28,16,1,45,6,0,6,12,18,17,1,36,2,0,7,35,199,48,151,442,42,1,19,1,7,281,649,0,25,14,18,0,57,298,2214,3232
TAMIL NADU,NILGIRIS,2006,17,22,0,39,5,0,5,10,2,2,0,4,0,0,4,79,120,22,98,323,15,3,6,0,1,175,232,1,13,6,7,0,27,32,914,1422
TAMIL NADU,PERAMBALUR,2006,32,37,0,69,15,0,15,30,16,13,3,32,1,0,7,46,172,51,121,398,30,2,42,1,17,214,480,3,33,3,26,0,65,174,1697,2568
TAMIL NADU,PUDUKOTTAI,2006,25,86,0,111,8,0,8,16,32,25,7,64,0,0,7,64,263,48,215,597,41,13,36,1,23,291,626,5,47,2,39,0,93,221,2580,3784
TAMIL NADU,RAMNATHAPURAM,2006,29,30,0,59,12,0,12,24,24,20,4,48,3,0,6,49,195,28,167,448,63,15,53,1,15,368,657,7,22,6,1,0,36,142,1761,2802
TAMIL NADU,SALEM RURAL,2006,50,29,0,79,21,0,21,42,45,41,4,90,4,0,17,46,160,44,116,387,110,1,17,2,30,771,1311,7,71,7,39,0,124,380,2468,4275
TAMIL NADU,SALEM URBAN,2006,15,17,0,32,7,0,7,14,13,13,0,26,0,0,6,43,291,102,189,631,14,2,36,0,2,129,290,6,3,24,18,0,51,107,1827,2560
TAMIL NADU,SIVAGANGAI,2006,19,42,0,61,5,0,5,10,23,16,7,46,0,0,8,58,170,35,135,406,17,1,51,1,11,249,477,2,8,19,32,0,61,147,1636,2499
TAMIL NADU,THANJAVUR,2006,40,52,0,92,8,0,8,16,55,55,0,110,1,0,16,130,555,103,452,1257,65,3,55,1,28,746,1202,6,80,5,25,0,116,304,2565,4740
TAMIL NADU,THENI,2006,24,30,0,54,5,0,5,10,30,25,5,60,3,0,6,68,229,57,172,535,49,6,72,0,8,387,665,3,21,16,17,0,57,143,1756,2873
TAMIL NADU,THIRUNELVELI RURAL,2006,58,146,2,206,42,0,42,84,31,31,0,62,1,0,26,121,371,45,326,890,3,7,27,2,51,632,1013,7,86,62,44,0,199,291,4114,6124
TAMIL NADU,THIRUNELVELI URBAN,2006,18,42,0,60,4,0,4,8,5,3,2,10,3,0,5,49,134,19,115,325,2,5,31,1,7,85,179,1,8,27,24,0,60,48,644,1143
TAMIL NADU,THIRUVALLUR,2006,23,31,0,54,10,0,10,20,13,2,11,26,2,0,6,74,188,33,155,458,59,1,7,4,1,462,832,2,30,18,21,0,71,298,1821,3071
TAMIL NADU,THIRUVANNAMALAI,2006,36,29,0,65,10,0,10,20,16,16,0,32,0,0,2,59,175,23,152,411,39,7,43,0,12,491,820,1,8,27,31,0,67,228,1881,3095
TAMIL NADU,THIRUVARUR,2006,16,32,0,48,7,0,7,14,17,15,2,34,2,0,10,46,222,42,180,502,45,3,25,0,11,376,576,5,66,18,13,0,102,116,2255,3285
TAMIL NADU,THOOTHUGUDI,2006,57,83,0,140,13,0,13,26,13,10,3,26,0,0,10,117,418,31,387,963,6,7,77,1,14,400,745,2,5,132,20,0,159,240,2542,4157
TAMIL NADU,TRICHY RLY.,2006,0,2,1,3,1,0,1,2,0,0,0,0,1,0,1,1,23,0,23,49,3,0,0,0,0,15,23,0,0,1,0,0,1,5,46,100
TAMIL NADU,TRICHY RURAL,2006,48,24,0,72,12,0,12,24,46,40,6,92,5,0,7,67,235,53,182,549,28,1,26,1,11,280,666,6,22,3,52,0,83,319,2557,3750
TAMIL NADU,TRICHY URBAN,2006,17,19,0,36,3,0,3,6,21,15,6,42,4,0,17,54,427,76,351,929,8,2,71,0,1,73,252,6,4,58,27,0,95,97,2246,3155
TAMIL NADU,VELLORE,2006,80,48,4,132,27,0,27,54,47,37,10,94,2,0,20,173,462,120,342,1119,20,2,40,1,13,659,1156,7,49,25,92,0,173,421,4734,6926
TAMIL NADU,VILLUPURAM,2006,66,56,0,122,39,0,39,78,26,26,0,52,4,0,5,86,304,88,216,703,197,0,15,0,20,515,1359,6,52,17,38,0,113,612,4387,6445
TAMIL NADU,VIRUDHUNAGAR,2006,46,41,0,87,7,0,7,14,28,24,4,56,0,0,15,82,346,33,313,789,44,16,63,2,8,370,712,1,30,71,51,0,153,209,2727,4157
TRIPURA,DHALAI,2006,21,8,0,29,16,0,16,32,14,8,6,28,3,1,3,22,24,1,23,77,17,1,6,0,7,38,90,2,19,0,22,0,43,21,109,354
TRIPURA,NORTH,2006,34,19,1,54,45,0,45,90,26,18,8,52,0,0,24,39,96,1,95,255,23,8,24,7,13,110,211,3,47,0,143,0,193,26,165,853
TRIPURA,SOUTH,2006,25,13,0,38,51,0,51,102,19,8,11,38,3,0,13,47,121,8,113,305,36,6,22,1,7,162,272,9,81,0,137,0,227,38,297,1088
TRIPURA,WEST,2006,74,12,0,86,77,0,77,154,46,28,18,92,12,0,31,74,151,21,130,419,78,8,32,4,8,154,398,21,60,0,169,0,250,114,520,1645
UTTAR PRADESH,AGRA,2006,123,190,43,356,26,0,26,52,175,134,41,350,9,1,76,250,1524,916,608,3384,216,134,266,9,14,448,1490,63,133,152,351,0,699,403,1492,6098
UTTAR PRADESH,ALIGARH,2006,177,217,37,431,49,0,49,98,122,90,32,244,4,3,66,110,772,372,400,1727,206,73,185,2,13,312,865,50,43,39,179,0,311,74,1118,3851
UTTAR PRADESH,ALLAHABAD,2006,132,93,39,264,22,0,22,44,75,64,11,150,3,0,40,187,523,268,255,1276,83,64,155,15,11,279,917,46,40,46,156,0,288,310,1321,3640
UTTAR PRADESH,AMBEDKAR NAGAR,2006,24,43,12,79,10,0,10,20,48,42,6,96,2,0,19,52,105,19,86,283,35,40,20,3,7,199,360,15,20,14,83,0,132,56,184,991
UTTAR PRADESH,AURAIYA,2006,56,46,17,119,10,0,10,20,42,25,17,84,3,0,29,29,76,21,55,213,27,14,23,1,7,132,319,22,13,6,22,0,63,115,321,1011
UTTAR PRADESH,AZAMGARH,2006,64,58,30,152,13,0,13,26,21,20,1,42,1,0,57,71,164,59,105,457,58,20,34,4,0,241,357,29,13,24,68,0,134,0,545,1515
UTTAR PRADESH,BADAUN,2006,169,155,54,378,29,0,29,58,64,42,22,128,1,0,15,41,161,26,135,379,21,19,20,1,16,178,263,33,38,11,34,0,116,8,838,1906
UTTAR PRADESH,BAGHPAT,2006,95,61,9,165,12,0,12,24,43,27,16,86,6,0,30,43,154,66,88,387,39,13,44,2,0,122,315,12,11,24,60,0,107,95,286,1161
UTTAR PRADESH,BAHRAICH,2006,56,38,18,112,21,0,21,42,44,33,11,88,4,10,11,51,134,32,102,344,41,26,34,3,5,178,351,24,25,15,35,0,99,64,451,1288
UTTAR PRADESH,BALLIA,2006,35,53,22,110,10,0,10,20,11,8,3,22,2,1,8,53,99,33,66,262,52,15,26,1,3,147,271,11,8,14,20,0,53,27,195,813
UTTAR PRADESH,BALRAMPUR,2006,14,16,8,38,8,0,8,16,15,11,4,30,1,0,6,16,46,11,35,115,9,5,14,1,0,51,105,9,11,3,15,0,38,25,113,386
UTTAR PRADESH,BANDA,2006,50,21,16,87,15,0,15,30,14,9,5,28,1,1,11,46,90,18,72,239,26,20,24,1,6,94,176,17,20,6,15,0,58,5,399,898
UTTAR PRADESH,BARABANKI,2006,79,56,10,145,21,0,21,42,52,49,3,104,3,1,24,56,174,39,135,432,40,55,18,0,4,249,386,25,41,48,67,0,181,20,732,1775
UTTAR PRADESH,BAREILLY,2006,180,189,35,404,45,0,45,90,93,81,12,186,11,0,50,118,444,175,269,1067,99,101,147,12,8,303,940,31,70,64,196,0,361,270,1475,3941
UTTAR PRADESH,BASTI,2006,30,23,15,68,10,0,10,20,15,15,0,30,2,1,9,32,92,36,56,228,23,19,41,2,3,114,245,12,8,21,30,0,71,43,285,830
UTTAR PRADESH,BIJNOR,2006,86,67,17,170,25,0,25,50,51,46,5,102,4,0,22,31,197,57,140,451,44,24,64,2,2,289,547,18,25,75,105,0,223,122,252,1522
UTTAR PRADESH,BULANDSHAHAR,2006,177,118,19,314,27,0,27,54,69,49,20,138,1,0,28,49,298,97,201,674,67,29,132,8,1,319,775,33,63,150,102,0,348,219,1024,2933
UTTAR PRADESH,CHANDOLI,2006,27,22,16,65,3,0,3,6,15,12,3,30,2,1,5,18,45,26,19,116,8,25,43,2,0,94,172,12,5,41,41,0,99,0,220,645
UTTAR PRADESH,CHITRAKOOT DHAM,2006,36,8,7,51,13,0,13,26,7,3,4,14,1,0,3,25,42,18,24,113,11,8,4,0,3,40,100,9,9,0,8,0,26,34,130,398
UTTAR PRADESH,DEORIA,2006,32,29,22,83,5,0,5,10,19,14,5,38,0,0,14,54,95,39,56,258,58,5,38,6,7,133,293,23,8,2,23,0,56,46,392,1011
UTTAR PRADESH,ETAH,2006,138,140,32,310,28,0,28,56,64,26,38,128,4,0,20,44,229,111,118,526,55,26,77,1,13,156,546,46,26,31,55,0,158,218,610,2013
UTTAR PRADESH,ETAWAH,2006,80,60,13,153,10,0,10,20,66,36,30,132,0,0,35,29,92,58,34,248,7,35,39,4,4,71,329,30,18,22,30,0,100,169,708,1522
UTTAR PRADESH,FAIZABAD,2006,45,35,14,94,14,0,14,28,34,28,6,68,2,1,30,79,185,76,109,482,37,37,85,2,8,134,418,12,18,24,54,0,108,115,358,1323
UTTAR PRADESH,FATEHGARH,2006,85,94,21,200,9,0,9,18,38,24,14,76,2,1,17,32,99,47,52,250,27,13,19,6,0,71,156,37,10,9,30,0,86,20,365,1005
UTTAR PRADESH,FATEHPUR,2006,87,37,32,156,9,0,9,18,22,20,2,44,1,0,11,46,79,27,52,216,11,19,34,0,1,108,304,27,14,21,18,0,80,131,457,1165
UTTAR PRADESH,FIROZABAD,2006,127,141,35,303,16,0,16,32,92,57,35,184,15,2,90,65,359,212,147,890,89,52,67,3,8,299,521,35,29,38,106,0,208,3,684,2355
UTTAR PRADESH,G.R.P.,2006,18,22,6,46,1,0,1,2,7,3,4,14,5,0,22,0,761,72,689,1549,13,24,39,4,0,7,92,0,18,24,0,0,42,5,707,1683
UTTAR PRADESH,GAUTAMBUDH NAGAR,2006,87,67,16,170,26,0,26,52,52,31,21,104,6,2,37,115,946,608,338,2052,61,52,160,4,0,19,312,13,35,57,59,0,164,16,571,2401
UTTAR PRADESH,GHAZIABAD,2006,146,143,51,340,29,0,29,58,109,86,23,218,0,5,44,114,1109,715,394,2381,70,91,238,4,5,61,855,41,26,93,190,0,350,386,1252,4207
UTTAR PRADESH,GHAZIPUR,2006,44,46,16,106,8,0,8,16,14,11,3,28,3,0,18,33,103,50,53,260,46,11,35,3,5,129,230,22,8,17,33,0,80,1,195,790
UTTAR PRADESH,GONDA,2006,55,63,19,137,22,0,22,44,44,35,9,88,5,0,30,77,167,76,91,446,36,35,76,1,4,162,378,28,27,23,7,0,85,64,335,1280
UTTAR PRADESH,GORAKHPUR,2006,89,57,36,182,23,0,23,46,44,39,5,88,3,1,36,98,318,179,139,774,97,51,59,14,2,305,776,16,24,45,70,0,155,248,568,2204
UTTAR PRADESH,HAMIRPUR,2006,36,20,18,74,8,0,8,16,6,5,1,12,1,0,3,16,33,6,27,86,11,7,9,2,0,31,60,12,16,7,11,0,46,0,286,533
UTTAR PRADESH,HARDOI,2006,87,58,38,183,30,0,30,60,42,37,5,84,0,0,17,38,150,29,121,355,10,29,47,2,6,282,518,35,55,26,53,0,169,142,637,1784
UTTAR PRADESH,HATHRAS,2006,71,87,15,173,23,0,23,46,45,30,15,90,8,0,37,51,220,108,112,536,63,21,47,0,0,158,384,22,50,28,64,0,164,95,415,1520
UTTAR PRADESH,J.P.NAGAR,2006,72,53,12,137,21,0,21,42,28,23,5,56,3,1,20,34,131,45,86,320,37,17,42,5,2,21,257,14,22,57,46,0,139,133,433,1204
UTTAR PRADESH,JALAUN,2006,48,37,14,99,4,0,4,8,29,20,9,58,2,1,6,32,81,33,48,203,16,25,19,0,3,4,139,36,31,18,46,0,131,72,492,1016
UTTAR PRADESH,JAUNPUR,2006,62,51,20,133,18,0,18,36,25,21,4,50,3,0,29,42,161,60,101,396,39,36,83,4,6,318,532,46,26,34,83,0,189,46,635,1767
UTTAR PRADESH,JHANSI,2006,47,18,30,95,8,0,8,16,12,6,6,24,1,2,6,29,128,63,65,294,10,15,34,4,0,47,141,21,19,45,18,0,103,31,302,827
UTTAR PRADESH,KANNAUJ,2006,45,60,12,117,6,0,6,12,41,34,7,82,1,0,10,17,97,25,72,222,15,12,27,1,3,24,142,19,31,20,41,0,111,60,384,926
UTTAR PRADESH,KANPUR DEHAT,2006,50,33,7,90,16,0,16,32,31,25,6,62,4,0,17,34,112,9,103,279,44,15,37,0,4,223,476,50,40,18,41,0,149,153,325,1254
UTTAR PRADESH,KANPUR NAGAR,2006,144,97,34,275,27,0,27,54,117,87,30,234,12,0,63,172,837,605,232,1921,128,129,250,6,4,368,999,67,64,179,273,0,583,114,1651,4736
UTTAR PRADESH,KAUSHAMBI,2006,50,29,11,90,15,0,15,30,19,14,5,38,1,0,10,37,44,12,32,136,12,6,9,0,0,87,194,17,12,19,26,0,74,80,250,734
UTTAR PRADESH,KHIRI,2006,105,96,41,242,39,0,39,78,68,60,8,136,1,1,26,55,169,43,126,421,42,25,49,3,6,367,633,60,47,42,35,0,184,141,709,2127
UTTAR PRADESH,KUSHI NAGAR,2006,20,28,21,69,9,0,9,18,20,17,3,40,0,0,6,54,107,33,74,274,65,25,27,9,8,194,485,24,15,19,20,0,78,157,178,1006
UTTAR PRADESH,LALITPUR,2006,19,6,13,38,7,0,7,14,12,10,2,24,1,0,5,22,43,10,33,114,15,8,23,0,2,41,140,9,16,11,35,0,71,51,130,469
UTTAR PRADESH,LUCKNOW,2006,167,185,40,392,51,0,51,102,205,164,41,410,7,3,241,462,2296,1280,1016,5305,267,210,464,34,2,63,1460,39,100,160,374,0,673,420,2312,8102
UTTAR PRADESH,MAHARAJGANJ,2006,25,8,9,42,21,0,21,42,22,19,3,44,1,2,9,26,52,18,34,142,29,9,37,5,0,87,231,12,17,22,13,0,64,64,202,672
UTTAR PRADESH,MAHOBA,2006,44,13,14,71,3,0,3,6,9,7,2,18,3,0,9,15,33,11,22,93,19,1,14,0,0,34,99,9,3,9,9,0,30,31,173,445
UTTAR PRADESH,MAINPURI,2006,110,120,26,256,16,0,16,32,42,24,18,84,3,0,27,37,170,73,97,407,39,24,84,2,0,196,351,35,12,8,28,0,83,6,639,1624
UTTAR PRADESH,MATHURA,2006,104,121,19,244,30,0,30,60,57,39,18,114,5,0,49,105,596,357,239,1351,91,72,202,3,16,197,860,25,66,43,126,0,260,279,942,3148
UTTAR PRADESH,MAU,2006,33,43,14,90,7,0,7,14,24,23,1,48,2,0,12,67,112,24,88,305,77,16,54,4,6,80,306,10,8,38,18,0,74,69,212,906
UTTAR PRADESH,MEERUT,2006,185,209,28,422,37,0,37,74,108,85,23,216,6,2,86,149,1003,540,463,2249,135,69,204,12,7,144,701,21,74,91,246,0,432,130,1126,4072
UTTAR PRADESH,MIRZAPUR,2006,51,26,17,94,14,0,14,28,18,10,8,36,1,0,12,39,101,33,68,254,22,14,32,0,0,106,288,22,11,9,53,0,95,114,152,814
UTTAR PRADESH,MORADABAD,2006,151,138,32,321,44,0,44,88,94,83,11,188,5,4,37,103,557,204,353,1263,75,69,98,4,0,81,479,23,69,142,243,0,477,152,1538,3659
UTTAR PRADESH,MUZAFFARNAGAR,2006,230,164,32,426,31,0,31,62,120,91,29,240,10,6,86,84,628,293,335,1442,144,44,119,5,0,14,326,39,46,88,172,0,345,0,1266,3328
UTTAR PRADESH,PILIBHIT,2006,47,23,8,78,13,0,13,26,27,20,7,54,2,1,8,12,65,12,53,153,9,38,62,6,0,2,162,16,39,37,45,0,137,45,1000,1505
UTTAR PRADESH,PRATAPGARH,2006,64,79,18,161,30,0,30,60,61,50,11,122,1,5,26,119,176,65,111,503,109,42,68,5,14,263,592,30,30,14,108,0,182,91,473,1826
UTTAR PRADESH,RAIBAREILLY,2006,53,78,19,150,21,0,21,42,40,35,5,80,2,0,13,54,188,51,137,445,44,28,35,0,1,274,519,23,40,28,170,0,261,137,344,1592
UTTAR PRADESH,RAMPUR,2006,57,65,17,139,11,0,11,22,43,37,6,86,2,0,22,37,242,55,187,545,39,35,73,5,6,9,263,13,32,4,4,0,53,96,646,1458
UTTAR PRADESH,SAHARANPUR,2006,78,117,18,213,15,0,15,30,41,29,12,82,3,18,36,73,410,167,243,950,85,53,230,6,0,27,541,16,42,48,175,0,281,140,1221,2852
UTTAR PRADESH,SANT KABIRNAGAR,2006,19,15,10,44,4,0,4,8,18,18,0,36,0,0,11,22,46,10,36,125,18,13,23,3,0,84,165,7,7,23,25,0,62,24,143,515
UTTAR PRADESH,SHAHJAHANPUR,2006,115,101,28,244,21,0,21,42,57,37,20,114,5,0,20,33,141,47,94,340,28,30,48,5,2,67,350,34,21,25,8,0,88,170,614,1573
UTTAR PRADESH,SHRAWASTI,2006,11,11,6,28,6,0,6,12,21,16,5,42,2,3,3,21,33,2,31,95,20,8,18,1,0,94,167,16,12,10,0,0,38,26,91,413
UTTAR PRADESH,SIDHARTHNAGAR,2006,17,4,14,35,4,0,4,8,28,28,0,56,4,0,10,43,86,25,61,229,18,20,48,2,0,75,210,15,12,58,19,0,104,47,269,793
UTTAR PRADESH,SITAPUR,2006,124,115,48,287,47,0,47,94,78,68,10,156,2,0,33,82,387,51,336,891,60,38,58,0,30,273,616,58,68,34,83,0,243,157,862,2637
UTTAR PRADESH,SONBHADRA,2006,31,21,17,69,8,0,8,16,4,3,1,8,0,0,5,25,41,12,29,112,11,12,24,0,3,53,192,10,14,32,9,0,65,89,100,509
UTTAR PRADESH,ST.RAVIDASNAGAR,2006,19,21,11,51,2,0,2,4,5,4,1,10,1,0,10,24,47,16,31,129,18,17,13,0,1,75,171,9,6,14,19,0,48,47,79,438
UTTAR PRADESH,SULTANPUR,2006,77,104,21,202,25,0,25,50,31,26,5,62,3,0,32,81,169,62,107,454,41,37,44,1,1,130,363,23,21,23,55,0,122,109,391,1419
UTTAR PRADESH,UNNAO,2006,96,70,35,201,37,0,37,74,44,40,4,88,3,1,19,44,159,53,106,385,37,16,25,0,0,217,445,37,35,26,58,0,156,150,466,1575
UTTAR PRADESH,VARANASI,2006,73,65,19,157,16,0,16,32,45,36,9,90,0,5,40,123,714,520,194,1596,120,69,102,18,6,158,528,23,10,46,90,0,169,55,865,2662
UTTARAKHAND,ALMORA,2006,15,10,3,28,11,0,11,22,5,5,0,10,0,0,11,13,36,1,35,96,11,3,37,1,3,23,96,5,3,1,6,0,15,18,34,249
UTTARAKHAND,BAGESHWAR,2006,11,3,0,14,4,0,4,8,4,4,0,8,0,0,7,9,14,0,14,44,0,0,2,0,1,10,21,4,6,0,7,0,17,8,9,99
UTTARAKHAND,CHAMOLI,2006,5,5,1,11,7,0,7,14,4,0,4,8,0,0,3,20,13,0,13,49,25,3,6,0,1,6,58,5,2,0,4,0,11,17,62,189
UTTARAKHAND,CHAMPAWAT,2006,5,7,0,12,3,0,3,6,1,0,1,2,1,0,3,4,15,0,15,38,3,1,1,1,0,4,20,0,4,0,1,0,5,10,45,109
UTTARAKHAND,DEHRADUN,2006,40,34,8,82,23,0,23,46,43,40,3,86,3,1,26,123,373,126,247,899,94,4,156,1,6,280,695,9,28,52,97,0,186,154,450,2005
UTTARAKHAND,HARIDWAR,2006,54,57,4,115,32,0,32,64,64,52,12,128,10,1,54,78,707,220,487,1557,105,29,166,3,10,316,798,11,45,58,109,0,223,169,80,2162
UTTARAKHAND,NAINITAL,2006,25,19,6,50,9,0,9,18,17,17,0,34,1,0,8,38,155,50,105,357,30,6,26,1,0,68,225,7,7,1,6,0,21,94,261,785
UTTARAKHAND,PAURI GARHWAL,2006,16,10,1,27,4,0,4,8,8,7,1,16,4,0,3,55,42,6,36,146,16,11,8,2,3,53,114,8,3,0,12,0,23,21,50,330
UTTARAKHAND,PITHORAGARH,2006,10,6,3,19,8,0,8,16,3,3,0,6,0,0,7,15,25,0,25,72,6,3,7,2,5,24,47,3,13,0,8,0,24,0,104,252
UTTARAKHAND,RUDRA PRAYAG,2006,4,3,0,7,3,0,3,6,2,2,0,4,0,0,4,16,12,0,12,44,12,1,4,0,3,11,43,8,3,0,3,0,14,12,25,126
UTTARAKHAND,TEHRI GARHWAL,2006,11,6,0,17,9,0,9,18,9,9,0,18,0,0,2,13,22,2,20,59,14,5,10,0,4,7,61,6,0,0,8,0,14,21,24,171
UTTARAKHAND,UDHAMSINGH NAGAR,2006,74,53,14,141,23,0,23,46,46,39,7,92,12,0,26,71,261,120,141,631,156,25,86,3,0,47,317,11,34,0,90,0,135,0,714,1746
UTTARAKHAND,UTTARKASHI,2006,4,2,0,6,11,0,11,22,6,5,1,12,0,0,3,15,21,0,21,60,17,4,5,0,3,5,34,3,5,1,7,0,16,0,77,189
WEST BENGAL,24 PARGANAS NORTH,2006,154,82,39,275,174,0,174,348,186,140,46,372,15,397,29,37,1440,431,1009,3358,180,61,100,22,5,349,720,74,175,5,1049,0,1303,3,3200,7776
WEST BENGAL,24 PARGANAS SOUTH,2006,138,4,34,176,190,0,190,380,155,154,1,310,14,227,17,165,1019,298,721,2461,289,1,110,2,6,390,865,68,157,3,1105,0,1333,67,3235,7396
WEST BENGAL,ASANSOL,2006,42,16,18,76,19,0,19,38,16,12,4,32,3,40,17,9,154,35,119,377,51,3,15,0,3,47,206,13,11,0,158,0,182,87,977,1699
WEST BENGAL,BANKURA,2006,55,38,5,98,51,0,51,102,26,22,4,52,9,16,16,6,205,15,190,457,62,18,24,1,5,294,534,24,43,0,133,0,200,130,121,1282
WEST BENGAL,BIRBHUM,2006,72,10,13,95,57,0,57,114,39,37,2,78,9,31,32,21,264,51,213,621,124,15,25,5,5,146,473,18,34,2,175,0,229,153,375,1625
WEST BENGAL,BURDWAN,2006,90,13,25,128,64,0,64,128,41,30,11,82,12,79,43,38,568,182,386,1308,201,7,112,4,13,158,829,27,91,0,519,0,637,334,1458,3897
WEST BENGAL,COOCHBEHAR,2006,31,8,5,44,124,0,124,248,48,48,0,96,2,0,6,10,135,37,98,288,45,12,41,4,0,78,268,5,116,0,309,0,430,88,630,1697
WEST BENGAL,DAKSHIN DINAJPUR,2006,26,41,16,83,32,0,32,64,49,37,12,98,1,6,4,10,95,9,86,211,36,8,15,4,4,59,203,11,60,0,140,0,211,77,407,1101
WEST BENGAL,DARJEELING,2006,52,2,10,64,30,0,30,60,43,43,0,86,4,37,5,15,448,76,372,957,14,23,8,3,0,239,368,1,44,0,79,0,124,81,544,1682
WEST BENGAL,HOOGHLY,2006,81,56,18,155,43,0,43,86,28,28,0,56,11,122,25,35,511,170,341,1215,254,4,37,3,11,269,848,8,37,0,467,0,512,270,930,3220
WEST BENGAL,HOWRAH,2006,53,5,14,72,60,0,60,120,66,59,7,132,6,66,8,13,639,198,441,1371,160,15,127,3,2,481,1076,26,75,6,368,0,475,288,1152,3633
WEST BENGAL,HOWRAH G.R.P.,2006,9,3,3,15,0,0,0,0,3,1,2,6,3,17,4,1,696,2,694,1417,2,0,21,1,0,2,27,2,5,0,0,0,7,1,53,826
WEST BENGAL,JALPAIGURI,2006,86,40,44,170,118,0,118,236,56,50,6,112,5,19,18,25,497,67,430,1061,32,39,22,6,1,230,590,6,102,0,250,0,358,260,754,2610
WEST BENGAL,KHARAGPUR G.R.P.,2006,2,1,0,3,0,0,0,0,0,0,0,0,1,4,4,0,88,0,88,185,1,0,0,0,0,1,2,1,3,1,0,0,5,0,19,126
WEST BENGAL,KOLKATA,2006,25,72,11,108,38,0,38,76,94,76,18,188,11,56,51,115,2566,581,1985,5365,167,210,963,16,0,1057,2901,4,173,37,276,1,491,488,2950,9381
WEST BENGAL,MALDA,2006,63,58,30,151,74,0,74,148,48,40,8,96,10,10,26,34,399,151,248,878,53,1,4,10,0,580,648,5,110,1,152,0,268,0,434,2102
WEST BENGAL,MURSHIDABAD,2006,95,39,46,180,224,0,224,448,118,111,7,236,6,37,22,6,702,204,498,1475,175,22,63,25,15,875,1423,30,217,3,735,0,985,248,1056,4759
WEST BENGAL,NADIA,2006,101,16,20,137,158,0,158,316,152,134,18,304,14,20,16,16,846,88,758,1758,164,0,143,7,9,608,1181,43,175,1,613,0,832,250,1300,4672
WEST BENGAL,PASCHIM MIDNAPUR,2006,99,57,20,176,79,0,79,158,50,50,0,100,15,26,30,24,327,32,295,749,153,35,28,1,13,88,319,25,73,3,283,0,384,1,1270,2700
WEST BENGAL,PURAB MIDNAPUR,2006,61,37,10,108,71,0,71,142,59,59,0,118,7,14,10,12,262,31,231,567,125,40,43,3,6,32,459,27,37,1,285,0,350,210,1047,2399
WEST BENGAL,PURULIA,2006,41,0,9,50,48,0,48,96,13,13,0,26,3,15,20,4,141,11,130,324,55,1,23,0,0,0,79,20,41,0,136,0,197,0,524,1094
WEST BENGAL,SEALDAH G.R.P.,2006,12,2,1,15,1,0,1,2,5,5,0,10,4,16,8,0,174,0,174,376,2,0,7,2,0,4,17,2,4,0,0,0,6,2,49,295
WEST BENGAL,SILIGURI G.R.P.,2006,3,0,0,3,0,0,0,0,4,4,0,8,0,0,0,0,63,0,63,126,6,0,0,0,0,0,6,0,1,0,0,0,1,0,22,99
WEST BENGAL,UTTAR DINAJPUR,2006,34,72,10,116,76,0,76,152,56,46,10,112,12,8,15,5,293,45,248,626,34,4,16,13,13,312,393,5,53,0,182,0,240,1,767,1981
A & N ISLANDS,ANDAMAN,2006,3,4,1,8,6,0,6,12,5,5,0,10,0,0,5,81,100,6,94,286,10,3,15,4,9,73,116,0,12,4,7,0,23,2,311,655
A & N ISLANDS,NICOBAR,2006,1,0,0,1,0,0,0,0,0,0,0,0,0,0,0,1,1,0,1,3,0,0,0,0,0,5,5,0,2,0,0,0,2,0,11,21
CHANDIGARH,CHANDIGARH,2006,12,21,8,41,19,0,19,38,65,57,8,130,1,3,34,189,1234,529,705,2695,44,59,232,3,5,55,412,10,20,13,102,0,145,14,983,3126
D & N HAVELI,D and N HAVELI,2006,9,0,1,10,6,0,6,12,18,14,4,36,5,0,5,41,61,13,48,173,8,30,10,1,5,35,105,1,5,1,5,0,12,16,172,435
DAMAN & DIU,DAMAN,2006,6,2,0,8,1,0,1,2,3,1,2,6,8,0,1,54,54,30,24,171,19,9,3,1,4,18,76,0,2,0,0,0,2,22,36,243
DAMAN & DIU,DIU,2006,0,1,0,1,2,0,2,4,0,0,0,0,0,0,0,6,9,3,6,24,5,0,0,3,1,0,13,0,0,0,2,0,2,4,12,45
DELHI UT,CENTRAL,2006,22,32,6,60,17,0,17,34,73,52,21,146,0,10,22,63,1036,452,584,2167,5,37,144,4,0,156,360,3,21,14,75,0,113,14,1952,3706
DELHI UT,EAST,2006,39,42,8,89,61,0,61,122,118,87,31,236,3,28,66,168,2096,1268,828,4457,14,39,138,4,8,200,411,9,86,19,205,0,319,8,2214,5573
DELHI UT,GRP(RLY),2006,5,2,0,7,1,0,1,2,11,10,1,22,0,3,3,1,945,33,912,1897,0,6,13,0,1,8,29,1,0,0,0,0,1,1,75,1076
DELHI UT,IGI AIRPORT,2006,2,1,1,4,0,0,0,0,8,5,3,16,0,0,8,2,160,25,135,330,0,4,617,1,0,0,622,0,2,1,1,0,4,0,116,924
DELHI UT,NEW DELHI,2006,7,8,0,15,6,0,6,12,26,17,9,52,0,3,20,42,754,262,492,1573,15,28,239,10,1,29,323,0,31,13,16,0,60,1,1039,2288
DELHI UT,NORTH,2006,28,21,5,54,22,0,22,44,41,34,7,82,0,12,29,78,701,269,432,1521,4,39,124,6,3,135,321,8,27,5,128,0,168,10,1590,3016
DELHI UT,NORTH-EAST,2006,61,66,9,136,93,0,93,186,197,149,48,394,3,26,82,173,1246,685,561,2776,11,34,93,5,2,286,611,28,92,17,176,0,313,180,2509,5389
DELHI UT,NORTH-WEST,2006,128,151,12,291,169,0,169,338,437,287,150,874,4,43,105,456,2690,1769,921,5988,12,48,186,3,4,358,659,28,137,11,412,0,588,48,5704,11146
DELHI UT,SOUTH,2006,66,69,13,148,87,0,87,174,215,169,46,430,2,55,117,350,3820,2302,1518,8164,12,92,379,1,5,206,744,19,141,34,215,0,409,49,4907,10854
DELHI UT,SOUTH-WEST,2006,52,45,11,108,79,0,79,158,161,128,33,322,0,4,48,345,1739,915,824,3875,9,49,199,0,7,134,417,24,84,25,240,0,373,19,3310,6584
DELHI UT,STF,2006,0,10,0,10,0,0,0,0,0,0,0,0,0,0,2,0,1,0,1,4,0,0,8,0,0,0,8,0,0,0,0,0,0,0,18,39
DELHI UT,WEST,2006,66,63,10,139,88,0,88,176,155,128,27,310,2,16,39,272,2310,1386,924,4949,5,66,173,8,2,306,597,17,97,5,260,0,379,37,3371,7368
LAKSHADWEEP,LAKSHADWEEP,2006,0,2,0,2,0,0,0,0,0,0,0,0,0,0,0,2,17,1,16,36,12,0,0,0,4,5,21,0,0,0,1,0,1,0,37,80
PUDUCHERRY,KARAIKAL,2006,2,2,1,5,1,0,1,2,5,5,0,10,0,0,1,18,94,36,58,207,41,2,7,1,10,186,289,1,7,4,0,0,12,42,347,772
PUDUCHERRY,PONDICHERRY,2006,28,22,2,52,8,0,8,16,13,8,5,26,2,0,2,66,466,284,182,1002,153,4,29,1,12,741,1107,2,49,35,19,0,105,167,2094,3915
ANDHRA PRADESH,ADILABAD,2007,112,61,12,185,46,0,46,92,83,72,11,166,4,0,9,211,481,80,401,1186,95,15,179,2,17,1244,1861,21,156,133,335,0,645,309,2160,5685
ANDHRA PRADESH,ANANTAPUR,2007,149,85,3,237,31,0,31,62,87,35,52,174,10,0,20,203,603,76,527,1439,85,13,125,17,8,1073,1719,14,176,194,0,0,384,398,1888,5182
ANDHRA PRADESH,CHITTOOR,2007,129,72,2,203,31,0,31,62,102,47,55,204,27,0,25,217,1134,302,832,2537,74,26,248,5,48,1101,2122,25,118,197,395,0,735,620,2499,7095
ANDHRA PRADESH,CUDDAPAH,2007,96,47,3,146,32,0,32,64,76,68,8,152,4,0,8,163,420,106,314,1015,85,30,221,4,29,982,1818,8,139,94,242,0,483,467,2350,5500
ANDHRA PRADESH,CYBERABAD,2007,186,84,8,278,45,0,45,90,147,100,47,294,21,4,90,1165,2928,1124,1804,7136,88,103,1192,5,74,3641,6291,41,118,55,881,0,1095,1188,2172,14236
ANDHRA PRADESH,EAST GODAVARI,2007,99,114,2,215,30,0,30,60,84,64,20,168,1,0,19,428,1361,398,963,3170,26,75,320,19,52,2538,3722,19,159,131,561,0,870,692,1850,8580
ANDHRA PRADESH,GUNTAKAL RLY.,2007,3,0,0,3,0,0,0,0,2,1,1,4,2,0,2,0,119,0,119,242,0,0,1,4,0,8,15,0,0,4,3,0,7,2,25,175
ANDHRA PRADESH,GUNTUR,2007,157,190,1,348,43,0,43,86,93,79,14,186,4,0,19,251,1128,290,838,2530,60,42,376,18,77,1567,2752,28,292,214,569,0,1103,612,2918,8659
ANDHRA PRADESH,HYDERABAD CITY,2007,121,147,9,277,58,0,58,116,148,74,74,296,6,0,96,993,4542,1685,2857,10179,214,116,1669,7,37,4352,6897,41,216,128,1365,0,1750,502,2624,17391
ANDHRA PRADESH,KARIMNAGAR,2007,123,95,5,223,73,0,73,146,152,135,17,304,3,0,16,301,803,8,795,1926,158,52,432,0,55,2971,4151,61,315,278,687,0,1341,483,1472,8535
ANDHRA PRADESH,KHAMMAM,2007,125,58,5,188,81,0,81,162,104,73,31,208,4,0,27,242,562,93,469,1397,159,20,162,10,28,1137,1979,28,176,272,422,0,898,463,2130,6215
ANDHRA PRADESH,KRISHNA,2007,64,52,1,117,27,0,27,54,57,47,10,114,0,0,10,164,521,65,456,1216,20,16,147,8,53,2370,2921,13,161,150,348,0,672,307,689,5178
ANDHRA PRADESH,KURNOOL,2007,124,119,2,245,36,0,36,72,85,64,21,170,12,0,11,247,406,121,285,1082,88,37,226,12,41,1234,2103,7,327,219,364,0,917,465,2097,6159
ANDHRA PRADESH,MAHABOOBNAGAR,2007,173,63,31,267,87,0,87,174,86,75,11,172,10,0,34,261,759,6,753,1823,87,19,198,4,77,2151,3202,27,132,21,218,0,398,666,1285,6389
ANDHRA PRADESH,MEDAK,2007,128,95,13,236,51,0,51,102,65,56,9,130,2,0,25,268,602,133,469,1499,62,11,253,3,66,1869,3227,49,115,96,346,0,606,963,988,6070
ANDHRA PRADESH,NALGONDA,2007,135,55,4,194,69,0,69,138,87,75,12,174,8,0,45,240,468,109,359,1229,117,16,232,6,82,1816,2987,36,233,112,429,0,810,718,3052,7960
ANDHRA PRADESH,NELLORE,2007,68,81,3,152,44,0,44,88,67,65,2,134,2,0,11,239,718,169,549,1688,63,30,168,5,59,2299,3040,14,203,123,331,0,671,416,1047,5991
ANDHRA PRADESH,NIZAMABAD,2007,151,77,9,237,23,0,23,46,60,48,12,120,22,1,17,287,490,83,407,1307,84,20,161,5,40,1695,2423,25,88,59,455,0,627,418,991,5178
ANDHRA PRADESH,PRAKASHAM,2007,78,63,1,142,40,0,40,80,74,65,9,148,4,0,20,207,511,126,385,1253,27,27,199,12,122,1303,2042,7,171,266,261,0,705,352,1910,5655
ANDHRA PRADESH,RANGA REDDY,2007,72,21,6,99,21,0,21,42,27,10,17,54,3,0,2,110,150,18,132,415,19,8,67,0,26,872,1174,25,40,10,93,0,168,182,416,2170
ANDHRA PRADESH,SECUNDERABAD RLY.,2007,12,0,0,12,0,0,0,0,0,0,0,0,0,0,6,0,339,0,339,684,0,0,8,14,0,13,39,0,2,0,0,0,2,4,47,445
ANDHRA PRADESH,SRIKAKULAM,2007,31,5,0,36,30,0,30,60,19,19,0,38,2,0,8,142,206,16,190,564,35,17,93,4,40,1607,2059,12,99,57,345,0,513,263,883,3898
ANDHRA PRADESH,VIJAYAWADA CITY,2007,33,44,3,80,17,0,17,34,64,49,15,128,0,0,31,225,1377,326,1051,3010,2,44,339,3,18,1671,2342,10,131,202,531,0,874,265,577,5587
ANDHRA PRADESH,VIJAYAWADA RLY.,2007,3,1,0,4,0,0,0,0,0,0,0,0,1,0,4,0,293,0,293,591,2,1,4,0,0,5,18,0,4,1,1,0,6,6,47,373
ANDHRA PRADESH,VISAKHA RURAL,2007,70,36,6,112,12,0,12,24,11,11,0,22,2,0,7,90,111,2,109,321,57,5,73,5,20,1682,2224,7,57,24,167,0,255,382,454,3278
ANDHRA PRADESH,VISAKHAPATNAM,2007,21,23,1,45,24,0,24,48,39,23,16,78,9,1,24,370,1215,417,798,2834,24,65,285,16,9,513,1167,14,100,25,535,0,674,255,1912,5480
ANDHRA PRADESH,VIZIANAGARAM,2007,34,30,0,64,10,0,10,20,23,20,3,46,3,0,5,97,253,1,252,611,17,8,66,5,11,495,841,3,90,46,270,0,409,239,1551,3256
ANDHRA PRADESH,WARANGAL,2007,106,61,5,172,57,0,57,114,138,109,29,276,1,0,15,277,697,202,495,1687,217,8,294,9,63,1690,2750,56,279,50,608,0,993,469,2233,7333
ANDHRA PRADESH,WEST GODAVARI,2007,62,106,0,168,52,0,52,104,117,80,37,234,3,0,8,279,1194,227,967,2678,33,45,365,22,24,2223,3235,22,309,155,573,0,1059,523,1319,7434
ARUNACHAL PRADESH,CHANGLANG,2007,5,4,0,9,7,0,7,14,2,2,0,4,2,0,6,16,35,0,35,94,0,4,2,0,1,33,45,0,5,0,4,0,9,5,40,171
ARUNACHAL PRADESH,DIBANG VALLEY,2007,7,1,0,8,2,0,2,4,4,3,1,8,1,0,2,7,31,3,28,72,1,0,0,0,0,16,20,0,5,0,1,0,6,3,20,101
ARUNACHAL PRADESH,K/KUMEY,2007,2,7,0,9,1,0,1,2,4,4,0,8,0,0,1,11,19,0,19,50,0,1,2,0,0,3,8,0,0,0,1,0,1,2,15,69
ARUNACHAL PRADESH,KAMENG EAST,2007,6,0,0,6,1,0,1,2,4,0,4,8,0,0,2,14,29,7,22,74,1,0,1,0,0,24,27,0,10,0,0,0,10,1,17,110
ARUNACHAL PRADESH,KAMENG WEST,2007,2,0,0,2,1,0,1,2,1,0,1,2,1,0,6,4,26,5,21,63,1,1,5,2,0,19,38,0,2,0,0,0,2,10,23,104
ARUNACHAL PRADESH,LOHIT,2007,17,1,0,18,5,0,5,10,12,12,0,24,0,0,5,19,42,2,40,108,1,0,2,0,3,28,49,0,4,0,0,0,4,15,52,206
ARUNACHAL PRADESH,PAPUM PARE,2007,4,7,0,11,8,0,8,16,20,8,12,40,1,0,23,56,138,76,62,356,7,15,7,3,11,84,141,0,15,0,8,0,23,14,155,576
ARUNACHAL PRADESH,SIANG EAST,2007,5,2,0,7,8,0,8,16,4,3,1,8,3,0,15,28,63,14,49,172,2,2,5,2,1,35,55,0,12,0,1,0,13,8,43,239
ARUNACHAL PRADESH,SIANG UPPER,2007,2,1,0,3,5,0,5,10,0,0,0,0,0,0,1,8,23,0,23,55,0,3,1,0,0,16,22,0,2,0,0,0,2,2,12,76
ARUNACHAL PRADESH,SIANG WEST,2007,6,1,0,7,3,0,3,6,6,5,1,12,2,0,8,30,35,2,33,110,1,9,4,1,2,35,57,0,5,1,3,0,9,5,61,218
ARUNACHAL PRADESH,SUBANSIRI LOWER,2007,0,2,1,3,3,0,3,6,4,2,2,8,3,0,3,12,24,2,22,66,2,1,1,0,2,26,36,0,3,0,0,0,3,4,32,123
ARUNACHAL PRADESH,SUBANSIRI UPPER,2007,1,2,1,4,3,0,3,6,4,4,0,8,1,0,0,10,22,4,18,55,0,3,3,0,2,32,43,0,5,0,2,0,7,3,47,141
ARUNACHAL PRADESH,TAWANG,2007,3,0,0,3,1,0,1,2,0,0,0,0,0,0,1,9,10,0,10,30,0,0,0,0,0,4,11,0,2,0,0,0,2,7,9,46
ARUNACHAL PRADESH,TIRAP,2007,7,1,0,8,0,0,0,0,3,1,2,6,2,0,1,16,16,1,15,51,0,2,0,2,0,20,27,0,2,0,0,0,2,3,26,101
ARUNACHAL PRADESH,UPPER DIBANG VALLEY,2007,1,0,0,1,0,0,0,0,0,0,0,0,0,0,1,0,0,0,0,1,0,0,0,0,0,0,0,0,0,0,0,0,0,0,3,5
ASSAM,BARPETA,2007,40,7,3,50,83,0,83,166,87,81,6,174,19,2,19,151,211,19,192,613,213,40,23,3,12,112,580,10,16,0,180,0,206,177,631,2039
ASSAM,BASKA,2007,29,11,0,40,7,0,7,14,19,13,6,38,0,1,5,20,26,2,24,78,10,1,6,0,8,77,118,2,7,0,7,0,16,16,82,334
ASSAM,BONGAIGAON,2007,15,2,2,19,40,0,40,80,45,38,7,90,11,1,5,72,107,2,105,303,53,16,25,4,8,71,335,5,13,0,124,0,142,158,333,1110
ASSAM,C.I.D.,2007,0,0,0,0,0,0,0,0,0,0,0,0,0,0,0,0,0,0,0,0,0,0,3,0,0,0,3,0,0,0,0,0,0,0,23,26
ASSAM,CACHAR,2007,61,20,0,81,58,0,58,116,117,105,12,234,28,2,13,173,505,37,468,1226,250,43,44,6,40,326,1083,4,30,0,364,0,398,374,1219,3677
ASSAM,CHIRANG,2007,12,0,0,12,10,0,10,20,20,17,3,40,18,0,9,11,32,10,22,102,45,8,7,2,12,21,116,0,13,0,55,0,68,21,219,515
ASSAM,DARRANG,2007,23,8,1,32,61,0,61,122,45,40,5,90,5,1,15,69,135,17,118,360,72,20,38,5,15,210,465,3,111,1,81,0,196,105,298,1322
ASSAM,DHEMAJI,2007,20,19,7,46,70,0,70,140,42,28,14,84,5,0,6,28,150,2,148,339,24,7,23,3,10,232,337,0,40,0,121,0,161,38,309,1154
ASSAM,DHUBRI,2007,44,42,1,87,148,0,148,296,138,111,27,276,7,2,17,102,198,11,187,524,664,76,103,16,32,311,1561,12,128,0,392,0,532,359,465,3257
ASSAM,DIBRUGARH,2007,112,17,2,131,55,0,55,110,93,2,91,186,9,0,23,87,436,28,408,991,23,35,6,3,15,364,549,0,29,0,30,0,59,103,464,1906
ASSAM,G.R.P.,2007,2,0,0,2,3,0,3,6,3,3,0,6,1,0,6,0,73,40,33,153,2,0,2,0,2,5,11,0,0,0,12,0,12,0,161,272
ASSAM,GOALPARA,2007,31,5,0,36,51,0,51,102,51,39,12,102,8,0,13,65,174,26,148,434,30,6,36,5,17,115,344,4,45,0,105,0,154,135,235,1131
ASSAM,GOLAGHAT,2007,80,23,6,109,64,0,64,128,78,58,20,156,2,0,29,95,281,25,256,688,0,23,33,4,18,280,445,0,50,0,99,0,149,87,216,1468
ASSAM,GUWAHATI CITY,2007,68,11,19,98,71,0,71,142,284,135,149,568,14,0,81,458,1941,1380,561,4435,73,90,109,15,12,205,668,6,24,0,106,0,136,164,178,3929
ASSAM,HAILAKANDI,2007,27,2,0,29,26,0,26,52,42,30,12,84,8,0,1,48,71,8,63,199,126,6,19,3,20,29,223,3,15,0,60,0,78,20,345,871
ASSAM,JORHAT,2007,46,14,6,66,45,0,45,90,70,59,11,140,2,0,16,92,299,48,251,708,90,20,24,3,13,175,385,3,21,0,55,0,79,60,580,1634
ASSAM,KAMRUP,2007,47,24,40,111,74,0,74,148,63,36,27,126,25,0,26,96,393,124,269,933,85,22,87,8,12,331,654,0,7,0,144,0,151,109,671,2264
ASSAM,KARBI ANGLONG,2007,73,39,1,113,16,0,16,32,43,15,28,86,9,1,10,12,161,32,129,354,44,17,6,4,6,47,166,3,10,0,18,0,31,42,213,775
ASSAM,KARIMGANJ,2007,29,19,1,49,49,0,49,98,40,37,3,80,11,0,13,71,182,0,182,459,185,12,18,7,22,121,399,13,5,0,82,0,100,34,253,1167
ASSAM,KOKRAJHAR,2007,41,8,0,49,42,0,42,84,47,38,9,94,4,0,13,58,176,2,174,427,58,9,13,5,0,282,402,1,35,0,82,0,118,35,137,1046
ASSAM,LAKHIMPUR,2007,41,18,5,64,62,0,62,124,84,82,2,168,6,0,8,102,166,1,165,448,87,30,28,2,16,387,590,0,47,0,147,0,194,40,482,1758
ASSAM,MORIGAON,2007,21,10,6,37,65,0,65,130,57,57,0,114,6,0,3,73,123,5,118,328,53,22,47,3,3,379,538,3,63,0,110,0,176,31,232,1310
ASSAM,N.C.HILLS,2007,34,19,0,53,5,0,5,10,12,8,4,24,2,0,10,11,44,0,44,111,14,2,4,0,2,18,56,2,4,0,2,0,8,16,91,292
ASSAM,NAGAON,2007,92,49,5,146,114,0,114,228,208,203,5,416,51,1,58,236,394,89,305,1134,229,53,74,5,48,578,1286,11,5,9,225,0,250,299,796,3540
ASSAM,NALBARI,2007,21,15,0,36,12,0,12,24,32,22,10,64,5,0,11,61,90,4,86,257,10,10,8,0,9,145,218,3,18,0,32,0,53,36,179,697
ASSAM,R.P.O.,2007,5,0,0,5,1,0,1,2,0,0,0,0,5,0,0,0,7,0,7,19,1,0,0,0,0,0,1,0,0,0,0,0,0,0,41,60
ASSAM,SIBSAGAR,2007,78,43,1,122,53,0,53,106,54,43,11,108,8,0,28,119,295,31,264,745,39,20,34,1,6,145,399,0,24,0,104,0,128,154,969,2175
ASSAM,SONITPUR,2007,102,16,2,120,70,0,70,140,80,75,5,160,9,0,23,128,460,23,437,1080,97,29,40,3,10,148,574,8,20,0,155,0,183,247,1079,2726
ASSAM,TINSUKIA,2007,143,6,0,149,57,0,57,114,91,76,15,182,8,0,21,102,533,9,524,1197,13,36,22,2,7,21,101,0,9,0,92,0,101,0,1056,2219
ASSAM,UDALGURI,2007,37,4,1,42,25,0,25,50,26,20,6,52,13,1,14,63,91,7,84,273,11,0,13,3,5,40,87,4,0,0,16,0,20,15,226,608
BIHAR,ARARIA,2007,48,185,5,238,47,0,47,94,27,5,22,54,41,0,51,67,228,22,206,615,95,24,51,0,58,251,515,11,51,0,86,0,148,36,1542,2904
BIHAR,ARWAL,2007,19,12,2,33,8,0,8,16,4,0,4,8,5,0,4,18,53,3,50,133,30,15,10,0,6,0,102,12,0,0,5,0,17,41,298,542
BIHAR,AURANGABAD,2007,68,12,2,82,30,0,30,60,35,28,7,70,29,1,27,82,289,21,268,717,216,33,77,4,33,1002,1558,36,25,0,30,0,91,193,261,2485
BIHAR,BAGAHA,2007,37,8,2,47,38,0,38,76,58,26,32,116,4,0,9,20,170,3,167,373,98,20,40,6,6,202,390,6,10,0,10,0,26,18,1227,1989
BIHAR,BANKA,2007,56,12,6,74,74,0,74,148,34,17,17,68,24,2,28,84,111,12,99,360,264,26,49,1,13,0,389,24,4,0,37,0,65,36,1023,1908
BIHAR,BEGUSARAI,2007,100,145,2,247,25,0,25,50,85,38,47,170,8,0,73,55,329,50,279,794,272,41,56,2,21,501,1082,43,15,0,34,0,92,189,1201,3197
BIHAR,BETTIAH,2007,61,8,5,74,23,0,23,46,17,15,2,34,12,0,15,40,208,12,196,483,202,29,18,5,9,1116,1482,21,12,0,30,0,63,103,752,2686
BIHAR,BHABHUA,2007,50,28,11,89,12,0,12,24,25,8,17,50,7,0,19,61,192,8,184,471,191,37,28,0,18,372,718,24,5,0,30,0,59,72,566,1748
BIHAR,BHAGALPUR,2007,92,85,11,188,25,0,25,50,76,59,17,152,15,4,31,114,425,115,310,1014,210,20,75,3,13,604,998,21,33,2,16,0,72,73,1072,3020
BIHAR,BHOJPUR,2007,112,133,5,250,41,0,41,82,57,40,17,114,11,2,47,112,333,65,268,838,222,58,100,1,45,1381,1930,42,60,0,83,0,185,123,145,3113
BIHAR,BUXAR,2007,36,75,6,117,13,0,13,26,32,19,13,64,11,0,29,51,166,32,134,423,154,35,43,1,38,193,519,23,37,0,34,0,94,55,435,1467
BIHAR,DARBHANGA,2007,72,109,5,186,47,0,47,94,91,60,31,182,10,1,19,63,318,29,289,729,55,76,149,1,40,97,502,39,41,0,59,0,139,84,2012,3388
BIHAR,GAYA,2007,157,170,11,338,28,0,28,56,59,55,4,118,48,8,90,118,439,128,311,1142,316,6,62,0,61,1431,1969,74,15,0,15,0,104,93,205,3406
BIHAR,GOPALGANJ,2007,48,79,6,133,9,0,9,18,21,14,7,42,11,0,32,59,203,39,164,508,193,3,49,0,12,60,403,22,15,0,46,0,83,86,1476,2430
BIHAR,JAMALPUR RLY.,2007,6,3,0,9,1,0,1,2,2,0,2,4,11,1,10,0,59,7,52,140,4,0,1,0,0,0,5,0,2,0,0,0,2,0,92,192
BIHAR,JAMUI,2007,51,30,1,82,46,0,46,92,31,14,17,62,20,2,26,44,104,6,98,300,166,17,42,1,16,340,630,8,12,0,20,0,40,48,568,1593
BIHAR,JEHANABAD,2007,40,16,3,59,7,0,7,14,27,18,9,54,11,1,16,26,85,1,84,224,87,10,18,0,8,65,235,19,7,0,24,0,50,47,802,1319
BIHAR,KATIHAR,2007,71,50,1,122,149,0,149,298,135,90,45,270,8,2,26,55,165,23,142,421,200,107,119,0,13,418,902,14,25,0,27,0,66,45,988,2618
BIHAR,KATIHAR RLY.,2007,6,0,0,6,2,0,2,4,7,4,3,14,9,2,10,10,238,8,230,507,13,2,14,0,0,0,30,0,0,0,0,0,0,1,150,464
BIHAR,KHAGARIA,2007,48,70,0,118,21,0,21,42,44,14,30,88,8,1,26,16,86,7,79,223,241,16,16,2,16,211,559,14,15,0,12,0,41,57,804,1724
BIHAR,KISHANGANJ,2007,23,12,0,35,53,0,53,106,65,40,25,130,7,4,11,38,108,22,86,276,80,15,19,0,11,115,270,8,25,0,18,0,51,30,398,1040
BIHAR,LAKHISARAI,2007,32,21,0,53,31,0,31,62,36,18,18,72,5,0,22,31,104,6,98,266,83,10,32,0,12,188,360,10,14,0,14,0,38,35,550,1230
BIHAR,MADHEPURA,2007,65,18,1,84,32,0,32,64,36,21,15,72,12,0,34,29,120,14,106,315,139,4,21,1,12,22,229,7,3,0,18,4,32,30,848,1456
BIHAR,MADHUBANI,2007,76,176,11,263,47,0,47,94,71,46,25,142,17,2,16,71,228,16,212,562,318,31,40,0,24,913,1391,27,36,0,29,0,92,65,1427,3625
BIHAR,MOTIHARI,2007,111,88,9,208,25,0,25,50,104,71,33,208,25,2,41,128,444,84,360,1084,348,44,29,1,34,1728,2268,61,20,0,37,0,118,84,970,4333
BIHAR,MUNGER,2007,76,63,0,139,25,0,25,50,52,26,26,104,5,0,37,40,237,56,181,556,246,8,33,3,6,10,348,10,0,0,52,0,62,42,1092,2037
BIHAR,MUZAFFARPUR,2007,143,26,19,188,77,0,77,154,169,64,105,338,31,6,74,197,875,173,702,2058,402,89,119,0,36,12,908,93,12,0,87,0,192,250,3031,5748
BIHAR,MUZAFFARPUR RLY.,2007,12,0,0,12,2,0,2,4,4,0,4,8,4,0,15,10,331,16,315,691,2,0,13,0,0,9,35,1,0,0,0,0,1,11,171,585
BIHAR,NALANDA,2007,102,62,15,179,14,0,14,28,105,51,54,210,18,3,41,72,406,34,372,946,160,71,105,0,17,972,1585,57,33,0,104,0,194,260,1142,3759
BIHAR,NAUGACHIA,2007,30,10,0,40,7,0,7,14,14,4,10,28,2,0,11,23,58,15,43,152,119,14,35,0,5,13,281,9,6,0,18,0,33,95,519,988
BIHAR,NAWADAH,2007,75,103,2,180,38,0,38,76,29,15,14,58,7,1,18,51,113,10,103,303,199,25,61,1,11,322,812,15,6,1,22,0,44,193,510,1803
BIHAR,PATNA,2007,317,115,12,444,74,0,74,148,313,65,248,626,57,0,380,644,1606,946,660,4293,497,53,216,3,2,65,1121,80,19,0,296,0,395,285,9030,14064
BIHAR,PATNA RLY.,2007,15,10,3,28,2,0,2,4,8,2,6,16,11,3,10,0,536,27,509,1096,6,9,27,0,0,0,44,2,12,0,2,0,16,2,177,835
BIHAR,PURNEA,2007,101,79,11,191,219,0,219,438,143,58,85,286,31,1,54,101,220,50,170,627,175,45,68,1,22,146,561,17,61,0,63,4,145,104,916,2582
BIHAR,ROHTAS,2007,89,207,0,296,23,0,23,46,29,26,3,58,11,0,36,106,287,35,252,727,124,45,12,5,25,175,636,58,21,0,34,0,113,250,1288,2825
BIHAR,SAHARSA,2007,50,123,4,177,17,0,17,34,35,4,31,70,9,1,57,39,128,8,120,362,218,66,61,1,8,148,535,14,31,0,22,0,67,33,954,2019
BIHAR,SAMASTIPUR,2007,78,205,33,316,54,0,54,108,98,29,69,196,14,17,42,86,320,55,265,799,312,29,37,0,47,311,937,55,11,7,42,25,140,201,1130,3154
BIHAR,SARAN,2007,112,345,13,470,57,0,57,114,41,30,11,82,39,3,93,110,410,57,353,1065,331,44,165,0,53,1268,1970,47,4,0,39,0,90,109,273,3556
BIHAR,SHEIKHPURA,2007,25,13,1,39,4,0,4,8,11,6,5,22,6,0,9,11,69,3,66,164,70,5,16,0,6,176,292,3,5,0,4,0,12,19,312,765
BIHAR,SHEOHAR,2007,25,24,6,55,13,0,13,26,8,3,5,16,1,0,2,8,35,9,26,81,97,4,12,0,2,47,166,1,13,0,8,1,23,4,123,434
BIHAR,SITAMARHI,2007,55,14,3,72,12,0,12,24,52,43,9,104,27,3,36,90,235,50,185,626,180,39,50,28,23,272,633,30,13,0,30,22,95,41,1410,2665
BIHAR,SIWAN,2007,80,61,15,156,17,0,17,34,75,21,54,150,24,2,70,75,202,73,129,575,121,15,85,5,34,782,1126,32,9,2,45,0,88,84,577,2412
BIHAR,SUPAUL,2007,44,73,3,120,43,0,43,86,34,19,15,68,11,1,39,47,168,16,152,434,239,24,34,1,13,139,476,14,69,0,17,0,100,26,573,1612
BIHAR,VAISHALI,2007,120,35,12,167,23,0,23,46,131,74,57,262,9,2,51,157,354,26,328,927,267,62,51,2,36,211,765,68,46,0,36,0,150,136,1891,3700
CHHATTISGARH,BALRAMPUR,2007,34,14,3,51,46,0,46,92,2,1,1,4,3,0,6,33,25,5,20,92,25,0,4,0,5,204,265,1,45,0,22,0,68,27,159,658
CHHATTISGARH,BILASPUR,2007,93,43,5,141,61,0,61,122,22,22,0,44,3,1,62,527,784,294,490,2161,158,10,34,7,19,1421,1858,26,179,8,129,0,342,209,1780,5581
CHHATTISGARH,BIZAPUR,2007,113,148,0,261,4,0,4,8,9,0,9,18,29,0,1,9,9,2,7,57,11,0,3,0,14,11,51,0,4,0,2,0,6,12,96,475
CHHATTISGARH,DANTEWARA,2007,87,99,0,186,8,0,8,16,6,2,4,12,13,0,1,52,66,9,57,198,9,1,3,1,8,46,101,0,8,2,4,0,14,33,315,762
CHHATTISGARH,DHAMTARI,2007,14,10,0,24,26,0,26,52,8,6,2,16,1,0,6,138,157,39,118,459,23,2,24,7,9,86,246,1,63,7,15,0,86,95,936,1628
CHHATTISGARH,DURG,2007,76,47,2,125,119,0,119,238,35,22,13,70,7,2,51,456,808,274,534,2132,55,10,74,1,20,450,958,14,200,13,101,0,328,348,3195,6084
CHHATTISGARH,GRP RAIPUR,2007,1,1,0,2,1,0,1,2,1,1,0,2,0,0,3,5,186,11,175,380,3,2,0,2,1,13,22,1,4,0,0,0,5,1,66,291
CHHATTISGARH,JAGDALPUR,2007,70,31,1,102,60,0,60,120,14,14,0,28,2,1,13,85,122,44,78,345,60,6,24,3,0,192,430,2,45,2,24,0,73,145,1022,1924
CHHATTISGARH,JANJGIR,2007,56,35,0,91,54,0,54,108,7,5,2,14,2,0,28,251,256,80,176,793,69,5,26,7,22,203,469,13,97,10,89,0,209,137,1373,2740
CHHATTISGARH,JASHPUR,2007,57,16,0,73,61,0,61,122,22,18,4,44,13,2,32,82,82,32,50,293,27,4,24,4,10,112,237,1,43,4,11,0,59,56,390,1053
CHHATTISGARH,KABIRDHAM,2007,17,8,3,28,29,0,29,58,3,0,3,6,0,0,3,81,97,18,79,278,19,3,16,2,5,406,498,3,57,8,32,0,100,47,366,1205
CHHATTISGARH,KANKER,2007,38,27,0,65,22,0,22,44,6,6,0,12,9,0,16,81,85,12,73,276,29,3,12,0,16,35,164,1,24,1,16,0,42,69,653,1143
CHHATTISGARH,KORBA,2007,47,11,1,59,31,0,31,62,5,4,1,10,3,3,15,152,290,118,172,753,31,1,19,4,11,461,681,1,69,4,43,0,117,154,872,2228
CHHATTISGARH,KORIYA,2007,42,30,1,73,66,0,66,132,8,8,0,16,2,0,16,191,172,33,139,553,23,2,11,0,8,458,582,0,77,0,29,0,106,80,373,1589
CHHATTISGARH,MAHASAMUND,2007,16,9,0,25,25,0,25,50,4,3,1,8,2,1,10,122,212,57,155,559,17,7,11,0,6,213,382,2,56,3,16,0,77,128,600,1460
CHHATTISGARH,NARAYANPUR,2007,25,31,0,56,3,0,3,6,3,0,3,6,4,0,2,9,4,2,2,23,0,0,2,1,9,9,23,0,2,0,2,0,4,2,30,138
CHHATTISGARH,RAIGARH,2007,62,30,0,92,55,0,55,110,7,7,0,14,1,0,23,222,329,120,209,904,80,21,21,6,20,499,818,7,86,12,33,0,138,171,1079,2764
CHHATTISGARH,RAIPUR,2007,110,77,3,190,120,0,120,240,53,39,14,106,8,1,61,714,1172,517,655,3128,139,56,105,11,36,1535,2373,15,253,28,131,0,427,491,3225,8344
CHHATTISGARH,RAJNANDGAON,2007,44,25,0,69,54,0,54,108,16,11,5,32,3,0,18,219,247,67,180,734,28,11,24,4,16,79,284,8,78,6,59,0,151,122,1839,2900
CHHATTISGARH,SARGUJA,2007,54,31,6,91,72,0,72,144,9,9,0,18,5,1,33,96,170,60,110,475,30,4,14,1,10,90,221,1,78,1,30,0,110,72,760,1568
CHHATTISGARH,SURAJPUR,2007,41,24,1,66,65,0,65,130,4,3,1,8,5,1,27,107,108,20,88,356,45,2,16,3,8,278,429,3,81,2,36,0,122,77,376,1310
GOA,NORTH GOA,2007,15,13,6,34,5,0,5,10,3,2,1,6,0,0,9,180,275,119,156,739,47,19,22,9,16,89,330,2,8,4,3,0,17,128,437,1290
GOA,SOUTH GOA,2007,18,10,1,29,15,0,15,30,9,5,4,18,7,0,13,112,219,88,131,570,23,17,33,1,8,61,262,0,12,3,11,0,26,119,497,1189
GUJARAT,AHMEDABAD COMMR.,2007,100,44,2,146,37,0,37,74,213,147,66,426,13,3,417,677,4302,2316,1986,9714,133,188,204,9,0,1421,2207,4,104,13,1221,0,1342,252,7953,17310
GUJARAT,AHMEDABAD RURAL,2007,30,16,1,47,6,0,6,12,48,46,2,96,7,0,38,133,434,98,336,1046,61,45,9,4,17,316,791,0,22,0,172,0,194,339,2308,4006
GUJARAT,AHWA-DANG,2007,8,2,0,10,5,0,5,10,0,0,0,0,0,0,2,6,11,3,8,30,5,2,1,1,1,17,58,0,5,0,7,0,12,31,188,292
GUJARAT,AMRELI,2007,30,13,0,43,7,0,7,14,49,49,0,98,3,0,11,98,172,61,111,456,62,34,6,11,6,295,518,0,20,0,162,0,182,104,1225,2308
GUJARAT,ANAND,2007,26,7,3,36,10,0,10,20,59,53,6,118,9,1,21,161,589,241,348,1370,33,77,12,11,15,386,778,0,22,2,170,0,194,244,2061,3919
GUJARAT,BHARUCH,2007,38,10,0,48,8,0,8,16,15,14,1,30,6,0,11,112,277,118,159,683,29,43,7,8,8,219,598,0,18,4,68,0,90,284,1373,2538
GUJARAT,BHAVNAGAR,2007,43,37,0,80,18,0,18,36,104,90,14,208,12,0,76,338,879,258,621,2184,156,61,61,29,30,116,459,1,94,35,280,0,410,6,3671,6047
GUJARAT,DAHOD,2007,40,14,1,55,8,0,8,16,35,32,3,70,26,1,56,53,176,77,99,488,66,2,4,6,18,298,394,0,25,1,56,0,82,0,836,1722
GUJARAT,GANDHINAGAR,2007,19,12,0,31,12,0,12,24,24,17,7,48,5,0,21,129,434,191,243,1023,39,6,46,9,3,220,518,1,17,2,170,0,190,195,1606,2970
GUJARAT,HIMATNAGAR,2007,46,12,1,59,5,0,5,10,35,34,1,70,6,0,9,132,234,71,163,615,46,51,20,10,7,259,664,0,33,0,197,0,230,271,4667,6041
GUJARAT,JAMNAGAR,2007,41,34,2,77,11,0,11,22,22,21,1,44,5,0,23,182,404,167,237,1018,64,37,23,12,27,367,533,0,15,4,245,0,264,3,5457,6978
GUJARAT,JUNAGADH,2007,46,15,0,61,13,0,13,26,56,46,10,112,5,0,43,175,545,186,359,1313,64,52,24,17,21,522,906,1,42,11,419,0,473,206,2587,4864
GUJARAT,KHEDA NORTH,2007,43,7,1,51,10,0,10,20,35,34,1,70,6,0,8,138,393,88,305,938,49,39,33,9,17,387,794,0,31,0,154,0,185,260,3449,5069
GUJARAT,KUTCH,2007,49,22,1,72,10,0,10,20,36,27,9,72,13,0,34,316,578,210,368,1519,60,28,44,9,8,400,859,2,20,4,255,0,281,310,3029,5228
GUJARAT,MEHSANA,2007,31,24,1,56,6,0,6,12,50,45,5,100,10,0,27,245,699,189,510,1680,93,28,39,9,13,601,948,2,23,0,276,0,301,165,2582,4924
GUJARAT,NARMADA,2007,15,2,0,17,6,0,6,12,4,4,0,8,0,0,1,11,31,7,24,74,5,6,3,0,7,115,178,0,8,0,13,0,21,42,553,822
GUJARAT,NAVSARI,2007,26,5,0,31,2,0,2,4,14,11,3,28,9,0,6,45,100,51,49,260,10,13,4,6,1,45,79,0,3,0,23,0,26,0,682,994
GUJARAT,PALANPUR,2007,45,30,0,75,19,0,19,38,55,51,4,110,4,0,31,186,456,101,355,1133,81,30,23,5,22,1187,1504,2,65,0,256,0,323,156,2140,4793
GUJARAT,PANCHMAHAL,2007,55,15,0,70,16,0,16,32,44,42,2,88,22,0,20,98,216,77,139,572,29,37,25,5,15,258,369,0,33,0,124,0,157,0,2661,3673
GUJARAT,PATAN,2007,18,14,1,33,6,0,6,12,43,41,2,86,4,0,16,107,434,82,352,995,59,24,23,6,14,412,664,0,33,0,178,0,211,126,1456,2974
GUJARAT,PORBANDAR,2007,6,2,3,11,1,0,1,2,8,7,1,16,0,0,4,32,64,18,46,164,11,10,13,4,4,88,176,0,4,0,59,0,63,46,565,924
GUJARAT,RAJKOT COMMR.,2007,37,16,0,53,4,0,4,8,46,36,10,92,2,0,32,203,846,436,410,1929,57,22,45,26,19,344,625,3,17,22,240,0,282,112,1819,3912
GUJARAT,RAJKOT RURAL,2007,32,21,1,54,25,0,25,50,58,51,7,116,14,0,32,164,376,122,254,962,65,70,10,9,7,423,877,4,26,1,234,0,265,293,2129,3994
GUJARAT,SURAT COMMR.,2007,108,31,3,142,24,0,24,48,117,80,37,234,15,1,42,447,2423,1587,836,5351,111,57,182,25,6,848,1586,21,44,8,332,0,405,357,5784,10986
GUJARAT,SURAT RURAL,2007,57,13,0,70,4,0,4,8,18,6,12,36,10,3,11,68,182,87,95,456,36,19,14,10,10,158,655,1,5,0,37,0,43,408,543,1607
GUJARAT,SURENDRANAGAR,2007,22,16,0,38,17,0,17,34,29,28,1,58,8,1,19,89,270,71,199,657,65,70,13,11,7,430,792,0,48,5,119,0,172,196,1785,3220
GUJARAT,VADODARA COMMR.,2007,24,22,0,46,8,0,8,16,47,37,10,94,9,0,25,359,1403,831,572,3199,119,34,152,10,6,306,745,0,11,8,268,0,287,118,2180,5109
GUJARAT,VADODARA RURAL,2007,76,21,0,97,10,0,10,20,39,37,2,78,6,0,13,46,192,85,107,449,34,23,12,8,15,318,714,0,21,0,63,0,84,304,1657,2858
GUJARAT,VALSAD,2007,39,11,0,50,8,0,8,16,5,2,3,10,8,0,11,99,233,115,118,584,21,26,23,6,5,158,239,0,6,0,25,0,31,0,1170,1854
GUJARAT,W.RLY,2007,16,6,0,22,0,0,0,0,4,1,3,8,8,0,35,21,811,78,733,1686,5,5,41,1,1,75,131,0,7,0,4,0,11,3,216,1259
HARYANA,AMBALA,2007,39,12,6,57,23,0,23,46,15,10,5,30,5,5,11,253,366,174,192,1006,0,70,96,1,4,226,398,16,11,15,154,0,196,1,1049,2378
HARYANA,BHIWANI,2007,62,22,2,86,17,0,17,34,32,23,9,64,6,3,26,231,391,230,161,1048,125,19,93,0,14,315,572,17,23,15,128,0,183,6,1026,2573
HARYANA,FARIDABAD,2007,65,36,2,103,37,0,37,74,154,117,37,308,11,47,32,329,1268,973,295,2955,153,120,25,4,10,224,799,19,23,0,167,0,209,263,1531,4520
HARYANA,FATEHABAD,2007,25,17,4,46,7,0,7,14,25,8,17,50,1,2,7,107,256,120,136,629,22,14,80,3,4,188,315,2,16,12,122,0,152,4,632,1550
HARYANA,GRP,2007,19,2,0,21,2,0,2,4,7,3,4,14,3,0,18,1,427,73,354,876,6,1,14,1,0,17,62,5,6,153,0,0,164,23,434,1139
HARYANA,GURGAON,2007,93,58,4,155,40,0,40,80,111,75,36,222,32,47,123,724,2230,1530,700,5386,97,60,183,5,6,152,525,17,36,43,122,0,218,22,2150,6355
HARYANA,HISSAR,2007,55,48,4,107,21,0,21,42,47,31,16,94,0,11,11,200,494,273,221,1210,30,26,78,3,3,387,529,7,19,0,157,0,183,2,1383,2986
HARYANA,JHAJJAR,2007,55,45,2,102,14,0,14,28,30,21,9,60,4,3,15,104,260,139,121,646,53,16,40,1,7,163,457,19,10,14,87,0,130,177,441,1560
HARYANA,JIND,2007,34,38,8,80,19,0,19,38,24,18,6,48,1,4,16,147,264,145,119,696,91,52,61,2,3,151,362,12,14,15,95,0,136,2,601,1654
HARYANA,KAITHAL,2007,32,15,2,49,14,0,14,28,16,10,6,32,7,2,9,144,240,120,120,642,0,38,39,0,4,196,288,14,26,0,178,0,218,11,601,1588
HARYANA,KARNAL,2007,53,22,10,85,47,0,47,94,26,13,13,52,4,9,26,291,702,390,312,1734,60,7,98,2,8,794,1247,13,28,0,169,0,210,278,448,3095
HARYANA,KURUKSHETRA,2007,27,19,0,46,21,0,21,42,18,13,5,36,4,5,12,255,632,283,349,1540,0,92,43,1,7,237,381,11,11,16,99,0,137,1,981,2492
HARYANA,MAHENDRAGARH,2007,28,14,0,42,10,0,10,20,25,22,3,50,3,1,7,112,187,75,112,497,79,37,12,0,5,172,309,14,17,0,47,0,78,4,912,1686
HARYANA,MEWAT,2007,35,43,3,81,44,0,44,88,28,18,10,56,20,24,17,24,208,131,77,501,162,12,60,2,9,147,392,13,18,14,153,0,198,0,641,1677
HARYANA,PALWAL,2007,26,23,3,52,15,0,15,30,22,17,5,44,7,20,24,89,254,186,68,648,88,12,54,0,0,148,302,9,21,34,54,0,118,0,767,1670
HARYANA,PANCHKULA,2007,18,3,3,24,11,0,11,22,25,9,16,50,1,0,9,103,216,113,103,545,2,4,47,1,0,44,99,0,9,0,70,0,79,1,697,1264
HARYANA,PANIPAT,2007,35,20,5,60,34,0,34,68,33,24,9,66,4,52,23,225,664,439,225,1632,37,26,15,3,5,210,548,11,13,18,63,0,105,252,620,2368
HARYANA,REWARI,2007,18,17,3,38,22,0,22,44,35,29,6,70,7,4,35,159,334,182,152,873,61,43,35,0,10,219,372,12,30,1,76,0,119,4,1193,2318
HARYANA,ROHTAK,2007,56,49,2,107,18,0,18,36,30,20,10,60,7,7,20,209,472,275,197,1187,56,36,62,1,6,187,568,31,18,32,92,0,173,220,695,2306
HARYANA,SIRSA,2007,29,22,2,53,23,0,23,46,21,14,7,42,3,0,14,154,357,183,174,885,38,22,46,1,14,326,453,5,21,0,154,0,180,6,714,1972
HARYANA,SONIPAT,2007,75,44,5,124,24,0,24,48,42,26,16,84,8,12,26,210,454,213,241,1164,10,10,10,1,18,314,631,16,30,27,149,0,222,268,911,2664
HARYANA,YAMUNANAGAR,2007,32,23,2,57,25,0,25,50,35,33,2,70,1,8,21,160,371,252,119,932,3,9,41,1,5,214,273,6,17,0,76,0,99,0,732,1782
HIMACHAL PRADESH,BILASPUR,2007,1,4,1,6,6,0,6,12,11,9,2,22,0,0,6,50,81,19,62,218,34,15,18,1,12,57,181,0,33,1,28,0,62,44,701,1104
HIMACHAL PRADESH,CHAMBA,2007,9,3,0,12,15,0,15,30,11,11,0,22,0,0,0,131,54,12,42,239,21,3,8,3,10,72,183,0,20,1,6,0,27,66,347,780
HIMACHAL PRADESH,G.R.P.,2007,0,0,0,0,0,0,0,0,0,0,0,0,0,0,0,0,3,0,3,6,1,0,0,0,0,0,1,0,0,0,0,0,0,0,0,4
HIMACHAL PRADESH,HAMIRPUR,2007,7,1,1,9,5,0,5,10,16,15,1,32,0,0,1,71,67,8,59,206,32,5,9,2,15,245,334,1,29,13,35,0,78,26,541,1122
HIMACHAL PRADESH,KANGRA,2007,22,11,1,34,20,0,20,40,25,19,6,50,0,0,1,94,125,31,94,345,136,12,31,1,13,197,396,3,38,4,72,0,117,6,1399,2211
HIMACHAL PRADESH,KINNAUR,2007,7,0,0,7,9,0,9,18,1,1,0,2,0,0,0,31,12,1,11,55,13,6,5,0,1,11,56,0,1,0,4,0,5,20,94,215
HIMACHAL PRADESH,KULLU,2007,11,2,1,14,22,0,22,44,12,11,1,24,1,0,2,61,74,13,61,212,64,5,20,1,5,51,194,0,22,3,18,0,43,48,597,1020
HIMACHAL PRADESH,LAHAUL-SPITI,2007,1,0,0,1,1,0,1,2,1,1,0,2,0,0,0,2,3,0,3,8,3,0,0,0,0,3,19,0,1,0,0,0,1,13,53,81
HIMACHAL PRADESH,MANDI,2007,14,7,1,22,30,0,30,60,25,23,2,50,0,0,3,85,117,32,85,322,68,23,21,0,32,112,337,0,70,6,60,0,136,81,1448,2203
HIMACHAL PRADESH,SHIMLA,2007,15,15,1,31,27,0,27,54,28,26,2,56,0,0,9,126,246,34,212,627,111,22,47,0,37,64,377,1,46,0,44,0,91,96,1191,2126
HIMACHAL PRADESH,SIRMAUR,2007,16,4,0,20,7,0,7,14,12,9,3,24,0,0,0,48,69,22,47,186,61,7,12,0,4,41,190,0,26,0,26,0,52,65,391,789
HIMACHAL PRADESH,SOLAN,2007,10,9,2,21,8,0,8,16,17,16,1,34,2,0,0,112,143,58,85,400,70,23,24,2,10,364,575,3,26,0,30,0,59,82,683,1620
HIMACHAL PRADESH,UNA,2007,14,1,1,16,9,0,9,18,12,9,3,24,2,0,1,66,98,34,64,265,35,11,17,1,2,101,217,0,10,5,19,0,34,50,492,947
JAMMU & KASHMIR,ANANTNAG,2007,9,27,5,41,16,0,16,32,65,65,0,130,0,0,5,147,120,34,86,392,92,11,39,0,17,54,244,0,57,29,0,0,86,31,586,1310
JAMMU & KASHMIR,AWANTIPORA,2007,13,2,0,15,5,0,5,10,13,11,2,26,0,0,4,24,35,10,25,98,22,2,3,2,1,0,43,0,29,7,0,0,36,13,202,377
JAMMU & KASHMIR,BARAMULLA,2007,47,79,3,129,31,0,31,62,102,90,12,204,4,0,3,148,181,17,164,517,83,8,16,5,23,19,154,0,93,28,2,0,123,0,669,1544
JAMMU & KASHMIR,BORDER DISTRICT,2007,9,17,0,26,6,0,6,12,10,7,3,20,0,0,0,23,62,13,49,147,32,2,12,0,0,8,55,2,11,3,3,0,19,1,436,637
JAMMU & KASHMIR,BUDGAM,2007,5,18,1,24,17,0,17,34,72,72,0,144,0,0,9,92,176,12,164,453,111,2,21,3,8,3,156,0,118,31,0,0,149,8,641,1336
JAMMU & KASHMIR,CRIME JAMMU,2007,0,0,0,0,0,0,0,0,0,0,0,0,0,0,0,0,0,0,0,0,0,0,43,0,0,0,43,0,0,0,0,0,0,0,1,44
JAMMU & KASHMIR,CRIME SRINAGAR,2007,0,0,0,0,0,0,0,0,0,0,0,0,0,0,0,0,0,0,0,0,0,12,67,0,0,0,79,0,0,0,0,0,0,0,0,79
JAMMU & KASHMIR,DODA,2007,35,68,0,103,28,0,28,56,30,28,2,60,4,0,5,40,67,4,63,183,13,5,9,0,16,28,76,0,26,5,13,0,44,5,550,947
JAMMU & KASHMIR,GANDERBAL,2007,11,6,0,17,5,0,5,10,45,45,0,90,0,0,4,41,58,4,54,161,92,4,12,0,11,5,130,0,73,3,5,0,81,6,241,622
JAMMU & KASHMIR,HANDWARA,2007,12,30,1,43,15,0,15,30,22,22,0,44,1,0,3,22,58,3,55,142,33,5,3,2,2,3,48,0,62,9,2,0,73,0,155,440
JAMMU & KASHMIR,JAMMU,2007,22,71,6,99,25,0,25,50,52,52,0,104,2,0,2,205,370,181,189,949,82,23,87,2,14,34,316,3,23,41,45,0,112,74,2159,3342
JAMMU & KASHMIR,KARGIL,2007,0,2,0,2,0,0,0,0,1,1,0,2,0,0,0,4,4,1,3,12,3,2,1,0,1,0,14,0,2,0,0,0,2,7,61,88
JAMMU & KASHMIR,KATHUA,2007,11,28,1,40,15,0,15,30,18,17,1,36,2,0,1,60,79,13,66,221,51,5,20,0,10,25,114,1,15,21,7,0,44,3,865,1238
JAMMU & KASHMIR,KULGAM,2007,10,18,2,30,9,0,9,18,46,43,3,92,1,0,14,54,85,8,77,239,68,0,13,1,2,20,129,0,53,13,0,0,66,25,239,673
JAMMU & KASHMIR,KUPWARA,2007,23,59,1,83,4,0,4,8,38,35,3,76,0,0,4,36,66,5,61,172,88,1,9,3,9,4,114,0,77,4,5,0,86,0,251,682
JAMMU & KASHMIR,LEH,2007,4,3,0,7,2,0,2,4,3,3,0,6,0,0,1,19,14,4,10,48,4,12,3,0,0,3,22,0,4,0,0,0,4,0,214,286
JAMMU & KASHMIR,POONCH,2007,13,35,1,49,13,0,13,26,17,17,0,34,0,0,0,34,43,0,43,120,106,3,10,0,0,37,159,0,28,3,15,0,46,3,400,761
JAMMU & KASHMIR,PULWAMA,2007,22,54,1,77,11,0,11,22,51,45,6,102,0,0,19,76,92,3,89,279,136,2,18,6,16,57,245,0,36,8,2,0,46,10,225,842
JAMMU & KASHMIR,RAILWAYS,2007,1,1,1,3,0,0,0,0,0,0,0,0,0,0,0,0,14,0,14,28,0,0,0,0,0,0,2,0,0,1,0,0,1,2,7,27
JAMMU & KASHMIR,RAJOURI,2007,23,27,0,50,25,0,25,50,51,47,4,102,0,0,5,77,69,3,66,220,31,1,23,1,27,24,112,3,30,6,45,0,84,5,1087,1560
JAMMU & KASHMIR,RAMBAN,2007,18,27,0,45,15,0,15,30,10,7,3,20,0,0,0,28,60,9,51,148,14,4,8,0,5,14,48,0,6,5,0,0,11,3,517,734
JAMMU & KASHMIR,REASI,2007,8,14,0,22,7,0,7,14,11,10,1,22,0,0,0,9,26,0,26,61,1,0,5,0,5,1,12,0,10,3,1,0,14,0,209,310
JAMMU & KASHMIR,SRINAGAR,2007,15,64,0,79,27,0,27,54,92,81,11,184,2,0,29,272,351,178,173,1005,127,14,59,6,18,21,292,0,219,121,31,0,371,47,1105,2620
JAMMU & KASHMIR,UDHAMPUR,2007,7,19,0,26,12,0,12,24,9,9,0,18,2,0,3,49,56,12,44,166,20,3,8,0,1,14,46,0,14,12,0,0,26,0,715,944
JHARKHAND,BOKARO,2007,60,21,0,81,57,0,57,114,43,36,7,86,18,2,45,108,622,142,480,1417,125,69,35,0,0,0,229,21,7,0,62,0,90,0,1456,2751
JHARKHAND,CHAIBASA,2007,127,32,2,161,43,0,43,86,19,9,10,38,10,2,21,21,135,29,106,324,41,5,26,0,1,61,161,6,10,0,21,0,37,27,415,1025
JHARKHAND,CHATRA,2007,29,69,1,99,25,0,25,50,12,11,1,24,34,0,33,29,87,10,77,270,113,0,2,0,2,0,117,15,3,0,8,0,26,0,498,960
JHARKHAND,DEOGHAR,2007,48,29,3,80,24,0,24,48,26,6,20,52,11,0,22,133,276,58,218,718,140,31,4,0,1,81,299,21,2,1,0,0,24,42,918,1813
JHARKHAND,DHANBAD,2007,80,56,7,143,41,0,41,82,87,68,19,174,40,3,58,180,851,312,539,1983,299,45,74,1,6,279,706,29,32,9,38,0,108,2,1495,3712
JHARKHAND,DHANBAD RLY.,2007,7,0,0,7,1,0,1,2,0,0,0,0,20,0,9,0,127,8,119,283,7,0,2,0,0,0,9,2,1,0,0,0,3,0,105,281
JHARKHAND,DUMKA,2007,65,27,0,92,52,0,52,104,29,22,7,58,6,0,11,64,191,78,113,463,98,8,29,0,9,208,428,23,35,0,49,0,107,76,589,1569
JHARKHAND,GARHWA,2007,53,45,3,101,17,0,17,34,20,12,8,40,14,0,16,21,75,10,65,201,141,7,25,1,9,169,413,8,0,0,30,0,38,61,301,1016
JHARKHAND,GIRIDIH,2007,59,114,0,173,46,0,46,92,35,30,5,70,52,4,31,103,289,27,262,768,310,12,49,0,7,72,559,20,61,0,71,0,152,109,1266,2710
JHARKHAND,GODDA,2007,55,85,3,143,30,0,30,60,39,19,20,78,8,0,9,64,152,0,152,385,129,10,18,0,9,61,227,7,3,0,42,0,52,0,571,1295
JHARKHAND,GUMLA,2007,137,59,3,199,60,0,60,120,34,29,5,68,24,0,45,8,91,21,70,259,27,3,11,8,12,0,61,1,11,0,9,0,21,0,436,979
JHARKHAND,HAZARIBAGH,2007,78,72,6,156,41,0,41,82,28,25,3,56,56,7,54,136,635,87,548,1523,157,20,207,0,24,149,629,45,40,0,86,0,171,72,864,2777
JHARKHAND,JAMSHEDPUR,2007,92,67,7,166,65,0,65,130,39,31,8,78,17,2,62,149,944,334,610,2118,118,106,78,0,12,826,1312,20,30,0,56,0,106,172,609,3471
JHARKHAND,JAMSHEDPUR RLY.,2007,4,0,0,4,1,0,1,2,4,2,2,8,2,0,4,3,159,11,148,327,5,1,2,1,0,5,14,0,1,0,0,0,1,0,73,265
JHARKHAND,JAMTARA,2007,14,9,5,28,22,0,22,44,21,19,2,42,4,0,2,34,95,10,85,230,74,2,14,0,5,0,114,6,11,0,24,0,41,19,358,719
JHARKHAND,KHUNTI,2007,91,9,4,104,15,0,15,30,15,7,8,30,12,2,26,2,44,4,40,130,9,0,2,1,4,24,95,1,1,0,3,0,5,55,69,389
JHARKHAND,KODERMA,2007,22,33,3,58,15,0,15,30,18,7,11,36,15,0,16,20,120,34,86,291,102,15,27,3,1,1,202,11,2,0,9,0,22,53,299,785
JHARKHAND,LATEHAR,2007,53,3,1,57,10,0,10,20,14,7,7,28,27,3,17,9,75,4,71,206,38,0,5,0,3,85,165,4,2,0,4,0,10,34,182,569
JHARKHAND,LOHARDAGGA,2007,31,19,4,54,32,0,32,64,21,9,12,42,12,0,23,21,88,28,60,232,29,14,16,2,4,118,208,1,12,0,24,0,37,25,124,620
JHARKHAND,PAKUR,2007,24,100,9,133,45,0,45,90,22,19,3,44,5,0,3,16,100,16,84,224,66,3,16,0,6,151,272,4,13,0,31,0,48,30,112,756
JHARKHAND,PALAMU,2007,67,31,1,99,29,0,29,58,36,28,8,72,21,2,40,96,145,12,133,449,122,8,20,0,13,642,805,17,6,3,31,0,57,0,267,1597
JHARKHAND,RAMGARH,2007,41,13,0,54,28,0,28,56,37,26,11,74,17,5,36,27,350,57,293,785,132,8,56,0,2,46,246,11,11,0,46,0,68,2,478,1346
JHARKHAND,RANCHI,2007,203,78,24,305,53,0,53,106,88,64,24,176,69,5,146,171,1177,437,740,2745,204,64,64,2,23,642,1171,17,27,2,100,0,146,172,1518,4849
JHARKHAND,SAHEBGANJ,2007,54,51,2,107,64,0,64,128,32,24,8,64,3,1,7,61,53,7,46,178,38,10,8,0,1,60,141,9,18,0,25,0,52,24,375,896
JHARKHAND,SARAIKELA,2007,51,30,2,83,18,0,18,36,23,4,19,46,12,2,18,4,151,37,114,338,31,7,19,0,0,41,142,4,2,0,26,0,32,44,422,907
JHARKHAND,SIMDEGA,2007,72,24,2,98,21,0,21,42,20,20,0,40,15,0,17,15,59,11,48,165,10,0,5,0,6,62,83,0,1,0,6,0,7,0,97,432
KARNATAKA,BAGALKOT,2007,38,24,3,65,4,0,4,8,27,17,10,54,8,3,11,60,125,41,84,332,123,4,44,5,15,245,436,2,51,3,70,0,126,0,1179,2044
KARNATAKA,BANGALORE COMMR.,2007,246,264,7,517,62,1,61,124,119,35,84,238,41,203,545,1485,7377,3667,3710,17028,425,183,2052,45,2,2381,5198,54,187,2,290,0,533,110,10969,27049
KARNATAKA,BANGALORE RURAL,2007,176,43,0,219,29,0,29,58,43,13,30,86,18,0,55,330,834,173,661,2071,504,23,86,0,10,1012,1635,32,99,0,103,0,234,0,5180,8577
KARNATAKA,BELGAUM,2007,110,84,3,197,22,0,22,44,42,28,14,84,7,1,51,224,459,202,257,1201,372,21,253,8,39,944,1658,10,129,2,232,0,373,21,3744,6778
KARNATAKA,BELLARY,2007,62,51,0,113,14,0,14,28,17,15,2,34,2,3,25,139,226,81,145,621,222,6,70,4,11,530,858,7,71,0,62,0,140,15,2099,3636
KARNATAKA,BIDAR,2007,42,46,11,99,11,0,11,22,26,20,6,52,7,0,25,160,197,55,142,586,172,7,22,2,19,946,1168,4,103,1,81,0,189,0,1757,3639
KARNATAKA,BIJAPUR,2007,49,28,1,78,17,0,17,34,30,13,17,60,2,10,31,129,155,45,110,482,298,6,72,3,23,690,1092,2,80,0,145,0,227,0,1447,3218
KARNATAKA,CHAMARAJNAGAR,2007,19,11,1,31,3,0,3,6,7,4,3,14,1,0,2,58,84,18,66,229,77,3,15,0,0,432,527,2,26,0,18,0,46,0,614,1373
KARNATAKA,CHICKMAGALUR,2007,32,29,2,63,11,0,11,22,11,7,4,22,6,2,22,126,169,43,126,494,121,3,20,3,7,702,859,4,55,3,108,0,170,3,1375,2814
KARNATAKA,CHITRADURGA,2007,32,20,0,52,10,0,10,20,21,7,14,42,1,0,23,114,183,40,143,504,238,6,27,1,8,821,1101,9,65,1,51,0,126,0,2298,3929
KARNATAKA,DAKSHIN KANNADA,2007,26,37,1,64,11,0,11,22,11,8,3,22,3,2,19,266,215,108,107,720,195,9,93,6,20,502,837,2,36,3,46,0,87,12,2373,3888
KARNATAKA,DAVANAGERE,2007,19,22,1,42,10,0,10,20,16,11,5,32,2,2,20,134,205,49,156,568,220,13,41,3,0,472,749,5,49,2,102,0,158,0,1437,2775
KARNATAKA,DHARWAD COMMR.,2007,16,20,0,36,5,0,5,10,16,12,4,32,1,4,60,147,273,118,155,758,104,17,133,6,0,184,449,3,10,1,30,0,44,5,1018,2053
KARNATAKA,DHARWAD RURAL,2007,30,13,0,43,7,0,7,14,6,3,3,12,4,0,4,19,45,15,30,117,64,8,21,0,0,114,207,0,8,0,10,0,18,0,643,996
KARNATAKA,GADAG,2007,17,17,0,34,4,0,4,8,5,2,3,10,2,0,8,50,68,22,46,196,111,6,27,0,3,131,369,3,31,0,23,0,57,91,425,1022
KARNATAKA,GULBARGA,2007,91,90,1,182,35,0,35,70,54,38,16,108,9,3,64,185,262,83,179,785,498,17,77,2,46,1205,1864,19,91,0,127,0,237,19,2057,4952
KARNATAKA,HASSAN,2007,54,35,1,90,13,0,13,26,15,9,6,30,2,0,30,191,278,111,167,779,130,5,99,0,0,1032,1266,11,77,0,83,0,171,0,2475,4531
KARNATAKA,HAVERI,2007,17,21,3,41,8,0,8,16,21,6,15,42,4,0,5,93,95,33,62,292,197,11,33,6,0,249,665,5,35,0,27,0,67,169,1044,2043
KARNATAKA,K.G.F.,2007,12,23,0,35,7,0,7,14,7,6,1,14,1,1,11,48,90,12,78,241,39,1,15,0,0,208,263,7,29,0,21,0,57,0,344,864
KARNATAKA,KODAGU,2007,25,28,2,55,4,0,4,8,11,9,2,22,2,0,8,103,129,26,103,371,48,2,19,1,4,453,529,4,20,1,43,0,68,2,704,1613
KARNATAKA,KOLAR,2007,66,62,1,129,19,0,19,38,35,24,11,70,7,0,19,133,389,113,276,937,291,1,37,0,0,720,1054,17,44,0,50,0,111,5,1850,3746
KARNATAKA,KOPPAL,2007,19,10,7,36,6,0,6,12,5,5,0,10,1,0,10,85,74,23,51,244,121,1,18,0,2,199,341,1,32,0,48,0,81,0,1001,1640
KARNATAKA,MANDYA,2007,48,43,0,91,17,0,17,34,15,14,1,30,3,0,9,142,254,103,151,662,180,8,27,4,0,799,1018,15,66,0,95,0,176,0,2511,4236
KARNATAKA,MYSORE COMMR.,2007,26,38,0,64,13,0,13,26,19,13,6,38,4,3,103,173,573,329,244,1429,84,5,78,5,0,258,430,4,25,0,123,0,152,0,1403,2937
KARNATAKA,MYSORE RURAL,2007,60,45,0,105,20,0,20,40,11,4,7,22,7,0,10,90,190,42,148,487,182,6,24,4,0,855,1071,11,77,0,108,0,196,0,1495,3195
KARNATAKA,RAICHUR,2007,44,31,2,77,19,0,19,38,23,20,3,46,5,0,8,110,142,34,108,407,214,7,74,6,16,569,896,3,61,2,97,0,163,10,1430,2873
KARNATAKA,RAILWAYS,2007,17,4,0,21,0,0,0,0,2,0,2,4,3,2,21,0,367,7,360,760,4,1,2,1,0,10,18,0,0,0,0,0,0,0,54,488
KARNATAKA,SHIMOGA,2007,40,43,2,85,23,0,23,46,26,21,5,52,12,1,41,241,282,102,180,859,160,4,42,3,5,885,1110,3,81,3,158,0,245,11,2183,4249
KARNATAKA,TUMKUR,2007,74,41,2,117,17,0,17,34,25,19,6,50,11,1,39,227,417,123,294,1112,184,2,37,2,16,784,1061,10,105,0,77,0,192,36,2611,4718
KARNATAKA,UDUPI,2007,12,12,1,25,11,0,11,22,7,1,6,14,1,1,15,117,119,54,65,372,142,5,22,2,8,289,473,1,22,2,19,0,44,5,1576,2389
KARNATAKA,UTTAR KANNADA,2007,19,16,3,38,4,0,4,8,7,6,1,14,1,0,19,70,75,15,60,240,63,9,20,2,8,342,444,1,63,2,60,0,126,0,1557,2341
KERALA,ALAPUZHA,2007,19,37,2,58,25,0,25,50,16,11,5,32,6,0,41,203,351,170,181,952,453,29,276,0,19,1158,1942,3,208,17,264,0,492,7,5027,8161
KERALA,CBCID,2007,7,2,0,9,2,0,2,4,0,0,0,0,0,0,0,2,1,0,1,4,2,1,12,40,0,2,60,1,0,0,3,0,4,3,8,86
KERALA,ERNAKULAM COMMR.,2007,14,17,13,44,23,0,23,46,10,6,4,20,4,0,43,189,350,120,230,936,177,21,284,0,5,460,947,0,75,5,88,0,168,0,4824,6602
KERALA,ERNAKULAM RURAL,2007,26,26,14,66,22,0,22,44,8,6,2,16,18,15,58,254,335,137,198,1015,323,27,186,0,7,1232,1776,1,126,10,151,0,288,1,6517,9357
KERALA,IDUKKI,2007,24,22,1,47,28,0,28,56,9,7,2,18,6,0,27,168,213,26,187,627,202,20,110,0,25,1323,1680,0,155,21,186,0,362,0,2381,4921
KERALA,KANNUR,2007,14,47,0,61,34,0,34,68,16,10,6,32,8,5,98,275,234,99,135,854,867,14,141,0,48,1243,2323,1,123,14,247,0,385,10,2543,5982
KERALA,KASARGOD,2007,12,13,2,27,19,0,19,38,2,0,2,4,0,3,27,156,192,78,114,570,519,16,791,0,34,648,2008,0,93,7,195,0,295,0,1417,4146
KERALA,KOLLAM,2007,43,27,12,82,46,0,46,92,22,20,2,44,4,25,36,298,457,179,278,1277,546,14,178,0,44,2183,2967,4,282,10,447,0,743,2,4559,9239
KERALA,KOTTAYAM,2007,17,17,3,37,25,0,25,50,20,16,4,40,10,0,57,314,384,114,270,1149,423,47,374,0,18,1771,2639,1,224,31,185,0,441,6,3932,7859
KERALA,KOZHIKODE COMMR.,2007,9,13,0,22,15,0,15,30,11,7,4,22,4,13,80,231,306,156,150,940,342,15,108,2,5,509,982,0,70,9,141,0,220,1,1999,3883
KERALA,KOZHIKODE RURAL,2007,10,12,3,25,25,0,25,50,14,10,4,28,3,3,30,201,257,123,134,751,522,7,185,0,30,1034,1781,3,128,16,257,0,404,3,1966,4709
KERALA,MALAPPURAM,2007,22,29,7,58,41,0,41,82,13,3,10,26,16,13,32,500,456,208,248,1473,516,13,235,1,19,903,1687,0,139,37,503,0,679,0,3691,7186
KERALA,PALAKKAD,2007,41,19,8,68,39,0,39,78,9,4,5,18,13,7,39,215,290,108,182,854,385,51,203,1,23,1128,1797,6,82,5,356,0,449,6,2535,5461
KERALA,PATHANAMTHITTA,2007,21,12,4,37,19,0,19,38,19,18,1,38,6,0,31,179,179,53,126,574,301,28,130,1,22,1093,1577,0,153,18,162,0,333,2,2499,4879
KERALA,RAILWAYS,2007,0,0,0,0,0,0,0,0,1,0,1,2,0,0,6,1,158,0,158,323,3,0,1,0,0,14,18,0,6,3,0,0,9,0,21,214
KERALA,THRISSUR,2007,38,50,9,97,48,0,48,96,27,19,8,54,7,30,74,221,356,124,232,1044,596,30,400,2,45,1008,2095,0,202,28,332,0,562,14,6651,10168
KERALA,TRIVANDRUM COMMR.,2007,13,21,3,37,20,0,20,40,23,16,7,46,5,35,96,244,568,217,351,1516,458,38,316,3,10,883,1709,1,141,10,130,0,282,1,2418,5437
KERALA,TRIVANDRUM RURAL,2007,26,24,9,59,54,0,54,108,26,20,6,52,10,7,79,322,396,154,242,1210,522,15,211,2,35,1708,2496,4,351,7,242,0,604,3,3832,7885
KERALA,WAYANADU,2007,11,14,2,27,27,0,27,54,9,4,5,18,1,1,15,127,126,47,79,396,201,8,74,2,9,675,969,2,66,14,110,0,192,0,861,2355
MADHYA PRADESH,ANUPPUR,2007,22,4,1,27,49,0,49,98,6,5,1,12,1,1,12,94,130,30,100,368,9,1,21,4,15,466,523,3,87,3,26,0,119,7,703,1665
MADHYA PRADESH,ASHOK NAGAR,2007,34,29,5,68,81,0,81,162,11,9,2,22,1,3,22,110,228,41,187,592,39,7,15,0,22,906,1064,13,173,14,43,0,243,75,915,2746
MADHYA PRADESH,BALAGHAT,2007,51,16,3,70,53,0,53,106,7,5,2,14,1,0,18,100,140,33,107,399,21,3,12,2,7,310,416,7,89,9,39,0,144,61,1341,2290
MADHYA PRADESH,BARWANI,2007,39,38,1,78,55,0,55,110,10,8,2,20,2,0,23,88,299,60,239,711,59,3,2,1,8,320,505,4,132,11,32,0,179,112,1262,2501
MADHYA PRADESH,BETUL,2007,51,48,0,99,156,0,156,312,18,17,1,36,2,0,20,154,200,63,137,576,8,0,19,0,20,387,554,13,174,14,72,0,273,120,1608,3084
MADHYA PRADESH,BHIND,2007,68,104,7,179,27,0,27,54,15,8,7,30,3,4,86,147,212,59,153,664,43,9,12,0,11,723,927,38,55,2,28,0,123,129,1235,2958
MADHYA PRADESH,BHOPAL,2007,74,76,1,151,82,0,82,164,48,43,5,96,3,1,196,978,2284,1300,984,5746,79,20,133,5,19,1797,2600,24,212,41,137,0,414,547,7308,14065
MADHYA PRADESH,BHOPAL RLY.,2007,7,2,1,10,1,0,1,2,0,0,0,0,2,2,9,8,962,19,943,1945,4,0,2,0,1,3,11,2,14,5,1,0,22,1,290,1317
MADHYA PRADESH,BURHANPUR,2007,16,11,0,27,12,0,12,24,1,1,0,2,3,0,8,48,140,40,100,339,15,6,5,0,3,122,180,2,54,4,15,0,75,29,873,1367
MADHYA PRADESH,CHHATARPUR,2007,53,80,0,133,65,0,65,130,32,25,7,64,1,3,38,369,332,47,285,1075,47,9,23,2,17,592,812,31,216,22,85,0,354,122,2964,5103
MADHYA PRADESH,CHHINDWARA,2007,59,28,10,97,116,0,116,232,14,13,1,28,2,0,13,172,289,85,204,765,49,7,25,0,11,1082,1355,16,185,19,118,0,338,181,1484,3880
MADHYA PRADESH,DAMOH,2007,43,47,0,90,30,0,30,60,14,9,5,28,2,1,12,141,148,62,86,452,15,1,12,0,9,1211,1321,20,148,0,50,0,218,73,778,2755
MADHYA PRADESH,DATIYA,2007,49,49,0,98,25,0,25,50,21,11,10,42,0,3,42,123,166,60,106,500,30,0,14,0,14,421,553,9,68,0,32,0,109,74,1348,2488
MADHYA PRADESH,DEWAS,2007,39,63,4,106,84,0,84,168,27,18,9,54,5,3,24,251,677,211,466,1637,90,11,41,0,20,460,770,22,165,48,131,0,366,148,3335,5648
MADHYA PRADESH,DHAR,2007,78,58,5,141,82,0,82,164,22,18,4,44,2,6,19,140,465,182,283,1097,75,25,131,0,30,679,1127,35,157,17,56,0,265,187,2351,4620
MADHYA PRADESH,DINDORI,2007,15,3,3,21,23,0,23,46,0,0,0,0,1,0,1,35,14,9,5,65,7,3,3,0,1,122,173,3,27,1,4,0,35,37,272,575
MADHYA PRADESH,GUNA,2007,39,28,7,74,80,0,80,160,3,2,1,6,2,10,22,212,263,68,195,772,57,22,32,0,16,772,1052,4,166,23,45,0,238,153,1545,3501
MADHYA PRADESH,GWALIOR,2007,70,139,19,228,74,0,74,148,68,46,22,136,4,11,198,1049,1623,982,641,4508,186,34,95,2,22,1242,1829,33,170,20,130,0,353,248,4401,9838
MADHYA PRADESH,HARDA,2007,17,23,0,40,38,0,38,76,12,7,5,24,0,0,20,64,158,67,91,400,15,9,5,0,7,446,482,5,41,14,34,0,94,0,510,1418
MADHYA PRADESH,HOSHANGABAD,2007,41,48,0,89,52,0,52,104,23,23,0,46,0,1,33,157,394,130,264,979,25,0,16,0,0,481,522,11,110,12,59,0,192,0,1711,3174
MADHYA PRADESH,INDORE,2007,111,151,4,266,102,0,102,204,49,35,14,98,6,3,175,936,3363,2130,1233,7846,198,44,113,4,61,1613,2460,21,276,55,319,0,671,427,8843,16874
MADHYA PRADESH,INDORE RLY.,2007,3,0,1,4,4,0,4,8,0,0,0,0,0,0,5,0,146,0,146,297,0,2,4,0,0,11,17,0,7,0,0,0,7,0,109,292
MADHYA PRADESH,JABALPUR,2007,81,156,0,237,77,0,77,154,40,31,9,80,1,5,104,554,1035,590,445,2734,145,10,141,7,24,3194,3754,42,290,65,144,0,541,233,4597,10945
MADHYA PRADESH,JABALPUR RLY.,2007,2,1,3,6,1,0,1,2,0,0,0,0,0,2,7,2,227,1,226,465,3,2,0,0,0,3,8,0,5,4,0,0,9,0,135,397
MADHYA PRADESH,JHABUA,2007,109,51,3,163,35,0,35,70,14,14,0,28,2,0,14,76,140,44,96,372,28,1,7,0,27,550,613,3,66,0,16,0,85,0,1153,2295
MADHYA PRADESH,KATNI,2007,37,22,2,61,44,0,44,88,15,8,7,30,1,1,14,106,186,93,93,494,18,7,33,0,7,1207,1391,22,129,11,58,0,220,119,878,2917
MADHYA PRADESH,KHANDWA,2007,19,45,2,66,64,0,64,128,14,13,1,28,1,0,15,279,408,92,316,1111,62,9,15,0,9,41,225,4,152,30,60,0,246,89,1852,3170
MADHYA PRADESH,KHARGON,2007,45,49,0,94,63,0,63,126,12,8,4,24,1,0,13,173,501,92,409,1189,73,10,128,0,18,554,919,27,154,20,52,0,253,136,2171,4200
MADHYA PRADESH,MANDLA,2007,27,8,0,35,47,0,47,94,6,6,0,12,1,1,5,100,72,21,51,251,8,0,10,1,5,310,411,3,87,8,15,0,113,77,862,1653
MADHYA PRADESH,MANDSAUR,2007,30,37,0,67,40,0,40,80,21,12,9,42,2,0,38,142,287,82,205,756,59,28,19,1,30,316,532,6,132,9,62,0,209,79,1921,3259
MADHYA PRADESH,MORENA,2007,47,92,3,142,39,0,39,78,38,24,14,76,15,6,67,220,409,218,191,1126,139,2,36,0,13,1836,2166,26,104,2,78,0,210,140,1788,5100
MADHYA PRADESH,NARSINGHPUR,2007,31,34,0,65,49,0,49,98,5,5,0,10,0,0,11,62,155,50,105,383,20,2,6,0,16,960,1105,22,134,15,39,0,210,101,674,2336
MADHYA PRADESH,NEEMUCH,2007,18,9,0,27,20,0,20,40,11,5,6,22,1,1,10,147,310,91,219,779,41,34,21,0,10,689,853,3,70,12,40,0,125,58,889,2394
MADHYA PRADESH,PANNA,2007,34,38,0,72,26,0,26,52,12,6,6,24,4,2,20,133,77,16,61,313,7,3,5,0,24,372,451,7,77,6,19,0,109,40,889,1795
MADHYA PRADESH,RAISEN,2007,45,70,0,115,75,0,75,150,12,12,0,24,5,0,20,120,241,63,178,627,37,1,15,0,6,380,587,15,148,16,42,0,221,148,2303,3699
MADHYA PRADESH,RAJGARH,2007,25,58,0,83,100,0,100,200,22,16,6,44,27,1,45,153,402,94,308,1030,91,25,16,1,87,381,723,12,227,34,144,0,417,122,3394,5367
MADHYA PRADESH,RATLAM,2007,35,40,1,76,85,0,85,170,14,13,1,28,5,3,34,138,355,110,245,890,36,34,32,2,21,433,655,5,165,35,85,0,290,97,2126,3781
MADHYA PRADESH,REWA,2007,40,30,0,70,66,0,66,132,25,18,7,50,2,2,56,409,461,154,307,1391,61,12,45,1,26,802,1120,26,119,3,72,0,220,173,2258,4689
MADHYA PRADESH,SAGAR,2007,80,101,0,181,115,0,115,230,32,30,2,64,0,1,50,453,557,119,438,1618,80,10,24,0,56,3029,3363,30,345,29,125,0,529,164,2913,8194
MADHYA PRADESH,SATNA,2007,90,46,2,138,84,0,84,168,27,17,10,54,4,9,61,422,497,228,269,1490,65,7,22,0,23,941,1293,38,191,7,101,0,337,235,2380,5252
MADHYA PRADESH,SEONI,2007,40,28,3,71,51,0,51,102,7,6,1,14,1,0,4,96,148,52,96,397,37,8,30,0,7,380,566,8,96,23,19,0,146,104,1486,2576
MADHYA PRADESH,SHAHDOL,2007,29,18,1,48,50,0,50,100,8,8,0,16,1,2,29,196,166,37,129,560,15,7,18,0,10,242,292,10,128,9,78,0,225,0,1541,2558
MADHYA PRADESH,SHAJAPUR,2007,35,46,4,85,67,0,67,134,15,11,4,30,3,6,68,198,460,134,326,1195,62,25,26,2,20,1216,1492,7,163,33,65,0,268,141,1118,3780
MADHYA PRADESH,SHEOPUR,2007,19,23,0,42,13,0,13,26,6,3,3,12,0,0,11,40,81,21,60,213,35,0,15,0,6,225,314,3,38,0,27,0,68,33,617,1192
MADHYA PRADESH,SHIVPURI,2007,64,70,5,139,91,0,91,182,29,17,12,58,5,3,52,217,312,267,45,901,71,10,38,0,33,818,1133,23,152,1,36,0,212,163,1985,4178
MADHYA PRADESH,SIDHI,2007,61,25,3,89,82,0,82,164,44,37,7,88,4,1,31,335,307,36,271,985,59,9,41,2,13,637,899,24,184,10,80,0,298,138,2514,4604
MADHYA PRADESH,SIHORE,2007,35,45,0,80,56,0,56,112,17,15,2,34,3,0,14,168,317,75,242,819,54,4,16,0,14,456,681,9,94,9,38,0,150,137,1674,3160
MADHYA PRADESH,TIKAMGARH,2007,56,35,1,92,63,0,63,126,18,15,3,36,4,1,35,175,207,32,175,629,69,3,20,0,32,1014,1218,14,148,0,39,0,201,80,1498,3512
MADHYA PRADESH,UJJAIN,2007,70,131,4,205,79,0,79,158,33,29,4,66,7,7,123,387,970,299,671,2464,102,36,72,1,24,717,1082,14,168,36,199,0,417,130,4442,7752
MADHYA PRADESH,UMARIYA,2007,13,12,39,64,37,0,37,74,2,1,1,4,0,0,6,92,81,24,57,260,28,2,11,0,9,163,218,3,68,1,20,0,92,5,594,1186
MADHYA PRADESH,VIDISHA,2007,48,58,7,113,100,0,100,200,22,18,4,44,0,3,22,261,394,102,292,1074,72,14,64,0,25,611,867,20,212,18,85,0,335,81,2169,4286
MAHARASHTRA,AHMEDNAGAR,2007,99,73,2,174,55,0,55,110,37,25,12,74,49,5,107,458,1344,425,919,3307,397,44,135,7,54,772,1984,3,132,12,475,0,622,575,1918,6753
MAHARASHTRA,AKOLA,2007,38,43,1,82,22,0,22,44,17,15,2,34,14,1,55,257,898,121,777,2123,117,23,56,3,28,821,1173,3,86,48,165,0,302,125,1246,4067
MAHARASHTRA,AMRAVATI COMMR.,2007,30,22,0,52,7,0,7,14,18,14,4,36,6,1,45,237,691,118,573,1671,99,13,52,0,11,399,650,3,35,16,74,0,128,76,808,2643
MAHARASHTRA,AMRAVATI RURAL,2007,51,36,2,89,58,0,58,116,26,24,2,52,8,1,26,214,761,62,699,1771,113,8,54,1,47,820,1214,11,118,32,123,0,284,171,1011,3692
MAHARASHTRA,AURANGABAD COMMR.,2007,37,27,0,64,18,0,18,36,29,26,3,58,11,8,67,276,762,246,516,1886,157,19,121,2,10,397,873,11,57,31,171,0,270,167,777,3155
MAHARASHTRA,AURANGABAD RURAL,2007,57,19,2,78,14,0,14,28,15,7,8,30,9,6,45,165,376,55,321,977,237,9,37,2,46,743,1343,39,71,14,256,0,380,269,601,3032
MAHARASHTRA,BEED,2007,69,50,0,119,23,0,23,46,48,37,11,96,34,7,88,303,645,164,481,1722,484,24,43,1,82,997,1890,18,91,6,353,0,468,259,841,4466
MAHARASHTRA,BHANDARA,2007,30,10,3,43,19,0,19,38,7,4,3,14,3,0,18,177,547,80,467,1292,94,16,23,1,37,362,679,2,55,27,68,0,152,146,909,2554
MAHARASHTRA,BULDHANA,2007,56,41,3,100,39,0,39,78,22,20,2,44,17,4,28,220,633,100,533,1535,210,14,39,0,57,730,1230,12,124,31,256,0,423,180,1064,3780
MAHARASHTRA,CHANDRAPUR,2007,59,23,4,86,35,0,35,70,25,19,6,50,7,1,34,383,815,153,662,2055,129,31,70,3,70,663,1224,5,115,109,169,0,398,258,1140,4148
MAHARASHTRA,DHULE,2007,49,23,1,73,15,0,15,30,5,5,0,10,13,3,24,124,397,92,305,958,170,21,84,2,8,421,935,10,37,14,223,0,284,229,808,2681
MAHARASHTRA,GADCHIROLI,2007,53,47,5,105,11,0,11,22,8,7,1,16,6,0,7,98,162,15,147,435,39,8,9,0,27,200,360,3,31,7,44,0,85,77,440,1282
MAHARASHTRA,GONDIA,2007,34,14,1,49,32,0,32,64,13,13,0,26,9,1,22,188,314,40,274,848,58,6,31,2,30,330,545,3,71,32,51,0,157,88,607,1937
MAHARASHTRA,HINGOLI,2007,29,16,0,45,9,0,9,18,8,7,1,16,6,2,24,81,167,35,132,447,121,6,30,0,18,449,707,3,45,6,98,0,152,83,396,1597
MAHARASHTRA,JALGAON,2007,94,38,1,133,52,0,52,104,27,27,0,54,20,3,49,211,667,138,529,1617,264,60,255,0,16,671,1604,20,75,19,420,0,534,338,1299,4599
MAHARASHTRA,JALNA,2007,52,22,1,75,17,0,17,34,17,10,7,34,7,6,36,152,361,75,286,923,184,8,85,2,26,491,948,31,43,5,266,0,345,152,620,2584
MAHARASHTRA,KOLHAPUR,2007,65,47,1,113,30,0,30,60,16,8,8,32,7,5,35,242,766,268,498,1821,231,104,231,4,11,583,1513,16,51,24,125,0,216,349,1046,3989
MAHARASHTRA,LATUR,2007,73,37,0,110,17,0,17,34,26,26,0,52,10,1,53,249,452,134,318,1217,191,16,64,2,44,971,1498,66,73,0,107,0,246,210,1175,3837
MAHARASHTRA,MUMBAI COMMR.,2007,230,116,2,348,174,0,174,348,179,120,59,358,31,42,265,2886,11670,3621,8049,26564,260,470,1735,113,13,3781,7150,17,365,112,380,0,874,778,6862,30481
MAHARASHTRA,MUMBAI RLY.,2007,4,5,1,10,1,0,1,2,1,0,1,2,3,0,39,3,1721,2,1719,3487,6,5,22,2,0,41,78,0,5,0,0,0,5,2,105,1966
MAHARASHTRA,NAGPUR COMMR.,2007,73,60,5,138,50,0,50,100,66,50,16,132,27,59,357,1141,2354,899,1455,6292,242,73,309,13,20,996,1933,7,96,51,251,0,405,280,3261,9791
MAHARASHTRA,NAGPUR RLY.,2007,4,1,0,5,0,0,0,0,2,2,0,4,5,0,22,0,878,17,861,1783,5,4,1,5,0,29,47,0,8,1,0,0,9,3,63,1031
MAHARASHTRA,NAGPUR RURAL,2007,71,24,1,96,39,0,39,78,24,22,2,48,5,11,47,232,843,82,761,1981,117,28,66,2,43,651,1329,7,92,41,60,0,200,422,1610,4436
MAHARASHTRA,NANDED,2007,83,82,6,171,33,0,33,66,40,29,11,80,18,6,54,317,514,128,386,1423,307,26,121,4,54,1137,1847,19,83,7,213,0,322,198,1332,4654
MAHARASHTRA,NANDURBAR,2007,32,19,1,52,14,0,14,28,3,0,3,6,8,3,13,55,213,41,172,505,90,14,39,1,7,294,562,3,24,2,94,0,123,117,533,1579
MAHARASHTRA,NASIK COMMR.,2007,33,26,1,60,7,0,7,14,21,17,4,42,5,1,50,460,1018,452,566,2552,153,21,127,13,12,224,820,1,34,11,127,0,173,270,500,3115
MAHARASHTRA,NASIK RURAL,2007,80,56,3,139,44,0,44,88,29,16,13,58,27,10,35,226,559,134,425,1416,406,60,86,4,13,839,1988,8,91,53,326,0,478,580,1364,4899
MAHARASHTRA,NAVI MUMBAI,2007,45,22,1,68,17,0,17,34,16,4,12,32,35,28,118,452,1704,806,898,4041,187,66,169,8,12,460,1342,5,32,7,53,0,97,440,828,4705
MAHARASHTRA,OSMANABAD,2007,44,24,2,70,29,0,29,58,23,18,5,46,27,2,43,209,447,78,369,1175,178,21,125,1,46,611,1211,2,84,7,172,0,265,229,880,3206
MAHARASHTRA,PARBHANI,2007,47,39,3,89,22,0,22,44,14,9,5,28,26,1,53,181,290,75,215,841,114,14,57,2,30,1151,1494,8,54,6,183,0,251,126,322,2743
MAHARASHTRA,PUNE COMMR.,2007,126,126,8,260,66,0,66,132,122,93,29,244,37,52,232,1369,4653,2492,2161,10996,457,74,517,12,18,1274,2889,6,79,77,250,0,412,537,2726,12818
MAHARASHTRA,PUNE RLY.,2007,6,0,0,6,0,0,0,0,1,0,1,2,4,1,7,0,316,0,316,644,5,2,2,1,0,11,21,0,0,0,0,0,0,0,36,392
MAHARASHTRA,PUNE RURAL,2007,130,51,12,193,59,0,59,118,41,25,16,82,37,36,73,377,1078,455,623,2679,272,74,186,4,29,655,2181,17,101,16,203,0,337,961,1832,6244
MAHARASHTRA,RAIGAD,2007,37,28,1,66,29,0,29,58,13,10,3,26,22,6,25,192,426,49,377,1097,170,30,67,5,8,273,873,4,39,7,72,0,122,320,617,2391
MAHARASHTRA,RATNAGIRI,2007,19,4,5,28,17,0,17,34,9,4,5,18,8,3,10,152,274,21,253,721,97,24,39,3,35,206,532,2,33,31,48,0,114,128,453,1600
MAHARASHTRA,SANGLI,2007,74,24,0,98,28,0,28,56,18,11,7,36,11,2,23,182,518,134,384,1254,148,19,132,6,30,395,1034,11,72,3,116,0,202,304,535,2651
MAHARASHTRA,SATARA,2007,75,26,5,106,43,0,43,86,38,26,12,76,19,5,73,381,966,249,717,2410,179,35,110,5,24,480,1210,9,59,13,256,0,337,377,1157,4335
MAHARASHTRA,SINDHUDURG,2007,17,3,1,21,9,0,9,18,4,2,2,8,0,1,6,101,132,9,123,372,48,9,20,0,11,117,273,4,13,14,8,0,39,68,196,782
MAHARASHTRA,SOLAPUR COMMR.,2007,22,24,0,46,12,0,12,24,16,13,3,32,4,7,34,120,319,122,197,803,69,12,88,0,7,174,440,0,15,5,81,0,101,90,465,1564
MAHARASHTRA,SOLAPUR RURAL,2007,77,53,5,135,46,0,46,92,35,21,14,70,21,16,65,255,655,182,473,1667,270,20,49,3,38,668,1492,4,63,17,128,0,212,444,1288,4220
MAHARASHTRA,THANE COMMR.,2007,120,74,4,198,78,0,78,156,110,68,42,220,32,34,146,1136,2479,1010,1469,6306,323,97,477,19,24,1352,2644,20,148,20,355,0,543,352,1511,8911
MAHARASHTRA,THANE RURAL,2007,128,39,6,173,67,0,67,134,46,39,7,92,49,20,92,513,853,267,586,2380,300,42,126,9,22,759,1937,7,108,29,139,0,283,679,1234,5267
MAHARASHTRA,WARDHA,2007,49,32,3,84,31,0,31,62,26,25,1,52,4,3,37,248,654,66,588,1600,88,16,48,3,72,756,1152,0,107,35,92,0,234,169,1553,4026
MAHARASHTRA,WASHIM,2007,22,19,3,44,14,0,14,28,19,18,1,38,6,1,22,121,395,42,353,940,88,9,35,0,32,489,752,8,62,14,131,0,215,99,566,2155
MAHARASHTRA,YAVATMAL,2007,70,50,7,127,49,0,49,98,32,31,1,64,9,0,66,263,994,141,853,2326,119,20,63,0,45,979,1447,8,129,27,174,0,338,221,1624,4949
MANIPUR,BISHNUPUR,2007,31,31,1,63,4,0,4,8,9,6,3,18,0,9,0,5,38,6,32,90,11,3,9,0,3,53,79,0,21,0,0,0,21,0,139,367
MANIPUR,CHANDEL,2007,16,17,0,33,0,0,0,0,2,0,2,4,0,3,0,2,7,1,6,19,2,0,3,0,3,13,22,0,0,0,0,0,0,1,19,88
MANIPUR,CHURACHANDPUR,2007,28,5,0,33,1,0,1,2,6,1,5,12,0,0,0,11,46,3,43,103,2,1,4,1,0,1,9,0,0,0,0,0,0,0,51,157
MANIPUR,IMPHAL EAST,2007,41,89,0,130,1,0,1,2,28,19,9,56,0,81,1,7,70,13,57,229,13,1,6,0,15,68,103,0,4,0,1,0,5,0,182,608
MANIPUR,IMPHAL WEST,2007,61,130,0,191,7,0,7,14,64,37,27,128,1,42,3,30,228,100,128,532,18,11,40,2,16,138,225,0,28,0,11,0,39,0,408,1238
MANIPUR,SENAPATI,2007,17,15,0,32,1,0,1,2,8,2,6,16,0,10,5,0,12,0,12,39,6,0,2,1,14,5,28,0,0,0,0,0,0,0,49,145
MANIPUR,TAMENGLONG,2007,3,4,0,7,0,0,0,0,2,0,2,4,0,0,0,0,5,1,4,10,2,0,0,0,1,1,4,0,0,0,0,0,0,0,20,38
MANIPUR,THOUBAL,2007,39,74,1,114,6,0,6,12,27,17,10,54,1,0,1,12,40,26,14,94,16,2,25,0,8,97,148,0,17,0,3,0,20,0,175,544
MANIPUR,UKHRUL,2007,4,12,0,16,0,0,0,0,4,1,3,8,1,1,1,3,8,0,8,22,0,1,4,0,3,1,9,0,0,0,0,0,0,0,31,74
MEGHALAYA,GARO HILLS EAST,2007,9,10,1,20,4,0,4,8,6,0,6,12,8,0,0,20,32,0,32,92,22,1,0,0,6,9,38,0,3,0,0,0,3,0,28,159
MEGHALAYA,GARO HILLS SOUTH,2007,2,5,0,7,1,0,1,2,2,0,2,4,2,0,4,5,12,0,12,35,2,0,1,2,0,5,10,0,0,0,0,0,0,0,10,53
MEGHALAYA,GARO HILLS WEST,2007,13,6,3,22,4,0,4,8,16,10,6,32,10,1,6,26,57,13,44,157,2,3,13,5,1,28,62,0,12,1,4,0,17,10,46,267
MEGHALAYA,JAINTIA HILLS,2007,43,2,0,45,26,0,26,52,3,1,2,6,10,0,7,21,56,2,54,150,0,2,6,0,5,22,55,0,6,0,0,0,6,20,85,314
MEGHALAYA,KHASI HILLS EAST,2007,21,19,3,43,32,0,32,64,22,10,12,44,9,0,30,108,270,62,208,687,3,9,136,5,21,56,268,2,11,0,13,0,26,38,171,979
MEGHALAYA,KHASI HILLS WEST,2007,16,4,1,21,8,0,8,16,2,0,2,4,13,0,3,14,20,0,20,70,2,1,5,0,0,0,8,0,2,0,0,0,2,0,36,127
MEGHALAYA,RI-BHOI,2007,10,3,0,13,7,0,7,14,1,1,0,2,3,0,6,9,53,14,39,124,2,1,3,0,3,4,13,0,11,0,2,0,13,0,62,180
MIZORAM,AIZAWL,2007,18,11,3,32,35,0,35,70,3,0,3,6,0,0,3,216,464,60,404,1147,1,8,42,11,22,38,143,0,38,0,2,0,40,21,120,1056
MIZORAM,CHAMPHAI,2007,5,2,0,7,12,0,12,24,0,0,0,0,0,0,0,32,65,3,62,162,0,1,8,2,3,10,26,0,3,0,0,0,3,2,19,164
MIZORAM,KOLASIB,2007,9,1,0,10,12,0,12,24,1,0,1,2,0,0,1,47,83,0,83,214,0,2,3,1,7,12,31,0,6,0,0,0,6,6,57,248
MIZORAM,LAWNGTLAI,2007,5,2,0,7,3,0,3,6,0,0,0,0,0,0,0,20,27,0,27,74,0,1,3,0,0,10,14,0,5,0,0,0,5,0,48,124
MIZORAM,LUNGLEI,2007,2,1,0,3,9,0,9,18,0,0,0,0,0,0,1,78,90,0,90,259,0,3,6,0,1,4,14,0,7,0,0,0,7,0,35,237
MIZORAM,MAMIT,2007,1,2,1,4,1,0,1,2,0,0,0,0,0,0,0,28,24,0,24,76,0,1,1,2,3,0,11,0,3,0,0,0,3,4,3,74
MIZORAM,SAIHA,2007,2,0,0,2,3,0,3,6,0,0,0,0,0,0,0,19,29,0,29,77,0,2,0,0,0,8,11,0,3,0,0,0,3,1,36,103
MIZORAM,SERCHHIP,2007,1,2,0,3,8,0,8,16,0,0,0,0,0,0,0,17,26,1,25,69,0,2,3,0,2,3,10,0,1,0,0,0,1,0,12,77
NAGALAND,DIMAPUR,2007,30,8,0,38,5,0,5,10,7,4,3,14,2,0,49,64,209,161,48,533,1,4,15,3,2,9,68,0,5,1,0,0,6,34,62,510
NAGALAND,KIPHIRE,2007,3,1,0,4,0,0,0,0,0,0,0,0,0,0,0,1,2,0,2,5,0,0,1,0,0,0,1,0,0,0,0,0,0,0,11,19
NAGALAND,KOHIMA,2007,24,14,2,40,4,0,4,8,4,1,3,8,4,0,18,17,63,21,42,165,0,2,10,1,0,6,19,0,1,0,0,0,1,0,78,248
NAGALAND,LONGLENG,2007,1,2,1,4,0,0,0,0,1,1,0,2,0,0,0,0,0,0,0,0,0,0,1,0,0,0,1,0,0,0,0,0,0,0,7,13
NAGALAND,MOKOKCHUNG,2007,17,3,0,20,1,0,1,2,3,0,3,6,1,0,2,10,13,8,5,39,3,0,1,0,0,5,16,0,0,0,0,0,0,7,18,84
NAGALAND,MON,2007,9,1,2,12,0,0,0,0,0,0,0,0,0,0,2,7,10,0,10,29,0,1,4,0,0,7,12,0,1,0,0,0,1,0,13,57
NAGALAND,PEREN,2007,3,0,0,3,0,0,0,0,1,0,1,2,0,0,1,5,8,1,7,22,0,0,0,0,1,2,3,0,0,0,0,0,0,0,7,28
NAGALAND,PHEK,2007,5,5,2,12,0,0,0,0,0,0,0,0,0,0,2,5,8,0,8,23,2,1,0,0,0,6,9,0,1,0,0,0,1,0,13,50
NAGALAND,TUENSANG,2007,7,4,0,11,0,0,0,0,1,0,1,2,0,0,0,4,9,0,9,22,6,3,1,0,1,2,13,0,0,0,0,0,0,0,13,51
NAGALAND,WOKHA,2007,8,7,0,15,3,0,3,6,0,0,0,0,0,0,1,1,23,2,21,48,2,0,1,2,1,9,17,0,0,0,0,0,0,2,6,66
NAGALAND,ZUNHEBOTO,2007,4,5,1,10,0,0,0,0,0,0,0,0,0,0,0,4,15,1,14,34,1,2,0,2,0,6,11,0,0,0,0,0,0,0,14,54
ODISHA,ANGUL,2007,54,71,1,126,38,0,38,76,37,29,8,74,11,3,61,111,370,68,302,926,141,9,22,0,31,86,437,16,199,18,43,0,276,148,958,2428
ODISHA,BALASORE,2007,36,33,1,70,55,0,55,110,51,42,9,102,17,0,40,172,290,45,245,809,47,26,31,4,23,368,500,35,113,23,32,0,203,1,1399,2797
ODISHA,BARAGARH,2007,41,47,2,90,18,0,18,36,14,10,4,28,3,2,33,71,170,41,129,449,103,3,10,1,20,37,337,10,63,5,9,0,87,163,597,1422
ODISHA,BERHAMPUR,2007,16,36,0,52,4,0,4,8,8,6,2,16,3,5,27,91,133,52,81,392,37,17,47,1,10,70,246,9,98,4,17,0,128,64,359,1056
ODISHA,BHADRAK,2007,30,20,0,50,42,0,42,84,21,20,1,42,7,1,23,59,68,12,56,226,37,18,42,2,15,25,213,36,76,10,11,0,133,74,1117,1734
ODISHA,BOLANGIR,2007,38,61,0,99,53,0,53,106,26,22,4,52,7,0,37,71,143,21,122,401,102,10,48,1,14,88,330,16,144,6,18,0,184,67,920,1870
ODISHA,BOUDH,2007,10,4,0,14,9,0,9,18,5,4,1,10,2,0,4,21,27,1,26,81,40,1,0,1,8,170,220,1,59,1,8,0,69,0,114,485
ODISHA,CUTTACK,2007,42,40,0,82,41,0,41,82,68,63,5,136,13,6,136,261,753,261,492,1922,104,8,79,2,23,82,869,48,47,13,36,0,144,571,1546,3919
ODISHA,DEOGARH,2007,26,23,0,49,13,0,13,26,8,3,5,16,3,0,16,32,44,2,42,139,17,6,16,1,4,189,270,2,79,5,10,0,96,37,124,655
ODISHA,DHENKANAL,2007,59,53,0,112,35,0,35,70,26,24,2,52,9,0,54,61,193,30,163,510,109,13,44,0,30,82,363,25,197,8,20,0,250,85,797,1900
ODISHA,GAJAPATI,2007,12,6,0,18,8,0,8,16,10,9,1,20,0,0,1,28,27,5,22,83,24,4,11,0,4,23,85,2,30,2,6,0,40,19,235,452
ODISHA,GANJAM,2007,66,127,3,196,34,0,34,68,27,17,10,54,7,0,40,150,149,33,116,495,171,20,27,0,30,372,752,20,232,14,18,0,284,132,605,2244
ODISHA,JAGATSINGHPUR,2007,23,4,0,27,18,0,18,36,13,7,6,26,19,1,34,69,120,27,93,363,39,9,34,0,10,127,374,19,8,2,12,0,41,155,601,1317
ODISHA,JAJPUR,2007,35,17,0,52,25,0,25,50,32,29,3,64,15,0,44,103,209,58,151,580,112,15,38,2,11,562,832,33,101,5,25,0,164,92,676,2152
ODISHA,JHARSUGUDA,2007,21,27,0,48,11,0,11,22,16,11,5,32,18,1,28,109,251,73,178,658,57,6,13,0,5,511,701,1,67,4,15,0,87,109,156,1426
ODISHA,KALAHANDI,2007,30,15,0,45,30,0,30,60,23,18,5,46,6,0,24,59,93,11,82,275,67,21,77,2,6,180,353,12,68,8,19,0,107,0,562,1302
ODISHA,KANDHAMAL,2007,25,19,0,44,32,0,32,64,14,13,1,28,0,0,24,42,40,5,35,146,82,3,9,0,23,359,477,4,114,5,32,0,155,1,124,952
ODISHA,KENDRAPARA,2007,40,13,0,53,30,0,30,60,31,27,4,62,11,3,40,95,93,18,75,335,34,3,15,0,13,47,112,41,11,2,27,0,81,0,916,1465
ODISHA,KEONJHAR,2007,81,85,0,166,41,0,41,82,35,32,3,70,6,0,54,82,231,57,174,604,88,24,38,2,24,35,655,21,211,10,25,0,267,444,354,1891
ODISHA,KHURDA,2007,56,59,4,119,53,0,53,106,79,60,19,158,23,2,175,475,1310,574,736,3295,93,25,346,1,23,1585,2265,20,52,11,53,0,136,192,1415,6052
ODISHA,KORAPUT,2007,42,34,1,77,41,0,41,82,32,29,3,64,2,0,21,85,141,16,125,390,39,6,34,2,8,60,340,4,126,10,54,0,194,191,579,1512
ODISHA,MALKANGIR,2007,30,19,0,49,12,0,12,24,9,7,2,18,1,0,7,11,30,4,26,79,29,2,3,0,3,49,110,2,20,6,12,0,40,24,111,380
ODISHA,MAYURBHANJ,2007,98,54,0,152,74,0,74,148,32,29,3,64,6,5,47,96,290,29,261,734,30,13,48,4,12,352,690,16,176,22,68,0,282,231,760,2434
ODISHA,NAYAGARH,2007,31,26,0,57,21,0,21,42,35,27,8,70,0,0,16,81,100,20,80,297,35,9,27,0,8,524,641,14,13,6,21,0,54,38,268,1273
ODISHA,NOWRANGPUR,2007,28,21,2,51,28,0,28,56,22,20,2,44,3,0,6,30,42,6,36,123,42,7,7,0,4,88,206,1,62,11,17,0,91,58,372,851
ODISHA,NUAPADA,2007,17,13,0,30,5,0,5,10,14,11,3,28,1,0,4,30,59,7,52,153,20,5,21,1,7,65,143,8,43,4,17,0,72,24,391,749
ODISHA,PURI,2007,21,32,0,53,43,0,43,86,17,12,5,34,9,2,90,174,348,66,282,971,79,1,39,0,11,169,590,34,19,0,25,0,78,291,1405,2809
ODISHA,RAYAGADA,2007,31,22,7,60,23,0,23,46,14,14,0,28,1,0,7,45,59,9,50,171,39,5,29,1,1,2,224,2,71,4,23,0,100,147,255,788
ODISHA,ROURKELA,2007,23,15,1,39,15,0,15,30,9,8,1,18,3,5,31,68,221,56,165,549,22,1,46,1,2,219,351,2,60,8,9,0,79,60,597,1418
ODISHA,SAMBALPUR,2007,46,30,0,76,27,0,27,54,15,11,4,30,17,3,82,169,259,35,224,789,80,9,29,1,16,337,554,5,70,6,29,0,110,82,815,2127
ODISHA,SONEPUR,2007,9,19,0,28,16,0,16,32,12,9,3,24,0,0,8,24,45,2,43,122,27,0,9,0,3,142,193,0,64,2,4,0,70,12,70,466
ODISHA,SRP(CUTTACK),2007,2,0,0,2,0,0,0,0,2,0,2,4,2,0,11,5,207,41,166,432,0,1,4,0,0,29,34,0,1,0,1,0,2,0,78,343
ODISHA,SRP(ROURKELA),2007,6,0,0,6,1,0,1,2,2,2,0,4,2,2,10,9,103,8,95,229,3,1,3,0,0,1,11,0,4,1,0,0,5,3,130,281
ODISHA,SUNDARGARH,2007,85,60,0,145,43,0,43,86,42,35,7,84,20,1,38,84,212,40,172,567,34,18,17,0,9,443,777,2,77,5,12,0,96,256,464,1922
PUNJAB,AMRITSAR,2007,43,46,11,100,21,0,21,42,48,46,2,96,2,9,21,137,445,152,293,1059,0,28,267,9,2,251,660,5,20,6,78,0,109,103,590,2142
PUNJAB,AMRITSAR RURAL,2007,31,24,2,57,10,0,10,20,31,24,7,62,0,1,3,28,70,10,60,172,0,3,83,4,7,142,298,1,9,5,17,0,32,59,214,744
PUNJAB,BARNALA,2007,12,17,7,36,7,0,7,14,6,3,3,12,0,1,1,29,65,22,43,161,1,18,58,1,1,109,259,5,8,0,12,0,25,71,208,637
PUNJAB,BATALA,2007,25,36,2,63,15,0,15,30,19,16,3,38,2,0,0,64,144,31,113,354,0,7,170,2,0,204,438,2,18,0,54,0,74,55,230,1049
PUNJAB,BHATINDA,2007,41,54,11,106,27,0,27,54,34,29,5,68,1,2,7,201,309,173,136,829,0,15,138,1,11,285,451,6,25,3,33,0,67,1,688,1893
PUNJAB,FARIDKOT,2007,23,29,1,53,13,0,13,26,17,11,6,34,0,1,2,108,137,53,84,385,0,9,114,5,4,197,332,2,19,0,28,0,49,3,355,1067
PUNJAB,FATEHGARH SAHIB,2007,10,15,5,30,15,0,15,30,47,24,23,94,1,1,3,124,244,93,151,617,0,27,137,1,0,191,530,5,17,6,0,0,28,174,269,1292
PUNJAB,FEROZPUR,2007,48,48,7,103,33,0,33,66,33,24,9,66,0,2,0,135,199,70,129,535,0,23,145,2,6,506,812,5,21,0,44,0,70,130,481,1868
PUNJAB,G.R.P,2007,14,0,2,16,2,0,2,4,1,0,1,2,0,3,0,3,34,3,31,74,0,0,6,1,0,22,29,2,2,0,0,0,4,0,214,306
PUNJAB,GURDASPUR,2007,19,17,11,47,30,0,30,60,26,21,5,52,1,2,2,66,120,48,72,311,0,14,84,3,1,123,385,9,15,0,28,0,52,160,369,1100
PUNJAB,HOSHIARPUR,2007,43,39,5,87,27,0,27,54,25,15,10,50,1,0,2,106,210,57,153,529,0,10,168,2,8,352,751,6,18,0,71,0,95,211,386,1690
PUNJAB,JAGRAON,2007,10,24,5,39,15,0,15,30,10,8,2,20,0,7,0,44,100,31,69,251,0,10,56,2,0,151,301,1,8,5,24,0,38,82,320,874
PUNJAB,JALANDHAR,2007,63,118,32,213,54,0,54,108,113,82,31,226,5,11,11,332,630,285,345,1619,0,12,537,8,14,615,1426,12,48,2,120,0,182,240,878,3855
PUNJAB,KAPURTHALA,2007,29,33,4,66,22,0,22,44,22,10,12,44,0,7,15,91,210,50,160,533,0,8,199,3,7,225,539,7,25,0,42,0,74,97,434,1480
PUNJAB,KHANNA,2007,24,21,4,49,17,0,17,34,18,14,4,36,3,0,7,61,108,47,61,287,0,13,112,3,0,160,432,8,0,0,33,0,41,144,347,1083
PUNJAB,LUDHIANA,2007,63,76,8,147,58,0,58,116,120,93,27,240,3,20,19,273,664,334,330,1643,0,31,310,4,6,276,912,9,25,13,107,0,154,285,1039,3409
PUNJAB,MANSA,2007,28,31,6,65,20,0,20,40,8,3,5,16,1,0,1,47,59,23,36,167,0,17,48,2,4,189,260,6,5,0,22,0,33,0,283,777
PUNJAB,MOGA,2007,37,34,8,79,7,0,7,14,22,14,8,44,0,2,4,70,125,44,81,326,0,26,155,0,6,260,540,4,20,5,30,0,59,93,216,1124
PUNJAB,MUKTSAR,2007,27,32,4,63,11,0,11,22,22,13,9,44,0,0,2,64,104,44,60,274,0,6,36,1,1,169,268,4,11,0,13,0,28,55,225,787
PUNJAB,NAWAN SHAHR,2007,21,20,2,43,13,0,13,26,10,9,1,20,1,1,15,61,99,35,64,276,0,8,72,3,0,202,377,4,15,1,15,0,35,92,169,824
PUNJAB,PATIALA,2007,51,55,8,114,22,0,22,44,25,14,11,50,1,10,3,158,320,153,167,812,0,11,164,2,6,370,870,17,22,0,109,0,148,317,757,2428
PUNJAB,ROPAR,2007,10,11,3,24,7,0,7,14,9,5,4,18,0,1,5,78,108,39,69,300,0,5,81,0,4,99,315,2,11,0,24,0,37,126,314,898
PUNJAB,SANGRUR,2007,36,58,9,103,31,0,31,62,26,17,9,52,3,4,8,132,210,72,138,567,0,9,115,3,8,234,519,5,31,2,51,0,89,150,553,1678
PUNJAB,SAS NGR,2007,11,21,13,45,16,0,16,32,33,23,10,66,2,5,2,139,312,180,132,772,0,6,179,0,0,125,388,0,0,0,0,0,0,78,660,1602
PUNJAB,TARN TARAN,2007,41,34,0,75,26,0,26,52,35,27,8,70,10,2,5,65,147,35,112,376,0,13,147,6,0,206,447,6,34,0,16,0,56,75,318,1186
RAJASTHAN,AJMER,2007,53,71,1,125,31,0,31,62,89,65,24,178,2,1,24,270,867,344,523,2031,55,22,617,4,13,281,1439,19,105,3,515,0,642,447,3218,6708
RAJASTHAN,ALWAR,2007,89,62,4,155,73,0,73,146,109,65,44,218,0,7,38,178,1241,576,665,2705,35,56,746,4,32,2022,3361,43,141,1,391,0,576,466,2461,8199
RAJASTHAN,BANSWARA,2007,39,13,1,53,39,0,39,78,46,42,4,92,0,3,9,64,106,26,80,288,95,0,71,0,23,811,1106,4,55,1,100,0,160,106,613,2199
RAJASTHAN,BARAN,2007,37,98,0,135,43,0,43,86,28,28,0,56,1,3,13,92,271,76,195,651,8,17,129,0,17,381,650,8,112,1,194,0,315,98,938,2489
RAJASTHAN,BARMER,2007,26,27,1,54,19,0,19,38,29,24,5,58,0,0,1,105,178,59,119,462,7,13,200,0,19,559,938,9,78,0,103,0,190,140,1150,2664
RAJASTHAN,BHARATPUR,2007,69,48,5,122,62,0,62,124,112,83,29,224,32,11,22,69,772,290,482,1678,22,16,552,4,50,479,1333,30,41,1,360,0,432,210,3964,6931
RAJASTHAN,BHILWARA,2007,34,46,4,84,48,0,48,96,66,47,19,132,1,0,47,227,596,302,294,1467,24,9,379,1,14,113,785,10,80,1,329,0,420,245,2355,4629
RAJASTHAN,BIKANER,2007,39,85,0,124,32,0,32,64,36,33,3,72,0,0,8,124,320,104,216,772,2,8,448,1,5,610,1266,18,76,0,307,0,401,192,1794,4105
RAJASTHAN,BUNDI,2007,28,55,0,83,28,0,28,56,57,47,10,114,1,0,14,98,216,74,142,545,24,12,191,0,8,608,952,2,87,0,204,0,293,109,1126,2868
RAJASTHAN,CHITTORGARH,2007,48,48,3,99,92,0,92,184,147,119,28,294,4,2,38,230,628,170,458,1530,132,28,301,3,46,1758,2509,6,155,2,530,0,693,241,1800,6242
RAJASTHAN,CHURU,2007,20,29,2,51,27,0,27,54,27,18,9,54,0,0,6,106,160,28,132,432,8,11,228,0,8,579,968,11,38,0,244,0,293,134,949,2587
RAJASTHAN,DAUSA,2007,34,18,1,53,16,0,16,32,67,43,24,134,0,0,9,108,725,329,396,1567,28,10,267,1,27,0,530,12,39,0,112,0,163,197,2524,4195
RAJASTHAN,DHOLPUR,2007,44,68,0,112,20,0,20,40,57,41,16,114,5,7,12,43,403,146,257,873,29,16,115,3,14,1422,1711,13,22,0,164,0,199,112,802,3371
RAJASTHAN,DUNGARPUR,2007,23,17,0,40,10,0,10,20,42,40,2,84,1,2,10,47,58,24,34,176,70,31,62,0,16,181,481,2,58,0,66,0,126,121,1174,1991
RAJASTHAN,G.R.P.,2007,4,5,0,9,0,0,0,0,6,3,3,12,1,3,2,0,483,9,474,972,14,5,7,1,1,7,44,1,12,4,0,0,17,9,407,972
RAJASTHAN,GANGANAGAR,2007,61,73,1,135,66,0,66,132,56,44,12,112,1,0,18,191,388,106,282,986,0,36,686,2,6,959,1846,11,64,2,625,0,702,157,1769,5172
RAJASTHAN,HANUMANGARH,2007,32,137,1,170,39,0,39,78,24,19,5,48,0,2,6,91,199,42,157,497,0,10,376,0,7,265,767,14,53,1,179,0,247,109,1377,2922
RAJASTHAN,JAIPUR EAST,2007,14,31,0,45,25,0,25,50,65,45,20,130,4,2,102,358,2295,1413,882,5056,121,52,462,5,5,42,905,7,38,0,159,0,204,218,2522,6527
RAJASTHAN,JAIPUR NORTH,2007,17,27,0,44,23,0,23,46,76,76,0,152,2,0,24,159,830,457,373,1845,52,55,430,0,4,347,1022,11,37,0,168,0,216,134,1393,3789
RAJASTHAN,JAIPUR RURAL,2007,66,25,7,98,39,0,39,78,85,66,19,170,1,2,24,246,1097,349,748,2467,105,38,848,0,44,638,2371,25,127,5,204,0,361,698,4605,8929
RAJASTHAN,JAIPUR SOUTH,2007,21,18,2,41,14,0,14,28,65,58,7,130,1,2,27,304,1293,736,557,2920,114,161,721,4,5,393,1598,7,26,0,157,0,190,200,1644,5179
RAJASTHAN,JAISALMER,2007,5,3,0,8,4,0,4,8,13,7,6,26,1,0,2,39,139,24,115,320,24,1,71,0,5,0,154,7,9,0,23,0,39,53,573,972
RAJASTHAN,JALORE,2007,21,22,0,43,7,0,7,14,30,24,6,60,2,0,3,79,152,34,118,388,18,17,110,0,29,72,337,9,62,0,107,0,178,91,1498,2329
RAJASTHAN,JHALAWAR,2007,43,105,2,150,54,0,54,108,49,35,14,98,1,23,20,78,390,189,201,902,67,5,113,2,26,458,810,10,113,0,222,0,345,139,862,2782
RAJASTHAN,JHUNJHUNU,2007,44,16,1,61,31,0,31,62,34,25,9,68,0,0,2,135,310,74,236,757,33,6,310,1,33,740,1284,18,39,0,204,0,261,161,1838,3956
RAJASTHAN,JODHPUR CITY,2007,16,57,2,75,16,0,16,32,55,40,15,110,0,0,16,207,718,429,289,1659,20,18,487,2,11,614,1308,11,32,1,227,0,271,156,806,3472
RAJASTHAN,JODHPUR RURAL,2007,23,30,0,53,24,0,24,48,19,15,4,38,2,0,13,102,232,22,210,581,17,11,126,0,22,1048,1418,15,49,0,70,0,134,194,702,2699
RAJASTHAN,KARAULI,2007,37,51,2,90,28,0,28,56,69,43,26,138,0,6,26,27,424,200,224,907,13,17,136,1,36,19,314,18,35,0,110,0,163,92,2417,3564
RAJASTHAN,KOTA CITY,2007,22,154,2,178,25,0,25,50,84,66,18,168,1,2,62,137,897,589,308,1996,10,25,384,0,10,145,692,10,41,1,261,0,313,118,1270,3661
RAJASTHAN,KOTA RURAL,2007,25,37,2,64,30,0,30,60,33,30,3,66,2,0,23,87,209,109,100,530,15,8,109,0,12,250,492,5,73,0,173,0,251,98,577,1768
RAJASTHAN,NAGAUR,2007,42,46,1,89,38,0,38,76,49,37,12,98,1,0,20,200,372,103,269,965,6,13,347,4,11,127,729,12,119,0,252,0,383,221,2120,4001
RAJASTHAN,PALI,2007,30,36,5,71,39,0,39,78,71,62,9,142,0,0,13,220,333,88,245,899,26,21,315,3,12,33,666,5,108,0,268,0,381,256,2939,4733
RAJASTHAN,RAJSAMAND,2007,13,16,0,29,5,0,5,10,43,36,7,86,1,0,9,91,173,68,105,447,41,10,143,0,7,662,1005,6,28,1,189,0,224,142,745,2325
RAJASTHAN,SAWAI MADHOPUR,2007,19,21,3,43,21,0,21,42,48,36,12,96,0,1,12,81,452,237,215,998,16,2,224,2,16,9,337,13,33,0,131,0,177,68,2313,3485
RAJASTHAN,SIKAR,2007,36,35,2,73,34,0,34,68,59,42,17,118,1,1,8,152,353,93,260,868,24,8,373,3,22,443,1158,19,32,0,183,0,234,285,1974,4047
RAJASTHAN,SIROHI,2007,22,21,1,44,23,0,23,46,37,32,5,74,0,0,9,68,164,26,138,405,27,17,127,0,6,438,757,5,51,0,130,0,186,142,600,1888
RAJASTHAN,TONK,2007,23,36,1,60,19,0,19,38,60,50,10,120,0,0,9,84,271,94,177,635,51,15,212,2,9,910,1392,3,20,1,212,0,236,193,1366,3497
RAJASTHAN,UDAIPUR,2007,84,85,7,176,94,0,94,188,135,108,27,270,2,1,77,267,630,219,411,1607,273,25,496,3,44,1297,2482,10,189,2,297,0,498,344,2661,7023
SIKKIM,EAST,2007,2,10,2,14,8,0,8,16,5,5,0,10,0,0,4,52,62,9,53,180,9,6,28,3,1,29,94,0,3,0,3,0,6,18,83,328
SIKKIM,NORTH,2007,0,0,1,1,0,0,0,0,0,0,0,0,0,0,1,3,5,0,5,14,0,0,0,0,0,5,8,0,0,0,1,0,1,3,13,32
SIKKIM,SOUTH,2007,1,2,0,3,12,0,12,24,1,1,0,2,0,0,0,18,29,1,28,76,5,1,6,0,0,33,52,0,3,0,2,0,5,7,60,180
SIKKIM,WEST,2007,6,2,0,8,4,0,4,8,3,3,0,6,0,0,1,10,22,1,21,55,1,0,0,0,0,28,35,0,7,0,1,0,8,6,36,127
TAMIL NADU,CHENNAI,2007,145,247,4,396,46,0,46,92,83,59,24,166,8,0,74,654,2117,338,1779,4970,115,14,433,9,11,1224,2931,43,108,126,323,0,600,1125,9599,16508
TAMIL NADU,CHENNAI RLY.,2007,4,5,0,9,0,0,0,0,3,1,2,6,0,1,4,4,113,6,107,235,17,0,1,1,0,28,52,1,2,0,0,0,3,5,169,358
TAMIL NADU,COIMBATORE RURAL,2007,87,62,1,150,16,0,16,32,84,71,13,168,7,0,27,286,1044,327,717,2408,190,17,169,7,17,776,2043,11,121,8,163,0,303,867,10400,14360
TAMIL NADU,COIMBATORE URBAN,2007,22,15,0,37,10,0,10,20,14,8,6,28,1,0,8,131,682,126,556,1504,5,7,92,1,4,162,565,4,12,2,50,0,68,294,2408,3924
TAMIL NADU,CUDDALORE,2007,61,114,0,175,28,0,28,56,57,57,0,114,4,0,28,117,490,141,349,1129,152,0,32,0,41,603,1215,3,28,113,50,0,194,387,4601,6909
TAMIL NADU,DHARMAPURI,2007,38,46,4,88,6,0,6,12,44,37,7,88,5,1,2,38,124,52,72,294,128,6,39,1,21,961,1364,4,77,0,45,0,126,208,1690,3488
TAMIL NADU,DINDIGUL,2007,40,79,0,119,12,0,12,24,50,49,1,100,1,0,10,71,297,63,234,676,57,6,71,2,15,379,924,3,28,15,66,0,112,394,2843,4439
TAMIL NADU,ERODE,2007,54,31,0,85,20,0,20,40,66,62,4,132,5,0,10,133,603,133,470,1354,64,18,90,1,30,613,1419,5,64,7,99,0,175,603,4864,7380
TAMIL NADU,KANCHIPURAM,2007,57,97,0,154,25,0,25,50,18,18,0,36,4,0,16,157,368,91,277,913,80,0,32,0,23,390,1345,13,27,18,10,0,68,820,5081,7236
TAMIL NADU,KANYAKUMARI,2007,27,51,1,79,11,0,11,22,22,22,0,44,3,0,6,116,292,32,260,709,0,2,100,5,18,500,818,7,11,45,70,0,133,193,2726,4206
TAMIL NADU,KARUR,2007,18,17,0,35,3,0,3,6,14,10,4,28,2,0,14,37,168,77,91,389,29,5,16,6,2,171,412,0,16,4,17,0,37,183,1920,2642
TAMIL NADU,KRISHNAGIRI,2007,72,44,0,116,11,0,11,22,38,32,6,76,8,7,21,40,291,126,165,658,163,2,57,5,17,617,1306,3,43,6,16,0,68,445,2656,4562
TAMIL NADU,MADURAI RURAL,2007,55,52,0,107,9,0,9,18,36,30,6,72,3,7,10,77,252,16,236,601,133,15,116,0,14,521,1193,11,54,30,97,0,192,394,2848,4734
TAMIL NADU,MADURAI URBAN,2007,27,25,0,52,4,0,4,8,23,16,7,46,3,0,5,68,334,80,254,744,7,23,163,2,3,119,419,10,11,31,76,0,128,102,1289,2325
TAMIL NADU,NAGAPATTINAM,2007,39,65,0,104,14,0,14,28,28,26,2,56,0,2,4,56,205,31,174,472,40,3,54,1,28,469,796,4,53,5,22,0,84,201,3111,4404
TAMIL NADU,NAMAKKAL,2007,26,19,0,45,12,0,12,24,31,26,5,62,4,0,7,46,230,110,120,517,55,2,33,3,11,394,891,3,33,9,27,0,72,393,2511,3849
TAMIL NADU,NILGIRIS,2007,13,8,0,21,6,0,6,12,5,3,2,10,2,0,2,62,104,18,86,274,15,8,12,1,0,182,261,1,13,0,8,0,22,43,880,1365
TAMIL NADU,PERAMBALUR,2007,32,35,1,68,26,0,26,52,22,21,1,44,1,0,5,53,172,52,120,403,47,3,20,1,17,301,561,3,65,14,31,0,113,172,1875,2896
TAMIL NADU,PUDUKOTTAI,2007,34,29,3,66,14,0,14,28,25,20,5,50,0,0,9,59,257,44,213,582,41,14,26,0,13,273,605,6,55,0,36,0,97,238,2318,3450
TAMIL NADU,RAMNATHAPURAM,2007,37,55,0,92,8,0,8,16,25,18,7,50,0,0,6,61,187,25,162,441,49,1,59,0,13,387,637,3,29,11,7,0,50,128,1961,3027
TAMIL NADU,SALEM RURAL,2007,67,54,2,123,25,0,25,50,71,60,11,142,8,2,21,55,202,45,157,490,191,0,25,0,40,1255,1896,6,125,0,69,0,200,385,2605,5208
TAMIL NADU,SALEM URBAN,2007,16,30,0,46,10,0,10,20,28,21,7,56,0,0,5,41,186,53,133,418,28,4,50,4,3,237,439,2,14,21,42,0,79,113,686,1520
TAMIL NADU,SIVAGANGAI,2007,43,50,0,93,3,0,3,6,40,31,9,80,0,0,9,71,227,33,194,534,39,9,70,0,18,315,634,3,4,12,63,0,82,183,1738,2897
TAMIL NADU,THANJAVUR,2007,68,66,0,134,5,0,5,10,50,47,3,100,4,8,18,133,588,98,490,1339,71,6,35,1,35,766,1272,9,96,0,46,0,151,358,4141,6504
TAMIL NADU,THENI,2007,29,62,1,92,4,0,4,8,22,22,0,44,0,1,9,105,241,51,190,597,77,5,74,1,26,481,844,3,42,12,44,0,101,180,2293,3712
TAMIL NADU,THIRUNELVELI RURAL,2007,80,262,1,343,35,0,35,70,56,54,2,112,1,0,46,170,416,43,373,1049,2,7,87,7,75,871,1333,5,96,0,105,0,206,284,5004,7610
TAMIL NADU,THIRUNELVELI URBAN,2007,16,47,1,64,6,0,6,12,10,7,3,20,0,2,10,34,196,41,155,438,6,4,37,0,6,87,219,1,8,28,7,0,44,79,813,1398
TAMIL NADU,THIRUVALLUR,2007,23,35,0,58,7,0,7,14,14,12,2,28,2,0,2,41,161,35,126,367,37,0,21,1,18,382,599,3,88,10,16,0,117,140,2055,3056
TAMIL NADU,THIRUVANNAMALAI,2007,45,26,1,72,14,0,14,28,25,25,0,50,1,0,2,67,195,50,145,460,73,6,49,0,23,562,903,4,25,28,15,0,72,190,3312,4663
TAMIL NADU,THIRUVARUR,2007,39,44,1,84,9,0,9,18,30,30,0,60,5,0,13,121,175,19,156,489,81,4,33,2,10,534,1025,10,23,10,25,0,68,361,2770,4300
TAMIL NADU,THOOTHUGUDI,2007,62,100,0,162,19,0,19,38,33,29,4,66,0,0,11,156,411,52,359,989,4,16,116,8,16,437,867,2,5,191,61,0,259,270,2745,4663
TAMIL NADU,TRICHY RLY.,2007,0,0,0,0,0,0,0,0,0,0,0,0,0,0,0,0,31,0,31,62,2,0,1,0,0,10,19,0,1,0,0,0,1,6,41,92
TAMIL NADU,TRICHY RURAL,2007,49,19,0,68,12,0,12,24,23,20,3,46,0,0,10,57,184,62,122,435,16,0,20,1,8,194,567,4,19,0,31,0,54,328,2591,3566
TAMIL NADU,TRICHY URBAN,2007,21,22,0,43,2,0,2,4,17,14,3,34,1,0,18,68,516,125,391,1119,4,2,80,0,1,79,293,2,7,6,33,0,48,127,2212,3218
TAMIL NADU,VELLORE,2007,66,36,2,104,25,0,25,50,55,48,7,110,0,0,11,165,418,129,289,1012,4,3,52,0,13,647,1127,8,26,0,75,0,109,408,5329,7343
TAMIL NADU,VILLUPURAM,2007,70,76,5,151,58,0,58,116,64,53,11,128,4,2,24,89,369,140,229,857,282,3,49,1,35,664,1664,5,72,22,83,0,182,630,4312,6919
TAMIL NADU,VIRUDHUNAGAR,2007,51,53,0,104,8,0,8,16,44,38,6,88,1,0,18,78,371,37,334,839,71,46,96,2,28,376,867,3,39,91,48,0,181,248,2351,4023
TRIPURA,DHALAI,2007,18,3,1,22,13,0,13,26,27,11,16,54,1,0,8,20,29,1,28,87,18,5,6,0,2,44,97,4,19,0,28,0,51,22,90,358
TRIPURA,NORTH,2007,21,6,0,27,26,0,26,52,21,16,5,42,1,0,6,35,72,3,69,186,21,9,14,6,7,113,206,0,27,1,100,0,128,36,184,706
TRIPURA,SOUTH,2007,34,35,0,69,41,0,41,82,21,18,3,42,0,0,27,53,125,19,106,330,33,5,37,1,5,138,265,10,106,0,172,0,288,46,378,1267
TRIPURA,WEST,2007,65,14,1,80,77,0,77,154,44,36,8,88,12,2,23,85,185,32,153,492,70,23,28,3,9,251,483,22,92,3,245,0,362,99,589,1942
UTTAR PRADESH,AGRA,2007,123,141,55,319,30,0,30,60,209,149,60,418,11,0,57,213,1483,1039,444,3247,218,151,324,16,4,409,1531,78,82,107,380,0,647,409,1635,6135
UTTAR PRADESH,ALIGARH,2007,166,154,33,353,50,0,50,100,147,96,51,294,3,16,67,105,680,326,354,1551,164,82,197,12,20,324,1098,70,74,37,237,0,418,299,814,3751
UTTAR PRADESH,ALLAHABAD,2007,143,85,43,271,26,0,26,52,100,81,19,200,3,1,47,217,606,278,328,1480,106,75,209,3,6,357,1013,63,40,48,207,0,358,257,1775,4417
UTTAR PRADESH,AMBEDKAR NAGAR,2007,26,20,12,58,15,0,15,30,33,24,9,66,1,0,19,39,126,17,109,311,26,18,53,1,0,169,314,8,10,17,139,0,174,47,248,1027
UTTAR PRADESH,AURAIYA,2007,37,34,7,78,9,0,9,18,34,26,8,68,5,0,22,29,81,36,45,218,47,10,30,2,8,142,360,34,17,10,29,0,90,121,361,1069
UTTAR PRADESH,AZAMGARH,2007,54,23,31,108,11,0,11,22,34,29,5,68,4,1,22,53,119,66,53,318,29,20,46,6,0,201,302,29,15,26,55,0,125,0,529,1308
UTTAR PRADESH,BADAUN,2007,88,110,58,256,11,0,11,22,53,40,13,106,4,0,17,26,158,28,130,363,15,15,41,3,14,176,288,31,29,18,25,0,103,24,915,1831
UTTAR PRADESH,BAGHPAT,2007,81,57,8,146,17,0,17,34,35,27,8,70,3,0,26,26,157,72,85,369,40,12,46,3,2,131,393,22,10,22,60,0,114,159,197,1114
UTTAR PRADESH,BAHRAICH,2007,43,30,29,102,34,0,34,68,53,44,9,106,7,11,26,54,130,36,94,358,31,38,70,1,6,151,384,28,20,25,37,0,110,87,402,1313
UTTAR PRADESH,BALLIA,2007,32,31,14,77,10,0,10,20,26,18,8,52,1,2,6,49,105,52,53,268,38,20,44,1,1,99,230,13,10,10,11,0,44,27,266,816
UTTAR PRADESH,BALRAMPUR,2007,20,13,8,41,10,0,10,20,17,17,0,34,4,0,2,25,58,19,39,147,13,9,25,3,1,41,99,10,12,4,38,0,64,7,185,505
UTTAR PRADESH,BANDA,2007,49,22,12,83,15,0,15,30,18,12,6,36,0,0,10,50,79,17,62,218,28,22,42,2,11,81,190,16,49,14,14,0,93,4,440,978
UTTAR PRADESH,BARABANKI,2007,62,44,13,119,25,0,25,50,70,63,7,140,13,0,24,75,161,52,109,434,39,81,35,0,0,205,501,35,28,34,106,0,203,141,740,1931
UTTAR PRADESH,BAREILLY,2007,138,171,37,346,62,0,62,124,126,95,31,252,5,0,62,104,514,193,321,1199,97,100,232,11,0,194,654,54,97,99,235,0,485,20,2476,4834
UTTAR PRADESH,BASTI,2007,24,20,19,63,10,0,10,20,22,22,0,44,0,0,11,29,97,32,65,234,34,36,97,5,0,142,388,13,8,39,51,0,111,74,399,1130
UTTAR PRADESH,BIJNOR,2007,99,51,25,175,27,0,27,54,68,48,20,136,7,0,35,36,178,75,103,434,70,43,152,2,0,340,749,26,33,75,188,0,322,142,473,2070
UTTAR PRADESH,BULANDSHAHAR,2007,146,160,24,330,44,0,44,88,120,93,27,240,1,0,33,63,400,156,244,897,105,69,209,3,2,417,968,36,75,120,227,0,458,163,1588,4005
UTTAR PRADESH,CHANDOLI,2007,17,20,6,43,6,0,6,12,12,12,0,24,2,0,5,43,51,19,32,152,7,30,89,2,1,137,279,22,8,34,63,0,127,13,387,955
UTTAR PRADESH,CHITRAKOOT DHAM,2007,23,14,10,47,23,0,23,46,8,2,6,16,3,0,1,27,39,8,31,109,5,17,14,0,0,9,77,7,14,1,13,0,35,32,180,440
UTTAR PRADESH,DEORIA,2007,31,17,26,74,2,0,2,4,21,17,4,42,1,0,5,40,83,42,41,212,40,11,43,2,0,111,229,25,8,3,25,0,61,22,485,1001
UTTAR PRADESH,ETAH,2007,141,194,28,363,39,0,39,78,107,66,41,214,1,0,27,81,297,122,175,703,116,38,118,3,17,228,735,56,48,22,77,0,203,215,870,2723
UTTAR PRADESH,ETAWAH,2007,66,69,7,142,14,0,14,28,84,54,30,168,2,0,32,52,220,106,114,526,16,44,73,2,5,153,475,28,31,37,115,0,211,182,976,2208
UTTAR PRADESH,FAIZABAD,2007,52,29,18,99,23,0,23,46,46,32,14,92,4,0,12,67,218,78,140,519,33,34,74,2,0,171,469,17,23,37,54,0,131,155,394,1463
UTTAR PRADESH,FATEHGARH,2007,64,90,11,165,21,0,21,42,71,41,30,142,3,1,27,38,103,40,63,275,32,23,47,2,1,65,191,24,32,16,79,0,151,21,617,1388
UTTAR PRADESH,FATEHPUR,2007,66,30,22,118,22,0,22,44,45,38,7,90,6,0,18,44,80,28,52,228,13,30,74,3,1,157,433,33,29,21,61,0,144,155,509,1419
UTTAR PRADESH,FIROZABAD,2007,123,143,15,281,28,0,28,56,109,69,40,218,30,3,74,85,318,161,157,828,152,65,80,0,7,233,541,56,58,51,155,0,320,4,863,2652
UTTAR PRADESH,G.R.P.,2007,20,20,4,44,2,0,2,4,8,3,5,16,11,1,27,0,1279,63,1216,2597,23,28,31,0,0,16,98,2,12,23,0,0,37,0,646,2153
UTTAR PRADESH,GAUTAMBUDH NAGAR,2007,75,71,16,162,17,0,17,34,83,64,19,166,3,1,47,138,1349,825,524,2887,83,75,230,4,0,17,425,14,41,51,73,0,179,16,873,3277
UTTAR PRADESH,GHAZIABAD,2007,150,135,46,331,33,0,33,66,158,108,50,316,4,2,45,117,1031,628,403,2230,69,181,333,12,7,60,977,37,30,85,204,0,356,315,1266,4320
UTTAR PRADESH,GHAZIPUR,2007,40,39,18,97,10,0,10,20,14,10,4,28,7,0,23,45,106,43,63,287,120,23,55,11,6,151,368,22,11,23,68,0,124,2,308,1102
UTTAR PRADESH,GONDA,2007,46,46,22,114,13,0,13,26,47,33,14,94,7,0,23,73,156,73,83,415,37,26,79,0,3,7,184,35,18,9,10,0,72,32,544,1233
UTTAR PRADESH,GORAKHPUR,2007,75,58,37,170,19,0,19,38,58,51,7,116,0,0,15,90,348,214,134,801,78,58,88,6,1,255,741,23,22,76,83,0,204,255,431,2076
UTTAR PRADESH,HAMIRPUR,2007,22,7,21,50,8,0,8,16,12,7,5,24,0,0,1,9,13,3,10,36,3,12,23,0,0,25,112,9,16,5,5,0,35,49,195,435
UTTAR PRADESH,HARDOI,2007,86,54,22,162,33,0,33,66,47,38,9,94,1,0,17,35,163,34,129,379,22,49,70,0,3,262,577,42,45,26,57,0,170,171,601,1806
UTTAR PRADESH,HATHRAS,2007,56,54,18,128,16,0,16,32,71,50,21,142,32,1,57,51,197,74,123,535,88,53,89,0,0,145,479,17,48,26,179,0,270,104,577,1879
UTTAR PRADESH,J.P.NAGAR,2007,66,50,13,129,28,0,28,56,34,34,0,68,0,2,16,39,167,73,94,391,95,19,91,6,0,25,385,12,34,34,85,0,165,149,279,1244
UTTAR PRADESH,JALAUN,2007,48,17,9,74,8,0,8,16,27,19,8,54,5,0,13,24,82,39,43,206,14,21,45,1,5,3,170,32,42,37,43,0,154,81,607,1164
UTTAR PRADESH,JAUNPUR,2007,44,62,26,132,24,0,24,48,47,33,14,94,6,0,41,62,169,58,111,447,84,41,151,2,3,360,683,47,28,44,71,0,190,42,844,2198
UTTAR PRADESH,JHANSI,2007,66,30,22,118,10,0,10,20,25,13,12,50,0,1,23,41,178,94,84,421,14,21,78,1,7,44,189,28,38,55,20,0,141,24,457,1183
UTTAR PRADESH,KANNAUJ,2007,54,40,20,114,6,0,6,12,32,26,6,64,1,0,16,17,78,26,52,190,17,19,44,2,4,26,240,13,32,9,108,0,162,128,418,1084
UTTAR PRADESH,KANPUR DEHAT,2007,41,43,18,102,13,0,13,26,62,52,10,124,4,0,15,36,114,19,95,283,103,41,89,4,2,267,645,37,51,17,114,0,219,139,610,1820
UTTAR PRADESH,KANPUR NAGAR,2007,148,132,46,326,46,0,46,92,291,222,69,582,42,5,114,264,1204,839,365,2833,273,252,582,32,18,548,1812,59,102,165,673,0,999,107,2905,8008
UTTAR PRADESH,KAUSHAMBI,2007,51,23,23,97,30,0,30,60,48,36,12,96,3,0,26,62,69,6,63,229,35,15,33,5,2,103,255,35,27,16,72,0,150,62,416,1156
UTTAR PRADESH,KHIRI,2007,93,66,48,207,47,0,47,94,75,72,3,150,6,2,21,67,276,93,183,648,42,25,104,1,4,293,519,57,48,25,67,0,197,50,891,2308
UTTAR PRADESH,KUSHI NAGAR,2007,20,20,29,69,9,0,9,18,29,25,4,58,0,0,7,34,72,19,53,185,51,35,69,4,3,145,450,18,17,60,40,0,135,143,322,1127
UTTAR PRADESH,LALITPUR,2007,22,4,13,39,10,0,10,20,13,9,4,26,4,0,2,23,44,11,33,117,29,7,13,1,0,165,254,14,16,29,28,0,87,39,107,583
UTTAR PRADESH,LUCKNOW,2007,159,118,55,332,82,0,82,164,260,216,44,520,32,6,221,613,2642,1558,1084,6156,299,357,779,21,3,58,1995,57,98,159,513,0,827,478,3007,10017
UTTAR PRADESH,MAHARAJGANJ,2007,25,11,14,50,23,0,23,46,25,23,2,50,2,0,11,27,52,19,33,144,33,24,81,5,0,79,300,18,18,23,74,0,133,78,488,1111
UTTAR PRADESH,MAHOBA,2007,30,13,20,63,10,0,10,20,11,11,0,22,0,0,8,18,55,30,25,136,12,10,17,3,4,23,89,12,21,14,13,0,60,20,182,496
UTTAR PRADESH,MAINPURI,2007,108,137,24,269,11,0,11,22,72,46,26,144,58,0,65,54,251,119,132,679,72,70,101,5,1,186,450,48,32,22,54,0,156,15,846,2232
UTTAR PRADESH,MATHURA,2007,83,115,14,212,36,0,36,72,74,45,29,148,9,1,44,87,610,377,233,1361,141,119,370,7,11,181,1102,26,62,50,250,0,388,273,1402,3965
UTTAR PRADESH,MAU,2007,32,38,12,82,8,0,8,16,37,26,11,74,0,0,14,62,93,27,66,262,78,11,72,4,11,85,328,14,21,32,35,0,102,67,185,911
UTTAR PRADESH,MEERUT,2007,195,189,21,405,39,0,39,78,150,109,41,300,7,1,86,167,854,414,440,1969,148,116,330,24,6,153,1006,38,63,163,405,0,669,229,1026,4410
UTTAR PRADESH,MIRZAPUR,2007,40,17,16,73,10,0,10,20,8,4,4,16,0,0,9,38,98,39,59,243,7,19,52,1,0,92,214,28,13,11,43,0,95,43,250,795
UTTAR PRADESH,MORADABAD,2007,130,138,59,327,58,0,58,116,129,97,32,258,4,0,44,112,597,246,351,1354,95,49,206,8,2,80,572,34,83,115,212,0,444,132,2017,4304
UTTAR PRADESH,MUZAFFARNAGAR,2007,213,170,26,409,37,0,37,74,154,100,54,308,12,2,75,89,532,230,302,1242,142,69,191,16,0,12,553,34,56,72,277,0,439,123,1418,3720
UTTAR PRADESH,PILIBHIT,2007,38,20,17,75,23,0,23,46,47,31,16,94,0,0,4,18,83,31,52,188,10,61,120,4,1,1,260,18,38,18,38,0,112,63,1029,1651
UTTAR PRADESH,PRATAPGARH,2007,58,44,21,123,16,0,16,32,53,43,10,106,3,0,19,84,180,66,114,466,91,29,59,4,17,200,490,27,32,20,107,0,186,90,530,1684
UTTAR PRADESH,RAIBAREILLY,2007,57,46,26,129,31,0,31,62,47,39,8,94,5,0,14,63,175,45,130,432,55,56,97,3,0,212,563,31,53,38,142,0,264,140,535,1826
UTTAR PRADESH,RAMPUR,2007,57,71,19,147,40,0,40,80,61,54,7,122,5,1,47,37,274,58,216,638,52,68,169,7,4,9,414,18,50,13,10,0,91,105,1021,2138
UTTAR PRADESH,SAHARANPUR,2007,81,105,24,210,14,0,14,28,41,34,7,82,1,19,22,64,389,171,218,884,80,56,227,12,0,32,539,16,36,77,194,0,323,132,1338,2960
UTTAR PRADESH,SANT KABIRNAGAR,2007,21,10,8,39,9,0,9,18,20,20,0,40,0,0,12,15,36,14,22,99,16,15,28,2,2,81,191,7,13,16,34,0,70,47,111,503
UTTAR PRADESH,SHAHJAHANPUR,2007,126,125,35,286,52,0,52,104,102,69,33,204,19,0,48,84,244,87,157,639,59,60,129,0,11,189,646,56,84,43,13,0,196,198,1014,2691
UTTAR PRADESH,SHRAWASTI,2007,19,11,9,39,10,0,10,20,18,9,9,36,2,1,5,29,55,6,49,147,11,12,16,1,0,59,126,4,12,5,24,0,45,27,63,393
UTTAR PRADESH,SIDHARTHNAGAR,2007,12,4,11,27,5,0,5,10,25,24,1,50,0,0,7,38,78,32,46,201,13,20,61,3,0,49,205,9,13,33,45,0,100,59,286,771
UTTAR PRADESH,SITAPUR,2007,112,81,39,232,67,0,67,134,102,84,18,204,7,1,43,87,466,61,405,1070,57,100,92,2,15,273,644,61,69,20,119,0,269,105,963,2881
UTTAR PRADESH,SONBHADRA,2007,35,16,14,65,16,0,16,32,12,8,4,24,1,0,8,27,66,28,38,168,13,17,50,1,3,129,318,11,21,35,23,0,90,105,141,744
UTTAR PRADESH,ST.RAVIDASNAGAR,2007,13,19,8,40,1,0,1,2,13,5,8,26,1,0,14,21,70,32,38,176,12,16,24,2,0,59,167,14,9,2,29,0,54,54,97,478
UTTAR PRADESH,SULTANPUR,2007,59,61,24,144,34,0,34,68,50,47,3,100,1,0,37,103,198,92,106,537,41,41,59,3,0,268,580,21,30,13,57,0,121,168,326,1594
UTTAR PRADESH,UNNAO,2007,94,61,37,192,30,0,30,60,68,61,7,136,6,0,32,41,165,58,107,409,45,36,51,3,0,155,427,52,37,26,61,0,176,137,423,1560
UTTAR PRADESH,VARANASI,2007,66,61,21,148,20,0,20,40,50,38,12,100,2,0,44,182,917,687,230,2062,119,114,257,14,2,269,854,35,20,120,197,0,372,79,1195,3784
UTTARAKHAND,ALMORA,2007,19,9,2,30,6,0,6,12,0,0,0,0,2,0,10,35,42,2,40,131,11,1,6,3,4,25,64,5,4,0,11,0,20,14,90,299
UTTARAKHAND,BAGESHWAR,2007,10,1,0,11,3,0,3,6,0,0,0,0,0,0,2,8,8,0,8,26,5,1,5,0,0,3,23,2,6,2,4,0,14,9,40,109
UTTARAKHAND,CHAMOLI,2007,15,9,0,24,10,0,10,20,7,6,1,14,0,0,1,28,26,1,25,81,19,8,8,0,3,21,84,2,5,0,5,0,12,25,29,221
UTTARAKHAND,CHAMPAWAT,2007,5,0,2,7,2,0,2,4,2,2,0,4,0,0,3,7,13,1,12,36,3,0,2,2,2,13,31,0,1,0,2,0,3,9,16,84
UTTARAKHAND,DEHRADUN,2007,37,50,6,93,29,0,29,58,60,58,2,120,7,2,25,148,396,134,262,974,98,47,237,17,2,250,786,3,45,23,126,0,197,135,462,2205
UTTARAKHAND,HARIDWAR,2007,55,59,13,127,28,0,28,56,72,59,13,144,19,3,70,102,472,210,262,1138,99,43,259,6,9,352,966,16,31,31,170,0,248,198,427,2534
UTTARAKHAND,NAINITAL,2007,26,19,6,51,6,0,6,12,25,24,1,50,7,0,13,38,176,60,116,410,28,7,34,5,0,39,215,12,4,0,17,0,33,102,319,883
UTTARAKHAND,PAURI GARHWAL,2007,19,7,1,27,7,0,7,14,11,11,0,22,0,0,3,27,49,10,39,128,12,9,10,0,4,75,149,7,4,4,24,0,39,39,107,419
UTTARAKHAND,PITHORAGARH,2007,9,2,4,15,9,0,9,18,9,9,0,18,1,0,8,33,33,2,31,108,11,3,7,1,4,40,66,3,11,0,11,0,25,0,142,341
UTTARAKHAND,RUDRA PRAYAG,2007,6,6,2,14,1,0,1,2,5,5,0,10,0,0,3,17,20,0,20,60,8,1,6,0,0,9,36,5,6,0,6,0,17,12,21,134
UTTARAKHAND,TEHRI GARHWAL,2007,11,7,5,23,2,0,2,4,4,4,0,8,0,0,9,14,37,3,34,97,18,5,17,1,1,12,78,3,2,2,7,0,14,24,67,248
UTTARAKHAND,UDHAMSINGH NAGAR,2007,54,56,8,118,12,0,12,24,49,41,8,98,10,1,23,74,292,141,151,692,133,36,99,4,0,42,355,9,21,0,67,0,97,41,872,1903
UTTARAKHAND,UTTARKASHI,2007,2,3,1,6,2,0,2,4,9,8,1,18,0,0,3,17,29,1,28,78,14,2,7,0,8,5,36,3,6,1,13,0,23,0,94,219
WEST BENGAL,24 PARGANAS NORTH,2007,194,6,46,246,231,0,231,462,236,236,0,472,13,238,18,14,1183,269,914,2649,545,5,210,3,10,281,1167,53,187,2,1696,0,1938,113,3917,9201
WEST BENGAL,24 PARGANAS SOUTH,2007,158,123,48,329,205,0,205,410,241,176,65,482,14,323,39,20,1440,322,1118,3276,325,94,123,11,7,218,782,67,205,4,1398,2,1676,4,3787,8856
WEST BENGAL,ASANSOL,2007,26,2,8,36,15,0,15,30,18,10,8,36,3,63,9,1,145,45,100,366,18,1,57,1,1,109,248,11,20,1,242,0,274,61,679,1491
WEST BENGAL,BANKURA,2007,49,32,6,87,44,0,44,88,14,12,2,28,5,21,20,7,157,16,141,367,87,19,21,5,7,166,427,24,43,1,147,0,215,122,332,1329
WEST BENGAL,BIRBHUM,2007,66,15,21,102,53,0,53,106,31,26,5,62,10,31,14,13,263,49,214,594,199,10,34,4,14,203,640,9,44,0,195,0,248,176,463,1868
WEST BENGAL,BURDWAN,2007,122,14,30,166,69,0,69,138,54,51,3,108,13,24,28,18,517,185,332,1117,212,4,103,7,4,179,1401,31,135,1,489,0,656,892,1438,4384
WEST BENGAL,COOCHBEHAR,2007,34,10,7,51,139,0,139,278,68,60,8,136,1,2,8,15,160,33,127,346,50,13,25,5,1,105,281,6,122,0,320,0,448,82,878,2051
WEST BENGAL,DAKSHIN DINAJPUR,2007,34,78,7,119,46,0,46,92,47,34,13,94,0,6,4,5,92,14,78,199,30,11,10,3,3,89,226,10,93,2,199,0,304,80,435,1284
WEST BENGAL,DARJEELING,2007,31,2,19,52,48,0,48,96,36,34,2,72,5,32,7,10,473,90,383,1000,28,22,16,6,4,638,837,2,37,2,84,0,125,123,248,1873
WEST BENGAL,HOOGHLY,2007,90,97,32,219,57,0,57,114,46,45,1,92,12,73,24,39,631,122,509,1410,281,38,21,1,11,305,861,16,48,0,549,0,613,204,1057,3632
WEST BENGAL,HOWRAH,2007,69,16,10,95,45,0,45,90,83,70,13,166,4,61,17,8,635,157,478,1360,180,23,152,1,7,463,1127,33,87,6,422,0,548,301,1450,4073
WEST BENGAL,HOWRAH G.R.P.,2007,9,4,1,14,1,0,1,2,3,2,1,6,0,8,5,0,401,0,401,815,3,0,4,0,1,7,15,0,4,0,0,0,4,0,42,493
WEST BENGAL,JALPAIGURI,2007,122,56,40,218,235,0,235,470,202,170,32,404,5,10,35,55,1538,95,1443,3181,69,86,46,6,5,490,909,14,211,1,632,0,858,207,2589,6654
WEST BENGAL,KHARAGPUR G.R.P.,2007,3,0,0,3,0,0,0,0,2,2,0,4,1,2,0,0,127,0,127,257,2,0,0,0,0,0,8,0,2,0,0,0,2,6,25,170
WEST BENGAL,KOLKATA,2007,36,71,12,119,44,0,44,88,114,88,26,228,2,63,74,114,2924,621,2303,6101,220,222,1126,14,0,1241,3282,8,189,58,296,3,554,459,3611,10901
WEST BENGAL,MALDA,2007,88,63,23,174,103,0,103,206,73,67,6,146,4,19,15,12,273,103,170,596,35,6,24,17,0,306,390,11,103,13,266,0,393,2,719,2175
WEST BENGAL,MURSHIDABAD,2007,132,61,30,223,369,0,369,738,140,123,17,280,10,52,17,10,655,103,552,1399,212,7,91,20,11,720,1307,32,250,6,945,0,1233,246,1227,5243
WEST BENGAL,NADIA,2007,99,69,9,177,183,0,183,366,175,175,0,350,18,44,14,7,863,51,812,1809,193,0,214,8,9,988,1629,42,249,0,861,0,1152,217,1361,5623
WEST BENGAL,PASCHIM MIDNAPUR,2007,105,39,14,158,60,0,60,120,61,61,0,122,10,44,31,19,328,44,284,760,204,46,53,4,9,131,451,31,83,1,407,0,522,4,1249,2933
WEST BENGAL,PURAB MIDNAPUR,2007,76,41,12,129,41,0,41,82,75,75,0,150,8,0,10,19,242,37,205,521,741,43,29,2,3,12,1150,24,36,1,373,0,434,320,991,3099
WEST BENGAL,PURULIA,2007,46,0,6,52,38,0,38,76,14,14,0,28,0,14,12,3,184,9,175,397,58,4,24,0,1,1,88,14,70,0,196,0,280,0,700,1385
WEST BENGAL,SEALDAH G.R.P.,2007,6,7,0,13,3,0,3,6,4,4,0,8,5,6,5,0,164,0,164,344,8,2,7,1,0,19,37,1,4,0,0,0,5,0,27,269
WEST BENGAL,SILIGURI G.R.P.,2007,4,1,0,5,1,0,1,2,1,0,1,2,2,0,0,0,57,0,57,116,2,1,0,0,0,0,3,0,1,0,0,0,1,0,26,96
WEST BENGAL,UTTAR DINAJPUR,2007,53,70,13,136,76,0,76,152,62,55,7,124,1,14,21,10,295,56,239,636,25,15,16,8,13,238,499,12,58,0,183,0,253,184,652,2019
A & N ISLANDS,A and N ISLANDS,2007,15,19,1,35,3,0,3,6,12,9,3,24,5,0,9,90,112,8,104,328,17,7,23,1,11,99,162,1,21,2,18,0,42,4,337,807
CHANDIGARH,CHANDIGARH,2007,19,26,8,53,22,0,22,44,52,46,6,104,2,0,37,191,1740,853,887,3710,79,38,170,2,9,78,391,1,32,11,112,0,156,15,999,3643
D & N HAVELI,D and N HAVELI,2007,10,2,0,12,7,0,7,14,9,6,3,18,1,0,3,28,87,19,68,206,39,17,10,1,10,25,114,0,0,0,3,0,3,12,161,425
DAMAN & DIU,DAMAN,2007,12,6,0,18,1,0,1,2,0,0,0,0,3,1,1,41,37,26,11,120,26,5,6,0,2,14,82,1,0,0,1,0,2,29,24,210
DAMAN & DIU,DIU,2007,0,1,0,1,0,0,0,0,1,1,0,2,0,0,1,5,6,2,4,18,5,0,0,6,1,6,21,0,0,0,2,0,2,3,13,50
DELHI UT,CENTRAL,2007,27,29,6,62,22,0,22,44,70,45,25,140,1,7,28,63,1069,538,531,2237,4,41,149,1,1,136,340,6,38,9,91,0,144,8,1442,3248
DELHI UT,EAST,2007,34,61,8,103,73,0,73,146,145,102,43,290,7,27,102,196,2239,1183,1056,4810,17,35,201,4,3,218,496,16,112,24,202,0,354,18,2274,6016
DELHI UT,GRP(RLY),2007,3,0,0,3,4,0,4,8,12,8,4,24,0,8,2,1,795,40,755,1601,0,1,13,2,0,10,28,0,4,1,0,0,5,2,68,926
DELHI UT,IGI AIRPORT,2007,1,0,0,1,0,0,0,0,3,0,3,6,0,0,6,1,144,26,118,295,1,4,411,1,0,0,417,0,8,3,1,0,12,0,78,662
DELHI UT,NEW DELHI,2007,4,7,1,12,7,0,7,14,12,9,3,24,1,0,23,53,698,215,483,1473,7,29,284,7,3,28,359,0,23,10,14,0,47,1,983,2195
DELHI UT,NORTH,2007,22,41,9,72,33,0,33,66,64,41,23,128,5,11,33,84,747,300,447,1627,7,51,182,3,3,133,385,6,43,30,89,0,168,6,1750,3352
DELHI UT,NORTH-EAST,2007,66,74,9,149,89,0,89,178,241,200,41,482,2,11,55,206,1287,732,555,2848,2,32,91,5,0,247,425,17,120,13,249,0,399,48,2257,5121
DELHI UT,NORTH-WEST,2007,57,52,11,120,51,0,51,102,208,120,88,416,4,22,63,272,1841,1206,635,4043,6,31,199,2,1,141,390,7,64,3,151,0,225,10,1993,5189
DELHI UT,OUTER,2007,102,96,17,215,121,0,121,242,360,237,123,720,4,13,85,231,1216,700,516,2765,12,20,98,0,4,226,406,29,100,12,208,0,349,46,2690,5690
DELHI UT,SOUTH,2007,68,84,11,163,83,0,83,166,256,177,79,512,2,110,75,412,3179,1742,1437,6957,19,102,348,6,5,193,740,22,169,36,275,0,502,67,4892,10414
DELHI UT,SOUTH-WEST,2007,51,43,8,102,51,0,51,102,148,111,37,296,7,8,47,304,1802,960,842,3970,9,41,154,2,8,147,379,19,85,14,222,0,340,18,3633,6821
DELHI UT,STF,2007,0,6,0,6,0,0,0,0,0,0,0,0,1,1,0,0,0,0,0,2,0,0,7,5,1,0,13,0,0,0,0,0,0,0,19,40
DELHI UT,WEST,2007,60,37,14,111,64,0,64,128,169,117,52,338,0,11,38,232,2020,1232,788,4321,3,64,199,3,2,257,556,16,102,12,285,0,415,28,2775,6391
LAKSHADWEEP,LAKSHADWEEP,2007,0,2,0,2,1,0,1,2,0,0,0,0,0,0,0,2,20,2,18,42,1,0,0,0,0,0,1,0,2,0,2,0,4,0,26,56
PUDUCHERRY,KARAIKAL,2007,4,9,0,13,3,0,3,6,5,4,1,10,0,0,0,15,87,39,48,189,29,1,6,0,7,179,267,0,33,6,1,0,40,45,336,766
PUDUCHERRY,PONDICHERRY,2007,30,33,2,65,6,0,6,12,15,10,5,30,1,2,8,71,700,459,241,1482,116,5,39,1,11,725,1119,2,56,26,16,0,100,222,2201,4288
ANDHRA PRADESH,ADILABAD,2008,73,82,14,169,50,0,50,100,41,26,15,82,3,0,20,248,427,56,371,1125,100,17,135,1,45,1289,1923,5,174,103,355,0,637,336,1782,5300
ANDHRA PRADESH,ANANTAPUR,2008,154,80,4,238,37,0,37,74,90,36,54,180,10,0,20,222,496,187,309,1244,51,24,108,15,0,1050,1582,12,133,132,0,0,277,334,2762,5734
ANDHRA PRADESH,CHITTOOR,2008,123,65,7,195,30,0,30,60,84,57,27,168,6,0,20,260,1321,420,901,2928,64,29,295,20,33,1017,2188,26,104,250,288,0,668,730,2535,7307
ANDHRA PRADESH,CUDDAPAH,2008,114,94,5,213,27,0,27,54,76,64,12,152,2,0,12,149,537,151,386,1237,143,28,248,3,11,1149,2078,11,212,37,267,0,527,496,2984,6605
ANDHRA PRADESH,CYBERABAD,2008,197,66,3,266,80,0,80,160,141,101,40,282,7,0,81,1319,3081,1202,1879,7569,74,103,1183,6,42,3321,5895,59,130,833,884,0,1906,1166,1397,14173
ANDHRA PRADESH,EAST GODAVARI,2008,82,112,1,195,48,0,48,96,91,13,78,182,0,0,19,425,1189,256,933,2822,48,109,328,36,47,3172,4382,23,194,131,563,0,911,642,1175,8435
ANDHRA PRADESH,GUNTAKAL RLY.,2008,7,0,0,7,0,0,0,0,0,0,0,0,0,0,1,0,122,0,122,245,0,1,4,7,0,7,21,0,3,1,2,0,6,2,14,171
ANDHRA PRADESH,GUNTUR,2008,159,196,3,358,48,0,48,96,83,65,18,166,4,4,25,336,1233,392,841,2835,64,40,393,21,74,1615,2828,26,306,99,496,0,927,621,3065,8911
ANDHRA PRADESH,HYDERABAD CITY,2008,122,126,5,253,62,0,62,124,140,77,63,280,10,0,115,1143,5200,2106,3094,11668,143,143,1875,42,44,4244,6973,41,231,148,1184,0,1604,482,3067,18567
ANDHRA PRADESH,KARIMNAGAR,2008,134,114,12,260,84,0,84,168,159,148,11,318,1,1,15,294,697,158,539,1705,153,36,525,5,56,2937,4231,48,310,273,596,0,1227,519,1368,8337
ANDHRA PRADESH,KHAMMAM,2008,123,47,5,175,70,0,70,140,103,83,20,206,3,5,9,251,560,186,374,1388,97,23,150,8,28,1089,1887,26,213,24,329,0,592,492,2179,5834
ANDHRA PRADESH,KRISHNA,2008,53,63,4,120,38,0,38,76,69,52,17,138,0,0,11,166,587,121,466,1351,13,9,114,13,38,2434,3024,12,254,93,379,0,738,403,775,5528
ANDHRA PRADESH,KURNOOL,2008,116,143,5,264,47,0,47,94,89,72,17,178,14,0,28,252,530,160,370,1354,158,22,282,9,9,2972,4003,17,419,232,227,0,895,551,1713,7835
ANDHRA PRADESH,MAHABOOBNAGAR,2008,188,66,30,284,72,0,72,144,104,87,17,208,9,0,36,256,923,8,915,2147,65,16,173,9,56,2306,3321,35,162,38,231,0,466,696,1190,6661
ANDHRA PRADESH,MEDAK,2008,140,57,10,207,50,0,50,100,62,44,18,124,7,0,20,297,641,145,496,1606,57,24,241,9,37,2190,3230,35,114,61,332,0,542,672,933,5989
ANDHRA PRADESH,NALGONDA,2008,121,76,3,200,90,0,90,180,91,76,15,182,7,0,31,279,551,132,419,1419,135,24,218,7,77,1762,2951,32,243,155,353,0,783,728,3043,8026
ANDHRA PRADESH,NELLORE,2008,70,73,6,149,39,0,39,78,83,73,10,166,4,1,23,266,735,249,486,1764,43,79,121,19,52,2408,3136,6,184,130,333,0,653,414,1029,6118
ANDHRA PRADESH,NIZAMABAD,2008,153,61,17,231,31,0,31,62,51,25,26,102,7,0,31,338,686,96,590,1748,67,28,241,6,47,1969,2778,16,70,85,305,0,476,420,1080,5709
ANDHRA PRADESH,PRAKASHAM,2008,75,59,4,138,30,0,30,60,66,53,13,132,5,0,12,173,413,124,289,1016,28,35,216,10,124,1222,2080,5,192,38,229,0,464,445,2072,5453
ANDHRA PRADESH,RANGA REDDY,2008,91,35,8,134,37,0,37,74,23,13,10,46,2,0,8,142,184,28,156,520,19,15,65,2,30,855,1176,19,39,25,120,0,203,190,510,2419
ANDHRA PRADESH,SECUNDERABAD RLY.,2008,10,0,0,10,2,0,2,4,0,0,0,0,0,0,2,0,371,0,371,744,0,0,4,6,0,17,30,0,1,0,0,0,1,3,60,476
ANDHRA PRADESH,SRIKAKULAM,2008,25,0,2,27,32,0,32,64,18,14,4,36,2,0,4,147,219,21,198,591,8,8,59,12,26,1632,2014,6,92,72,314,0,484,269,961,3908
ANDHRA PRADESH,VIJAYAWADA CITY,2008,34,58,1,93,30,0,30,60,49,36,13,98,1,0,24,189,1176,321,855,2566,8,52,326,13,23,1482,2195,9,104,252,395,0,760,291,610,5127
ANDHRA PRADESH,VIJAYAWADA RLY.,2008,1,1,0,2,0,0,0,0,1,0,1,2,0,0,3,1,306,0,306,616,1,0,3,28,0,12,45,0,1,1,0,0,2,1,57,417
ANDHRA PRADESH,VISAKHA RURAL,2008,65,40,4,109,12,0,12,24,12,9,3,24,0,0,3,103,153,4,149,412,159,5,61,5,20,1509,2124,10,79,40,168,0,297,365,294,3107
ANDHRA PRADESH,VISAKHAPATNAM,2008,32,36,1,69,29,0,29,58,34,26,8,68,3,0,28,263,1045,343,702,2384,14,31,267,21,10,412,1068,13,87,2,488,0,590,313,1886,5015
ANDHRA PRADESH,VIZIANAGARAM,2008,29,21,3,53,6,0,6,12,16,14,2,32,0,0,1,147,206,0,206,560,12,6,99,12,21,478,898,3,88,60,253,0,404,270,1411,3142
ANDHRA PRADESH,WARANGAL,2008,121,73,5,199,59,0,59,118,82,62,20,164,1,0,3,263,455,140,315,1177,173,15,304,14,44,1562,2624,36,223,54,519,0,832,512,2240,6758
ANDHRA PRADESH,WEST GODAVARI,2008,78,98,3,179,117,0,117,234,112,70,42,224,2,0,18,403,1318,291,1027,3059,33,68,355,20,27,2055,3056,25,368,182,696,0,1271,498,1737,8213
ARUNACHAL PRADESH,CHANGLANG,2008,6,4,0,10,2,0,2,4,4,4,0,8,0,0,7,19,49,0,49,124,0,3,1,0,3,39,49,0,5,0,0,0,5,3,54,199
ARUNACHAL PRADESH,DIBANG VALLEY,2008,1,2,0,3,3,0,3,6,6,4,2,12,1,0,1,10,36,2,34,84,0,3,2,0,2,28,37,0,9,0,2,0,11,2,25,133
ARUNACHAL PRADESH,K/KUMEY,2008,3,4,0,7,2,0,2,4,3,2,1,6,0,0,1,5,4,0,4,14,2,1,1,0,0,21,29,0,2,0,1,0,3,4,43,97
ARUNACHAL PRADESH,KAMENG EAST,2008,4,0,0,4,5,0,5,10,6,4,2,12,2,0,4,15,13,0,13,47,1,2,0,0,0,49,61,0,0,0,0,0,0,9,34,144
ARUNACHAL PRADESH,KAMENG WEST,2008,1,0,0,1,0,0,0,0,3,2,1,6,3,0,0,8,20,2,18,51,2,3,1,1,0,18,45,0,4,0,0,0,4,20,13,97
ARUNACHAL PRADESH,LOHIT,2008,11,1,0,12,3,0,3,6,1,1,0,2,0,0,6,13,43,0,43,105,1,0,0,0,0,19,30,0,1,0,0,0,1,10,50,159
ARUNACHAL PRADESH,PAPUM PARE,2008,11,6,1,18,7,0,7,14,18,10,8,36,5,0,33,62,111,40,71,322,2,20,10,0,3,81,133,0,12,1,3,0,16,17,138,541
ARUNACHAL PRADESH,SIANG EAST,2008,9,2,1,12,5,0,5,10,8,5,3,16,2,0,7,29,40,2,38,118,0,1,4,0,0,27,39,0,6,0,1,0,7,7,30,179
ARUNACHAL PRADESH,SIANG UPPER,2008,1,3,0,4,0,0,0,0,1,1,0,2,0,0,2,7,12,1,11,33,0,5,1,0,0,10,20,0,1,0,0,0,1,4,8,55
ARUNACHAL PRADESH,SIANG WEST,2008,6,5,0,11,13,0,13,26,10,8,2,20,0,0,1,24,51,3,48,127,1,3,2,0,2,65,80,0,6,0,5,0,11,7,75,276
ARUNACHAL PRADESH,SUBANSIRI LOWER,2008,4,1,0,5,0,0,0,0,4,3,1,8,0,0,6,12,16,3,13,50,1,1,2,0,0,39,47,0,10,0,0,0,10,4,35,135
ARUNACHAL PRADESH,SUBANSIRI UPPER,2008,4,6,0,10,2,0,2,4,2,1,1,4,0,0,4,5,13,2,11,35,7,0,4,0,0,55,71,0,6,0,1,0,7,5,48,162
ARUNACHAL PRADESH,TAWANG,2008,2,0,0,2,0,0,0,0,0,0,0,0,0,0,1,3,10,0,10,24,0,0,0,0,0,11,17,0,5,0,0,0,5,6,4,42
ARUNACHAL PRADESH,TIRAP,2008,7,3,0,10,0,0,0,0,13,2,11,26,1,0,6,30,24,5,19,85,1,1,0,0,0,14,21,0,5,0,0,0,5,5,31,141
ARUNACHAL PRADESH,UPPER DIBANG VALLEY,2008,2,0,0,2,0,0,0,0,0,0,0,0,0,0,0,3,3,0,3,9,0,0,0,0,0,3,4,0,0,0,0,0,0,1,2,14
ASSAM,BARPETA,2008,54,20,0,74,97,0,97,194,128,117,11,256,14,0,16,127,209,25,184,575,277,20,11,1,3,253,780,14,34,0,240,0,288,215,806,2539
ASSAM,BASKA,2008,67,19,0,86,23,0,23,46,35,30,5,70,3,0,7,10,35,1,34,90,3,7,4,1,3,77,107,4,16,0,13,0,33,12,126,465
ASSAM,BONGAIGAON,2008,15,10,0,25,51,0,51,102,60,35,25,120,7,1,7,104,138,27,111,395,83,13,36,3,4,94,314,5,13,0,106,0,124,81,388,1219
ASSAM,C.I.D.,2008,0,0,0,0,0,0,0,0,0,0,0,0,0,0,0,0,1,0,1,2,0,0,10,0,0,0,10,0,0,0,0,0,0,0,13,24
ASSAM,CACHAR,2008,56,6,0,62,72,0,72,144,128,106,22,256,43,1,23,262,640,183,457,1609,245,54,64,3,49,71,547,13,19,0,216,0,248,61,2843,4869
ASSAM,CHIRANG,2008,24,0,0,24,25,0,25,50,33,24,9,66,2,0,4,27,57,3,54,147,5,1,7,0,3,42,98,0,15,0,38,0,53,40,144,467
ASSAM,DARRANG,2008,38,5,0,43,57,0,57,114,59,57,2,118,6,0,16,91,136,23,113,385,61,17,31,5,27,347,595,2,162,2,119,0,285,107,205,1493
ASSAM,DHEMAJI,2008,21,30,5,56,88,0,88,176,66,51,15,132,1,1,23,30,152,23,129,359,22,3,35,0,14,345,478,0,40,0,165,0,205,59,226,1326
ASSAM,DHUBRI,2008,44,20,3,67,116,0,116,232,139,126,13,278,16,1,15,125,240,27,213,637,304,53,79,13,20,598,1157,4,88,0,393,0,485,90,881,3242
ASSAM,DIBRUGARH,2008,99,21,0,120,46,0,46,92,89,60,29,178,4,0,31,85,587,52,535,1294,21,34,34,4,0,440,634,4,60,0,100,0,164,101,583,2343
ASSAM,G.R.P.,2008,6,0,0,6,5,0,5,10,8,8,0,16,4,0,6,7,155,0,155,327,1,1,2,0,0,7,15,0,2,0,0,0,2,4,43,251
ASSAM,GOALPARA,2008,36,5,0,41,66,0,66,132,76,64,12,152,14,0,9,74,131,20,111,359,147,0,30,1,19,115,416,4,32,0,117,0,153,104,339,1319
ASSAM,GOLAGHAT,2008,65,15,1,81,42,0,42,84,61,50,11,122,15,0,25,89,247,49,198,623,54,13,32,2,29,258,544,0,46,0,86,0,132,156,240,1476
ASSAM,GUWAHATI CITY,2008,50,18,16,84,59,0,59,118,167,97,70,334,20,42,77,564,1129,987,142,2961,74,125,147,22,15,345,863,5,169,0,216,0,390,135,3768,7163
ASSAM,HAILAKANDI,2008,27,0,0,27,39,0,39,78,61,52,9,122,16,2,5,72,122,13,109,339,343,14,22,7,14,28,449,3,8,0,62,0,73,21,305,1171
ASSAM,JORHAT,2008,51,24,17,92,44,0,44,88,54,41,13,108,5,0,15,106,269,85,184,664,16,17,41,2,10,297,471,0,59,0,76,0,135,88,326,1517
ASSAM,KAMRUP,2008,46,23,19,88,36,0,36,72,113,78,35,226,11,25,55,265,704,211,493,1764,34,45,47,3,35,195,470,3,75,0,101,0,179,111,483,2429
ASSAM,KARBI ANGLONG,2008,55,16,0,71,16,0,16,32,25,12,13,50,11,0,9,32,141,34,107,334,35,10,12,4,8,31,167,1,7,0,16,0,24,67,188,684
ASSAM,KARIMGANJ,2008,27,13,0,40,19,0,19,38,49,44,5,98,6,0,8,54,105,6,99,278,228,7,15,1,8,120,411,5,10,0,99,0,114,32,240,1046
ASSAM,KOKRAJHAR,2008,53,32,0,85,55,0,55,110,51,24,27,102,5,0,8,39,173,19,154,398,38,9,25,4,12,82,244,4,16,0,58,0,78,74,164,902
ASSAM,LAKHIMPUR,2008,41,6,3,50,52,0,52,104,91,71,20,182,4,0,9,90,177,11,166,457,17,11,28,1,16,551,738,1,24,0,160,0,185,114,509,1905
ASSAM,MORIGAON,2008,20,9,3,32,75,0,75,150,68,68,0,136,9,0,12,61,169,10,159,420,64,5,50,1,6,510,682,4,57,0,114,0,175,46,146,1429
ASSAM,N.C.HILLS,2008,42,14,0,56,4,0,4,8,14,9,5,28,0,0,2,15,43,1,42,103,2,1,2,0,2,7,29,0,1,0,3,0,4,15,66,233
ASSAM,NAGAON,2008,83,41,2,126,112,0,112,224,215,209,6,430,44,0,74,233,354,80,274,1059,271,96,49,3,51,458,1115,9,200,0,371,0,580,187,1441,4294
ASSAM,NALBARI,2008,31,29,1,61,30,0,30,60,55,47,8,110,6,1,33,81,144,35,109,409,10,4,16,2,9,321,399,6,42,0,54,0,102,37,271,1183
ASSAM,R.P.O.,2008,3,0,0,3,5,0,5,10,3,3,0,6,5,0,0,1,13,0,13,32,3,1,0,0,2,5,11,0,1,0,0,0,1,0,46,88
ASSAM,SIBSAGAR,2008,108,7,0,115,46,0,46,92,111,94,17,222,3,0,22,156,500,65,435,1181,44,28,73,3,24,234,441,4,27,0,139,0,170,35,712,2276
ASSAM,SONITPUR,2008,94,31,1,126,56,0,56,112,136,125,11,272,7,0,20,167,451,64,387,1096,87,28,45,2,2,83,453,6,34,0,294,0,334,206,1029,2779
ASSAM,TINSUKIA,2008,114,0,0,114,60,0,60,120,87,60,27,174,17,0,21,115,682,41,641,1517,16,59,31,2,12,159,336,2,8,0,84,0,94,57,807,2333
ASSAM,UDALGURI,2008,56,3,0,59,42,0,42,84,57,27,30,114,14,0,16,65,108,6,102,311,95,4,18,1,46,34,202,0,7,0,38,0,45,4,260,868
BIHAR,ARARIA,2008,50,37,10,97,37,0,37,74,40,30,10,80,49,0,51,57,234,21,213,625,214,30,42,0,61,371,749,3,35,0,92,2,132,31,1461,2907
BIHAR,ARWAL,2008,28,0,0,28,2,0,2,4,12,10,2,24,1,0,4,11,57,2,55,130,26,11,21,0,0,0,125,13,0,0,8,0,21,67,433,694
BIHAR,AURANGABAD,2008,92,27,8,127,30,0,30,60,56,38,18,112,28,1,24,115,307,18,289,782,445,19,165,1,25,1487,2293,32,13,0,65,0,110,151,290,3381
BIHAR,BAGAHA,2008,26,8,2,36,15,0,15,30,49,36,13,98,6,0,17,66,217,5,212,523,133,14,44,4,7,477,711,11,14,0,36,0,61,32,1261,2439
BIHAR,BANKA,2008,70,56,6,132,49,0,49,98,46,38,8,92,14,1,24,85,143,7,136,410,168,12,26,1,24,484,715,23,16,0,24,0,63,0,576,1848
BIHAR,BEGUSARAI,2008,101,170,9,280,25,0,25,50,110,34,76,220,18,1,67,69,275,39,236,705,225,70,78,0,19,397,949,41,3,0,56,0,100,160,1362,3256
BIHAR,BETTIAH,2008,64,33,8,105,28,0,28,56,51,49,2,102,7,1,18,57,243,16,227,569,261,66,35,16,26,55,592,33,0,4,96,0,133,133,2077,3312
BIHAR,BHABHUA,2008,40,38,0,78,8,0,8,16,37,19,18,74,6,0,14,68,193,14,179,474,148,33,45,1,6,141,456,19,10,0,26,1,56,82,847,1763
BIHAR,BHAGALPUR,2008,90,81,13,184,35,0,35,70,133,98,35,266,10,0,34,130,699,139,560,1572,259,35,105,3,21,621,1124,27,35,5,120,0,187,80,1777,4313
BIHAR,BHOJPUR,2008,138,167,2,307,18,0,18,36,72,47,25,144,16,0,49,94,314,64,250,787,191,106,164,0,48,1635,2284,57,31,1,122,0,211,140,501,3866
BIHAR,BUXAR,2008,52,61,6,119,11,0,11,22,26,18,8,52,9,1,24,52,284,44,240,654,143,26,24,4,23,116,382,29,20,0,19,0,68,46,520,1496
BIHAR,DARBHANGA,2008,76,154,6,236,67,0,67,134,123,80,43,246,19,0,15,68,320,10,310,742,50,129,150,4,34,159,628,48,53,0,45,0,146,102,2178,3800
BIHAR,GAYA,2008,136,60,12,208,52,0,52,104,90,77,13,180,35,0,63,124,494,169,325,1210,544,32,151,0,26,456,1421,43,8,0,40,3,94,212,1598,4179
BIHAR,GOPALGANJ,2008,74,93,6,173,23,0,23,46,80,63,17,160,16,0,41,50,144,55,89,395,201,4,65,0,17,68,549,36,27,0,110,0,173,194,1356,2605
BIHAR,JAMALPUR RLY.,2008,10,0,0,10,1,0,1,2,4,0,4,8,8,1,3,0,123,8,115,258,7,0,1,0,0,0,8,1,0,0,0,0,1,0,64,223
BIHAR,JAMUI,2008,56,127,3,186,17,0,17,34,38,21,17,76,16,6,21,38,138,13,125,357,163,5,47,0,21,756,1024,32,25,0,41,0,98,32,206,1788
BIHAR,JEHANABAD,2008,35,10,5,50,6,0,6,12,38,19,19,76,15,0,18,25,132,9,123,322,127,3,10,0,0,20,212,23,0,0,17,0,40,52,988,1524
BIHAR,KATIHAR,2008,63,13,2,78,120,0,120,240,103,66,37,206,16,5,23,61,152,28,124,409,146,19,85,0,17,765,1117,15,12,0,28,0,55,85,1128,2858
BIHAR,KATIHAR RLY.,2008,6,11,2,19,2,0,2,4,9,2,7,18,4,1,9,8,232,2,230,486,21,3,8,0,0,33,67,0,5,0,1,0,6,2,110,467
BIHAR,KHAGARIA,2008,55,63,0,118,16,0,16,32,48,17,31,96,7,0,17,16,99,29,70,238,201,13,17,2,11,219,526,9,2,0,13,0,24,63,955,1826
BIHAR,KISHANGANJ,2008,32,42,0,74,30,0,30,60,33,26,7,66,7,1,17,46,169,16,153,409,125,5,4,1,4,426,600,8,0,0,23,0,31,35,308,1316
BIHAR,LAKHISARAI,2008,41,67,0,108,35,0,35,70,34,17,17,68,7,0,23,36,133,2,131,332,72,16,33,0,4,237,414,11,23,2,12,0,48,52,349,1187
BIHAR,MADHEPURA,2008,34,7,6,47,16,0,16,32,45,30,15,90,7,0,33,42,140,29,111,362,159,25,11,0,7,57,282,16,10,0,12,0,38,23,1050,1700
BIHAR,MADHUBANI,2008,62,72,6,140,24,0,24,48,51,36,15,102,24,4,26,85,345,5,340,829,285,21,30,0,16,214,728,24,182,0,51,0,257,162,3770,5454
BIHAR,MOTIHARI,2008,120,306,79,505,34,0,34,68,121,83,38,242,27,0,50,113,474,110,364,1138,323,13,9,4,21,1876,2372,45,14,0,12,0,71,126,833,4600
BIHAR,MUNGER,2008,85,92,0,177,20,0,20,40,61,31,30,122,6,1,43,36,312,85,227,710,189,20,22,0,3,85,372,14,2,0,40,0,56,53,815,1899
BIHAR,MUZAFFARPUR,2008,138,11,18,167,28,0,28,56,136,97,39,272,35,8,50,209,875,226,649,2052,316,66,126,5,33,5,607,75,15,0,90,0,180,56,3383,5678
BIHAR,MUZAFFARPUR RLY.,2008,16,0,0,16,2,0,2,4,4,0,4,8,4,0,12,16,300,19,281,632,9,0,13,2,0,0,39,0,0,0,1,0,1,15,215,609
BIHAR,NALANDA,2008,120,53,17,190,23,0,23,46,100,56,44,200,10,0,23,82,397,65,332,909,190,73,76,3,25,1085,1735,70,36,0,77,0,183,283,1472,4215
BIHAR,NAUGACHIA,2008,33,15,2,50,8,0,8,16,29,6,23,58,2,0,4,3,65,2,63,139,106,59,62,0,5,101,384,5,35,0,65,0,105,51,873,1523
BIHAR,NAWADAH,2008,76,8,0,84,28,0,28,56,48,26,22,96,10,1,24,28,151,19,132,365,128,40,35,1,3,401,688,24,10,1,36,1,72,80,613,1747
BIHAR,PATNA,2008,341,189,28,558,57,0,57,114,341,78,263,682,63,0,312,647,1455,880,575,3932,428,46,318,5,6,93,1677,99,31,1,189,0,320,781,9061,14491
BIHAR,PATNA RLY.,2008,24,13,3,40,0,0,0,0,11,4,7,22,9,0,12,3,601,36,565,1226,18,3,19,1,0,0,41,2,7,0,1,0,10,0,212,939
BIHAR,PURNEA,2008,81,20,39,140,185,0,185,370,139,88,51,278,29,6,30,163,242,48,194,712,187,36,151,0,38,478,1027,3,73,0,81,0,157,137,684,2802
BIHAR,ROHTAS,2008,112,19,0,131,21,0,21,42,63,55,8,126,22,0,49,120,439,24,415,1069,154,38,97,0,29,165,738,36,15,0,42,0,93,255,2267,3943
BIHAR,SAHARSA,2008,30,139,4,173,22,0,22,44,41,20,21,82,13,0,70,38,131,10,121,383,267,49,59,1,15,304,745,17,75,0,21,0,113,50,809,2155
BIHAR,SAMASTIPUR,2008,81,292,31,404,32,0,32,64,74,62,12,148,8,11,28,75,381,49,332,884,253,25,34,0,41,315,971,60,15,5,52,15,147,303,1285,3416
BIHAR,SARAN,2008,119,137,14,270,34,0,34,68,98,58,40,196,29,2,60,101,455,55,400,1102,266,55,95,0,39,1014,1590,58,10,0,41,0,109,121,802,3550
BIHAR,SHEIKHPURA,2008,22,27,5,54,9,0,9,18,25,14,11,50,2,0,7,7,85,8,77,186,101,1,33,0,6,46,213,7,1,0,10,0,18,26,600,1020
BIHAR,SHEOHAR,2008,9,17,0,26,7,0,7,14,19,11,8,38,5,0,9,12,44,7,37,114,70,7,16,0,1,171,270,7,4,0,13,0,24,5,130,546
BIHAR,SITAMARHI,2008,72,37,6,115,12,0,12,24,70,43,27,140,26,0,36,76,311,95,216,760,59,11,20,0,27,316,486,24,18,0,12,0,54,53,2049,3235
BIHAR,SIWAN,2008,74,65,10,149,24,0,24,48,67,35,32,134,22,3,72,79,231,85,146,638,125,19,90,5,32,763,1119,31,9,2,54,0,96,85,590,2452
BIHAR,SUPAUL,2008,49,88,2,139,53,0,53,106,54,37,17,108,6,2,31,74,181,16,165,475,315,34,85,1,11,121,596,15,71,0,68,0,154,29,688,1978
BIHAR,VAISHALI,2008,106,29,16,151,36,0,36,72,218,114,104,436,13,3,35,129,489,92,397,1158,281,60,20,4,20,111,643,64,34,0,30,0,128,147,1824,3669
CHHATTISGARH,BALRAMPUR,2008,49,12,1,62,41,0,41,82,7,5,2,14,4,2,20,46,33,1,32,138,32,0,4,2,6,222,324,3,43,0,24,0,70,58,165,774
CHHATTISGARH,BILASPUR,2008,112,48,0,160,71,0,71,142,33,25,8,66,6,2,55,610,869,307,562,2411,211,11,74,7,31,1741,2350,19,171,4,136,0,330,275,1851,6337
CHHATTISGARH,BIZAPUR,2008,95,82,1,178,5,0,5,10,8,2,6,16,11,0,6,8,4,0,4,33,18,0,1,0,12,9,54,0,5,0,1,0,6,14,88,368
CHHATTISGARH,DANTEWARA,2008,69,84,0,153,10,0,10,20,8,7,1,16,25,3,1,44,47,13,34,167,28,0,8,0,20,43,132,1,17,1,3,0,22,33,278,723
CHHATTISGARH,DHAMTARI,2008,23,16,0,39,26,0,26,52,4,4,0,8,5,0,11,152,151,52,99,470,34,0,20,0,8,74,250,3,47,4,19,0,73,114,841,1552
CHHATTISGARH,DURG,2008,83,39,4,126,109,0,109,218,18,12,6,36,5,1,61,593,822,323,499,2304,54,15,69,8,25,385,916,11,218,17,118,0,364,360,3580,6595
CHHATTISGARH,GRP RAIPUR,2008,5,1,0,6,2,0,2,4,0,0,0,0,0,0,4,7,195,20,175,401,1,0,2,0,0,14,18,0,4,2,0,0,6,1,63,301
CHHATTISGARH,JAGDALPUR,2008,73,46,1,120,68,0,68,136,13,11,2,26,11,0,13,112,128,55,73,392,55,3,18,5,9,214,453,2,49,2,23,0,76,149,1315,2309
CHHATTISGARH,JANJGIR,2008,36,31,1,68,47,0,47,94,8,7,1,16,3,0,34,270,319,86,233,945,100,5,23,9,17,180,471,14,135,12,123,0,284,137,1507,3011
CHHATTISGARH,JASHPUR,2008,65,16,0,81,71,0,71,142,46,41,5,92,6,2,24,87,126,26,100,371,27,0,16,2,6,98,233,0,56,3,19,0,78,84,516,1270
CHHATTISGARH,KABIRDHAM,2008,11,18,0,29,29,0,29,58,5,4,1,10,3,0,13,120,141,20,121,418,50,6,21,0,11,642,788,5,79,6,23,0,113,58,479,1720
CHHATTISGARH,KANKER,2008,54,53,1,108,15,0,15,30,10,7,3,20,14,0,13,76,77,13,64,257,26,3,6,1,19,31,160,4,26,3,13,0,46,74,543,1062
CHHATTISGARH,KORBA,2008,38,12,0,50,31,0,31,62,12,9,3,24,4,1,36,147,293,133,160,774,39,4,26,4,5,624,898,5,68,10,42,0,125,196,918,2515
CHHATTISGARH,KORIYA,2008,48,22,0,70,54,0,54,108,5,5,0,10,4,0,13,209,159,27,132,544,28,7,14,0,15,557,680,2,93,6,34,0,135,59,469,1798
CHHATTISGARH,MAHASAMUND,2008,19,13,1,33,24,0,24,48,8,7,1,16,1,0,5,120,155,37,118,436,20,11,19,3,9,200,422,6,57,4,27,0,94,160,631,1493
CHHATTISGARH,NARAYANPUR,2008,18,49,0,67,1,0,1,2,1,0,1,2,7,0,0,3,8,4,4,26,1,1,0,0,7,14,31,0,0,0,0,0,0,8,33,151
CHHATTISGARH,RAIGARH,2008,89,24,0,113,30,0,30,60,10,7,3,20,2,0,28,237,448,162,286,1163,109,23,25,3,18,643,979,7,74,8,45,0,134,158,964,2945
CHHATTISGARH,RAIPUR,2008,112,91,1,204,128,0,128,256,46,36,10,92,5,5,85,823,1525,672,853,3968,183,60,138,21,51,2328,3314,11,247,34,124,0,416,533,3430,9981
CHHATTISGARH,RAJNANDGAON,2008,47,33,4,84,60,0,60,120,12,12,0,24,2,1,23,251,288,81,207,853,42,7,36,4,14,99,355,7,72,5,57,0,141,153,2035,3252
CHHATTISGARH,SARGUJA,2008,65,27,1,93,78,0,78,156,9,8,1,18,2,0,30,87,162,65,97,443,44,2,30,1,13,77,256,3,89,3,27,0,122,89,966,1805
CHHATTISGARH,SURAJPUR,2008,58,19,2,79,78,0,78,156,10,7,3,20,4,0,25,110,129,25,104,397,42,11,12,1,6,370,529,3,71,1,39,0,114,87,402,1480
GOA,NORTH GOA,2008,26,14,8,48,15,0,15,30,19,17,2,38,2,0,8,150,360,128,232,880,43,30,57,13,6,94,377,0,15,2,5,0,22,134,488,1489
GOA,SOUTH GOA,2008,23,11,3,37,15,0,15,30,17,11,6,34,1,0,15,152,241,110,131,650,59,17,48,9,21,91,341,2,17,10,7,0,36,96,398,1253
GUJARAT,AHMEDABAD COMMR.,2008,85,60,0,145,44,0,44,88,172,137,35,344,14,2,538,778,5485,3239,2246,12302,168,223,200,14,1,1335,2183,1,78,19,1185,0,1283,242,7900,18544
GUJARAT,AHMEDABAD RURAL,2008,36,20,0,56,3,0,3,6,36,35,1,72,14,1,37,114,354,124,230,874,61,45,9,3,9,236,684,1,16,0,67,0,84,321,2021,3404
GUJARAT,AHWA-DANG,2008,7,2,0,9,3,0,3,6,2,2,0,4,0,0,0,2,13,4,9,28,2,2,2,0,0,27,46,0,2,0,11,0,13,13,143,231
GUJARAT,AMRELI,2008,22,6,1,29,8,0,8,16,60,58,2,120,0,1,6,127,218,69,149,570,34,50,8,6,10,305,546,0,31,3,128,0,162,133,1234,2391
GUJARAT,ANAND,2008,40,10,2,52,11,0,11,22,51,45,6,102,12,0,16,121,508,172,336,1165,39,64,10,7,14,342,700,0,25,2,170,0,197,224,2126,3794
GUJARAT,BHARUCH,2008,36,15,1,52,13,0,13,26,34,29,5,68,13,0,22,157,371,121,250,934,51,76,14,4,41,218,684,0,13,2,114,0,129,280,1600,3075
GUJARAT,BHAVNAGAR,2008,35,33,3,71,9,0,9,18,90,80,10,180,11,0,52,224,857,328,529,2001,134,40,73,11,13,132,403,0,69,51,197,0,317,0,3824,5858
GUJARAT,DAHOD,2008,44,21,3,68,13,0,13,26,43,40,3,86,33,1,55,98,167,89,78,521,61,8,4,1,31,347,452,0,33,0,63,0,96,0,782,1808
GUJARAT,GANDHINAGAR,2008,32,12,0,44,8,0,8,16,44,35,9,88,6,0,34,150,606,250,356,1402,42,19,40,9,6,271,598,3,18,2,200,0,223,211,3095,4808
GUJARAT,HIMATNAGAR,2008,38,13,1,52,16,0,16,32,37,34,3,74,11,0,19,83,206,71,135,525,64,31,33,12,17,209,632,0,22,0,217,0,239,266,3592,4887
GUJARAT,JAMNAGAR,2008,34,12,3,49,17,0,17,34,30,25,5,60,14,0,22,150,410,162,248,1006,79,22,27,4,15,422,576,0,14,1,239,0,254,7,3810,5332
GUJARAT,JUNAGADH,2008,33,20,0,53,5,0,5,10,48,43,5,96,13,0,49,221,719,268,451,1721,79,84,46,7,25,463,890,3,66,3,456,0,528,186,2762,5288
GUJARAT,KHEDA NORTH,2008,36,11,0,47,8,0,8,16,41,39,2,82,5,0,13,114,393,81,312,918,39,25,35,9,23,383,761,0,40,0,219,0,259,247,3624,5265
GUJARAT,KUTCH,2008,40,8,1,49,16,0,16,32,44,42,2,88,4,1,34,297,656,254,402,1648,73,35,52,7,14,418,894,1,26,6,334,0,367,295,2579,4941
GUJARAT,MEHSANA,2008,29,18,1,48,9,0,9,18,54,48,6,108,10,0,33,211,652,215,437,1558,84,49,34,6,9,838,1205,0,33,1,289,0,323,185,2059,4604
GUJARAT,NARMADA,2008,11,3,5,19,7,0,7,14,7,7,0,14,0,0,1,18,38,13,25,95,7,2,3,2,4,118,199,0,8,1,12,0,21,63,500,810
GUJARAT,NAVSARI,2008,25,3,1,29,2,0,2,4,9,4,5,18,0,0,5,26,84,46,38,199,10,14,5,4,3,35,71,0,1,1,5,0,7,0,762,995
GUJARAT,PALANPUR,2008,42,16,1,59,37,0,37,74,43,43,0,86,9,0,31,206,413,137,276,1072,67,18,35,6,23,1109,1432,1,34,0,201,0,236,174,1641,4107
GUJARAT,PANCHMAHAL,2008,40,13,1,54,8,0,8,16,55,53,2,110,3,0,13,99,208,84,124,531,29,34,25,0,27,303,418,0,29,2,148,0,179,0,2286,3323
GUJARAT,PATAN,2008,14,15,0,29,19,0,19,38,29,24,5,58,4,0,18,102,371,71,300,866,54,17,20,6,5,350,570,0,29,0,157,0,186,118,1620,2948
GUJARAT,PORBANDAR,2008,7,6,0,13,3,0,3,6,12,11,1,24,0,0,6,38,89,22,67,222,10,4,11,2,6,82,184,0,5,0,48,0,53,69,616,1014
GUJARAT,RAJKOT COMMR.,2008,37,33,1,71,12,0,12,24,54,40,14,108,9,0,68,320,1394,784,610,3185,140,71,85,14,12,417,867,1,30,19,312,0,362,128,2368,5525
GUJARAT,RAJKOT RURAL,2008,45,16,2,63,24,0,24,48,47,42,5,94,13,0,26,156,425,190,235,1045,62,42,12,4,12,334,759,4,45,2,293,0,344,293,2013,3870
GUJARAT,SURAT COMMR.,2008,97,42,3,142,28,0,28,56,131,79,52,262,24,4,146,544,3049,1939,1110,6816,165,39,178,29,10,856,1659,11,54,2,472,0,539,382,4475,10741
GUJARAT,SURAT RURAL,2008,43,4,1,48,3,0,3,6,11,5,6,22,5,2,9,39,122,56,66,299,10,17,19,3,4,78,431,0,7,0,30,0,37,300,882,1589
GUJARAT,SURENDRANAGAR,2008,35,15,0,50,21,0,21,42,44,38,6,88,3,0,12,80,195,66,129,485,44,38,17,2,6,382,725,0,50,1,133,0,184,236,1643,2957
GUJARAT,TAPI,2008,21,5,0,26,3,0,3,6,3,2,1,6,3,0,3,19,42,20,22,109,8,5,0,3,0,50,164,0,2,0,6,0,8,98,331,602
GUJARAT,VADODARA COMMR.,2008,20,32,3,55,7,0,7,14,34,30,4,68,9,2,23,366,1415,827,588,3230,123,20,119,6,5,283,715,0,16,3,268,0,287,159,2473,5386
GUJARAT,VADODARA RURAL,2008,79,17,1,97,11,0,11,22,39,37,2,78,6,0,10,53,191,76,115,451,31,44,6,5,16,345,743,0,21,0,87,0,108,296,1497,2755
GUJARAT,VALSAD,2008,33,5,0,38,4,0,4,8,15,9,6,30,4,0,8,119,229,121,108,589,36,28,43,4,2,138,251,0,6,0,32,0,38,0,1094,1800
GUJARAT,W.RLY,2008,10,1,0,11,2,0,2,4,4,3,1,8,4,0,13,21,835,48,787,1708,3,1,2,0,0,71,85,1,5,1,1,0,8,8,173,1156
HARYANA,AMBALA,2008,31,31,0,62,35,0,35,70,55,49,6,110,2,3,15,266,419,217,202,1124,1,32,88,2,7,239,371,11,27,21,172,0,231,2,1101,2560
HARYANA,BHIWANI,2008,56,27,11,94,33,0,33,66,47,36,11,94,12,1,25,241,560,291,269,1399,158,21,90,3,19,305,601,14,24,20,111,0,169,5,956,2739
HARYANA,FARIDABAD,2008,59,24,5,88,46,0,46,92,109,94,15,218,4,51,32,276,945,691,254,2253,145,138,32,2,7,191,527,21,23,97,173,0,314,12,2124,4516
HARYANA,FATEHABAD,2008,20,13,4,37,12,0,12,24,25,21,4,50,1,5,5,126,298,162,136,733,23,8,65,0,5,184,289,4,16,13,143,0,176,4,647,1621
HARYANA,GRP,2008,27,3,2,32,1,0,1,2,7,3,4,14,1,1,22,1,497,108,389,1019,11,4,7,0,0,13,59,6,7,158,0,0,171,24,468,1260
HARYANA,GURGAON,2008,80,59,5,144,35,0,35,70,89,66,23,178,36,56,111,698,2843,2063,780,6587,117,91,200,8,9,156,610,19,27,32,123,0,201,29,2347,7170
HARYANA,HISSAR,2008,52,46,5,103,23,0,23,46,43,27,16,86,1,8,23,214,560,332,228,1366,52,30,94,3,8,382,571,19,25,9,214,0,267,2,1353,3166
HARYANA,JHAJJAR,2008,62,30,4,96,22,0,22,44,26,15,11,52,5,8,18,138,268,152,116,705,58,24,44,0,2,117,426,20,13,42,115,0,190,181,518,1715
HARYANA,JIND,2008,39,24,14,77,38,0,38,76,29,23,6,58,1,1,18,158,296,189,107,770,103,56,43,0,4,154,367,18,21,15,73,0,127,7,655,1767
HARYANA,KAITHAL,2008,22,24,2,48,14,0,14,28,16,16,0,32,5,7,6,107,194,116,78,513,0,70,22,2,3,225,327,13,14,0,150,0,177,5,621,1522
HARYANA,KARNAL,2008,39,46,7,92,50,0,50,100,35,23,12,70,6,10,23,265,681,373,308,1666,28,13,74,1,8,350,752,17,31,21,124,0,193,278,1124,3231
HARYANA,KURUKSHETRA,2008,20,19,2,41,41,0,41,82,30,24,6,60,2,4,23,244,582,270,312,1437,0,73,22,5,4,207,317,12,11,27,72,0,122,6,1007,2413
HARYANA,MAHENDRAGARH,2008,31,6,2,39,21,0,21,42,26,20,6,52,1,0,4,102,196,102,94,499,52,27,10,0,4,156,252,16,17,0,73,0,106,3,977,1724
HARYANA,MEWAT,2008,19,21,0,40,29,0,29,58,21,13,8,42,4,23,11,23,212,124,88,485,96,13,42,0,2,91,245,7,6,6,114,0,133,1,521,1262
HARYANA,PALWAL,2008,34,37,3,74,29,0,29,58,32,23,9,64,5,18,22,70,354,268,86,823,115,16,25,1,2,198,361,15,25,33,89,0,162,4,863,1990
HARYANA,PANCHKULA,2008,17,7,1,25,15,0,15,30,26,18,8,52,6,1,14,157,427,201,226,1032,3,11,58,0,0,53,128,5,6,1,72,0,84,3,686,1569
HARYANA,PANIPAT,2008,46,16,12,74,30,0,30,60,52,34,18,104,3,19,27,195,845,613,232,1934,63,20,20,5,2,225,569,13,16,17,62,0,108,234,780,2702
HARYANA,REWARI,2008,27,24,4,55,23,0,23,46,27,25,2,54,4,1,29,170,429,253,176,1062,47,44,18,2,9,203,330,13,31,0,72,0,116,7,1177,2361
HARYANA,ROHTAK,2008,67,53,3,123,39,0,39,78,32,20,12,64,4,6,30,227,596,369,227,1459,75,22,60,1,6,197,556,17,25,38,106,0,186,195,843,2642
HARYANA,SIRSA,2008,48,35,0,83,31,0,31,62,25,16,9,50,3,0,8,146,334,173,161,825,26,18,32,4,13,351,445,9,14,0,127,0,150,1,733,1958
HARYANA,SONIPAT,2008,84,48,4,136,36,0,36,72,59,43,16,118,11,28,69,229,659,331,328,1655,11,21,86,0,13,291,732,24,31,50,149,0,254,310,1170,3383
HARYANA,YAMUNANAGAR,2008,41,23,2,66,28,0,28,56,43,35,8,86,3,6,20,196,514,276,238,1253,0,11,18,1,12,216,268,9,25,5,101,0,140,10,789,2073
HIMACHAL PRADESH,BILASPUR,2008,5,2,1,8,10,0,10,20,7,7,0,14,0,0,2,46,64,8,56,176,38,7,17,3,6,36,126,2,28,5,35,0,70,19,713,1046
HIMACHAL PRADESH,CHAMBA,2008,10,3,1,14,10,0,10,20,16,16,0,32,0,0,1,112,52,5,47,217,21,2,3,0,4,62,136,0,26,0,10,0,36,44,384,761
HIMACHAL PRADESH,G.R.P.,2008,0,0,0,0,0,0,0,0,0,0,0,0,0,0,0,0,3,0,3,6,0,0,0,0,0,0,0,0,0,0,0,0,0,0,5,8
HIMACHAL PRADESH,HAMIRPUR,2008,6,0,0,6,8,0,8,16,12,12,0,24,0,0,0,63,75,23,52,213,23,12,16,0,16,207,295,0,15,7,39,0,61,21,439,959
HIMACHAL PRADESH,KANGRA,2008,19,20,1,40,19,0,19,38,20,15,5,40,0,0,4,123,249,69,180,625,118,12,65,2,20,234,457,0,37,13,68,0,118,6,1260,2290
HIMACHAL PRADESH,KINNAUR,2008,1,0,0,1,4,0,4,8,2,2,0,4,0,0,1,27,9,1,8,46,11,3,0,0,0,9,49,0,3,0,3,0,6,26,71,170
HIMACHAL PRADESH,KULLU,2008,15,3,0,18,16,0,16,32,19,17,2,38,0,0,2,62,80,14,66,224,54,5,13,1,8,40,173,0,31,2,28,0,61,52,665,1096
HIMACHAL PRADESH,LAHAUL-SPITI,2008,1,0,0,1,1,0,1,2,0,0,0,0,0,0,0,4,1,1,0,6,1,1,1,0,0,0,7,0,0,0,1,0,1,4,55,70
HIMACHAL PRADESH,MANDI,2008,19,7,0,26,32,0,32,64,14,13,1,28,0,0,3,95,98,29,69,294,68,11,31,1,28,130,330,1,75,8,42,0,126,61,1420,2144
HIMACHAL PRADESH,SHIMLA,2008,15,10,0,25,22,0,22,44,20,19,1,40,1,0,3,139,225,60,165,593,108,26,41,1,27,54,336,0,31,0,33,0,64,79,1106,1941
HIMACHAL PRADESH,SIRMAUR,2008,7,2,0,9,10,0,10,20,14,13,1,28,1,0,0,52,85,27,58,223,64,19,30,0,8,36,217,0,19,0,30,0,49,60,448,885
HIMACHAL PRADESH,SOLAN,2008,16,3,2,21,14,0,14,28,15,13,2,30,3,0,4,95,126,69,57,354,70,25,13,2,6,357,535,0,13,2,17,0,32,62,659,1504
HIMACHAL PRADESH,UNA,2008,15,9,0,24,11,0,11,22,12,10,2,24,1,0,0,67,85,26,59,238,51,14,18,1,4,93,232,0,17,4,37,0,58,51,612,1102
JAMMU & KASHMIR,ANANTNAG,2008,10,6,0,16,13,0,13,26,74,74,0,148,1,0,7,115,149,38,111,421,148,2,35,1,16,1,203,0,63,17,0,0,80,0,566,1224
JAMMU & KASHMIR,AWANTIPORA,2008,2,3,0,5,4,0,4,8,13,13,0,26,0,0,1,20,39,2,37,99,30,0,2,1,1,0,46,0,40,1,1,0,42,12,197,367
JAMMU & KASHMIR,BANDIPORA,2008,3,3,0,6,1,0,1,2,45,44,1,90,0,0,3,38,57,1,56,155,57,0,7,0,6,0,70,0,74,7,0,0,81,0,166,467
JAMMU & KASHMIR,BARAMULLA,2008,18,35,5,58,13,0,13,26,63,60,3,126,0,0,4,130,144,19,125,422,141,6,6,3,14,9,179,0,80,12,1,0,93,0,563,1247
JAMMU & KASHMIR,BUDGAM,2008,3,27,4,34,8,0,8,16,66,60,6,132,0,0,4,84,186,12,174,460,230,3,31,1,9,3,296,0,88,29,0,0,117,19,609,1404
JAMMU & KASHMIR,CRIME JAMMU,2008,2,0,0,2,0,0,0,0,0,0,0,0,0,0,0,0,1,0,1,2,0,0,22,0,0,0,22,0,0,0,0,0,0,0,0,25
JAMMU & KASHMIR,CRIME SRINAGAR,2008,2,0,0,2,0,0,0,0,0,0,0,0,0,0,0,0,1,0,1,2,0,5,44,0,0,0,49,0,0,0,0,0,0,0,0,52
JAMMU & KASHMIR,DODA,2008,20,41,0,61,20,0,20,40,24,21,3,48,0,0,0,28,39,1,38,106,27,3,8,0,6,16,62,0,14,4,8,0,26,2,331,591
JAMMU & KASHMIR,GANDERBAL,2008,5,2,0,7,2,0,2,4,23,21,2,46,0,0,2,30,41,8,33,114,35,3,4,1,2,4,64,0,36,1,2,0,39,15,150,358
JAMMU & KASHMIR,HANDWARA,2008,6,22,0,28,6,0,6,12,17,16,1,34,0,0,0,13,29,1,28,71,16,2,8,1,6,1,34,0,51,6,1,0,58,0,125,310
JAMMU & KASHMIR,JAMMU,2008,31,87,7,125,26,0,26,52,51,49,2,102,1,0,3,248,572,335,237,1396,210,18,66,4,42,43,486,7,31,58,54,0,150,103,2189,3851
JAMMU & KASHMIR,KARGIL,2008,0,0,2,2,1,0,1,2,1,1,0,2,0,0,0,4,4,0,4,12,8,1,3,0,1,0,17,0,5,0,0,0,5,4,73,107
JAMMU & KASHMIR,KATHUA,2008,14,18,1,33,15,0,15,30,19,13,6,38,0,0,0,43,71,21,50,185,87,2,12,0,12,10,125,7,17,4,7,0,35,2,716,1057
JAMMU & KASHMIR,KISHTWAR,2008,10,22,0,32,4,0,4,8,12,12,0,24,0,0,0,11,35,1,34,81,0,3,4,0,11,6,27,0,10,1,5,0,16,3,157,294
JAMMU & KASHMIR,KULGAM,2008,6,9,0,15,5,0,5,10,45,43,2,90,0,0,7,44,64,4,60,179,68,3,10,2,5,18,139,0,63,4,1,0,68,33,185,572
JAMMU & KASHMIR,KUPWARA,2008,12,41,2,55,5,0,5,10,22,19,3,44,0,0,1,16,29,2,27,75,54,2,5,1,6,4,80,0,31,2,2,0,35,8,150,393
JAMMU & KASHMIR,LEH,2008,2,1,0,3,6,0,6,12,3,3,0,6,0,0,1,20,16,2,14,53,1,5,8,0,0,0,14,0,7,0,0,0,7,0,183,253
JAMMU & KASHMIR,POONCH,2008,13,27,1,41,16,0,16,32,25,21,4,50,0,0,3,49,36,2,34,124,112,2,7,3,0,48,172,0,35,6,13,0,54,0,391,787
JAMMU & KASHMIR,PULWAMA,2008,7,14,2,23,2,0,2,4,30,29,1,60,0,0,11,23,62,5,57,158,77,3,6,0,10,36,135,0,13,8,0,0,21,3,114,421
JAMMU & KASHMIR,RAILWAYS,2008,0,1,0,1,0,0,0,0,1,1,0,2,0,0,0,0,11,0,11,22,0,0,0,0,0,0,0,0,0,0,0,0,0,0,0,13
JAMMU & KASHMIR,RAJOURI,2008,8,26,5,39,21,0,21,42,28,27,1,56,0,0,3,55,51,3,48,160,44,6,17,3,29,31,161,6,34,7,39,0,86,31,842,1286
JAMMU & KASHMIR,RAMBAN,2008,11,12,0,23,9,0,9,18,14,14,0,28,1,0,0,27,37,2,35,102,33,2,10,0,5,9,62,0,4,4,0,0,8,3,497,678
JAMMU & KASHMIR,REASI,2008,16,34,1,51,5,0,5,10,10,9,1,20,0,0,1,18,37,7,30,93,5,1,4,0,7,4,23,0,11,4,2,0,17,2,310,472
JAMMU & KASHMIR,SAMBA,2008,6,26,0,32,2,0,2,4,9,9,0,18,0,0,1,22,45,16,29,113,38,1,8,0,5,2,56,1,7,1,3,0,12,2,491,670
JAMMU & KASHMIR,SHOPIAN,2008,7,23,0,30,6,0,6,12,16,14,2,32,0,0,5,9,62,4,58,138,31,1,5,1,8,5,55,0,49,5,1,0,55,4,75,313
JAMMU & KASHMIR,SRINAGAR,2008,13,80,1,94,16,0,16,32,79,69,10,158,0,0,9,256,329,185,144,923,295,11,57,1,26,16,453,0,162,104,18,0,284,47,1029,2549
JAMMU & KASHMIR,UDHAMPUR,2008,10,10,0,20,13,0,13,26,14,14,0,28,0,0,1,44,51,18,33,147,35,2,3,0,3,7,50,0,10,11,4,0,25,0,625,843
JHARKHAND,BOKARO,2008,76,8,0,84,40,0,40,80,41,37,4,82,21,0,27,71,658,141,517,1435,142,17,84,0,0,0,243,15,0,2,65,0,82,0,1398,2665
JHARKHAND,CHAIBASA,2008,127,46,35,208,42,0,42,84,7,5,2,14,7,2,16,19,131,27,104,306,31,12,22,0,2,49,146,7,16,0,33,0,56,30,203,837
JHARKHAND,CHATRA,2008,42,46,0,88,11,0,11,22,17,14,3,34,14,0,27,18,97,9,88,253,121,0,10,0,5,0,154,14,1,0,2,0,17,18,587,1030
JHARKHAND,DEOGHAR,2008,46,4,1,51,33,0,33,66,11,2,9,22,18,3,22,112,152,61,91,459,148,13,7,11,3,279,557,6,5,5,29,12,57,96,459,1475
JHARKHAND,DHANBAD,2008,72,41,12,125,47,0,47,94,88,76,12,176,38,2,59,182,788,276,512,1857,204,26,62,1,8,196,498,36,35,10,57,0,138,1,1614,3579
JHARKHAND,DHANBAD RLY.,2008,13,0,0,13,0,0,0,0,1,1,0,2,16,1,12,7,110,9,101,256,5,0,1,0,0,0,6,2,4,0,2,0,8,0,61,235
JHARKHAND,DUMKA,2008,77,17,0,94,60,0,60,120,26,23,3,52,6,0,17,80,201,12,189,505,109,11,23,0,4,261,462,17,7,0,66,0,90,54,722,1758
JHARKHAND,GARHWA,2008,48,78,2,128,21,0,21,42,27,16,11,54,18,1,30,29,85,1,84,248,139,8,29,1,19,302,542,9,15,0,20,0,44,44,354,1279
JHARKHAND,GIRIDIH,2008,63,30,0,93,48,0,48,96,52,44,8,104,41,0,45,88,353,47,306,880,378,6,30,0,9,205,712,33,22,1,25,0,81,84,1306,2819
JHARKHAND,GODDA,2008,61,44,0,105,26,0,26,52,41,6,35,82,5,0,16,55,160,0,160,396,124,0,0,0,29,235,388,7,16,0,50,0,73,0,994,1863
JHARKHAND,GUMLA,2008,158,79,4,241,38,0,38,76,37,11,26,74,20,0,62,22,97,58,39,298,18,8,17,0,0,76,199,0,11,0,8,0,19,80,225,960
JHARKHAND,HAZARIBAGH,2008,80,52,2,134,57,0,57,114,65,61,4,130,32,11,55,116,465,133,332,1144,323,23,144,3,19,109,790,36,31,0,97,0,164,169,1132,3021
JHARKHAND,JAMSHEDPUR,2008,102,88,10,200,41,0,41,82,36,16,20,72,20,2,59,123,890,325,565,1984,44,35,116,2,11,86,298,14,18,5,74,0,111,4,1432,3212
JHARKHAND,JAMSHEDPUR RLY.,2008,6,2,0,8,0,0,0,0,0,0,0,0,3,1,6,3,122,10,112,257,1,0,2,1,1,11,17,0,1,0,1,0,2,1,32,194
JHARKHAND,JAMTARA,2008,25,1,3,29,20,0,20,40,9,3,6,18,0,1,4,42,64,6,58,175,71,6,16,0,1,0,97,5,9,0,16,0,30,3,358,654
JHARKHAND,KHUNTI,2008,63,11,5,79,8,0,8,16,13,2,11,26,6,2,16,4,40,3,37,108,15,0,1,0,3,19,79,1,1,0,1,0,3,41,63,313
JHARKHAND,KODERMA,2008,23,31,0,54,16,0,16,32,16,14,2,32,2,0,9,18,120,28,92,269,103,9,57,1,3,0,245,11,6,0,23,0,40,72,305,825
JHARKHAND,LATEHAR,2008,31,16,2,49,11,0,11,22,14,11,3,28,22,2,19,16,73,2,71,205,18,4,6,1,2,29,100,6,10,0,6,0,22,40,212,540
JHARKHAND,LOHARDAGGA,2008,22,3,2,27,16,0,16,32,18,4,14,36,14,1,19,22,88,25,63,232,49,5,16,0,8,4,110,2,2,0,7,0,11,28,237,563
JHARKHAND,PAKUR,2008,31,90,6,127,53,0,53,106,18,2,16,36,2,0,7,19,88,23,65,204,56,0,17,0,4,134,269,1,9,0,103,0,113,58,100,796
JHARKHAND,PALAMU,2008,102,174,6,282,30,0,30,60,57,31,26,114,20,0,41,80,188,34,154,517,143,13,37,0,0,0,268,18,1,0,32,0,51,75,1100,2117
JHARKHAND,RAMGARH,2008,44,14,1,59,11,0,11,22,20,18,2,40,18,1,29,33,288,75,213,657,90,8,35,0,5,131,269,5,6,0,13,0,24,0,315,1067
JHARKHAND,RANCHI,2008,209,72,10,291,62,0,62,124,117,62,55,234,49,17,112,155,1624,766,858,3581,138,43,133,0,14,495,1122,12,23,0,88,27,150,299,1106,4805
JHARKHAND,SAHEBGANJ,2008,42,47,4,93,61,0,61,122,35,22,13,70,4,1,9,24,134,31,103,306,37,5,12,1,6,98,182,4,14,0,19,0,37,23,264,844
JHARKHAND,SARAIKELA,2008,59,56,3,118,13,0,13,26,14,11,3,28,13,0,24,20,199,55,144,455,51,17,17,2,5,107,289,5,8,0,13,0,26,90,141,857
JHARKHAND,SIMDEGA,2008,75,11,4,90,26,0,26,52,12,7,5,24,7,2,19,17,54,8,46,153,18,0,6,0,3,0,27,0,0,0,1,0,1,0,123,378
KARNATAKA,BAGALKOT,2008,43,26,0,69,2,0,2,4,22,15,7,44,1,1,8,68,128,52,76,334,175,9,45,3,3,222,457,6,62,2,56,0,126,0,1166,2048
KARNATAKA,BANGALORE COMMR.,2008,253,297,8,558,54,0,54,108,159,2,157,318,88,203,702,1787,9681,5605,4076,22142,348,190,2025,49,10,2497,5245,52,179,1,307,0,539,126,10648,29664
KARNATAKA,BANGALORE RURAL,2008,102,54,0,156,14,0,14,28,22,7,15,44,29,0,49,185,527,244,283,1317,209,6,81,2,0,471,769,11,56,0,56,0,123,0,2549,4423
KARNATAKA,BELGAUM,2008,124,94,1,219,30,0,30,60,59,45,14,118,3,7,53,311,599,256,343,1572,460,19,223,7,27,1049,1821,9,180,9,233,0,431,36,3617,7150
KARNATAKA,BELLARY,2008,46,47,1,94,11,0,11,22,19,10,9,38,5,0,24,123,284,135,149,720,189,20,48,0,7,497,770,10,41,0,49,0,100,9,1834,3264
KARNATAKA,BIDAR,2008,28,36,1,65,7,0,7,14,23,17,6,46,3,0,24,147,203,57,146,580,135,12,37,1,15,899,1117,11,105,2,55,0,173,18,1601,3363
KARNATAKA,BIJAPUR,2008,83,73,0,156,19,0,19,38,23,17,6,46,6,5,19,146,151,75,76,478,313,15,55,0,20,592,995,1,83,0,135,0,219,0,1386,3125
KARNATAKA,CBPURA,2008,39,44,1,84,7,0,7,14,17,13,4,34,2,0,13,98,209,53,156,531,172,3,60,3,0,309,548,9,37,0,22,0,68,1,845,1891
KARNATAKA,CHAMARAJNAGAR,2008,36,20,1,57,4,0,4,8,7,3,4,14,4,0,10,76,128,31,97,346,85,0,22,2,0,423,532,4,29,0,35,0,68,0,632,1518
KARNATAKA,CHICKMAGALUR,2008,39,31,3,73,17,0,17,34,23,10,13,46,4,1,26,151,201,49,152,584,151,1,24,4,8,775,967,8,60,6,123,0,197,4,1441,3101
KARNATAKA,CHITRADURGA,2008,42,15,1,58,18,0,18,36,20,15,5,40,5,3,29,118,281,114,167,717,266,11,33,3,9,794,1116,6,82,0,49,0,137,0,2406,4191
KARNATAKA,DAKSHIN KANNADA,2008,29,45,2,76,10,0,10,20,10,6,4,20,5,0,38,187,256,145,111,742,266,3,91,6,19,508,907,5,53,4,51,0,113,14,2372,3974
KARNATAKA,DAVANAGERE,2008,26,18,1,45,10,0,10,20,35,31,4,70,3,2,16,138,268,103,165,695,213,14,53,1,0,468,752,9,60,5,102,0,176,3,1564,3009
KARNATAKA,DHARWAD COMMR.,2008,21,26,0,47,3,0,3,6,15,10,5,30,8,1,78,153,422,245,177,1084,90,7,135,5,8,168,422,1,16,1,44,0,62,9,1088,2299
KARNATAKA,DHARWAD RURAL,2008,22,25,0,47,1,0,1,2,6,0,6,12,3,0,7,23,49,12,37,131,72,6,10,1,1,127,217,3,16,0,23,0,42,0,692,1087
KARNATAKA,GADAG,2008,23,22,1,46,10,0,10,20,10,0,10,20,2,0,6,58,87,41,46,240,108,2,17,0,5,181,407,5,49,1,34,0,89,94,460,1175
KARNATAKA,GULBARGA,2008,104,104,3,211,25,0,25,50,47,31,16,94,10,2,74,236,297,119,178,916,429,14,71,3,59,1279,1877,7,75,0,169,0,251,22,2592,5622
KARNATAKA,HASSAN,2008,72,59,1,132,17,0,17,34,28,24,4,56,9,0,35,245,368,186,182,1025,152,4,53,2,0,1002,1213,8,76,0,79,1,164,0,2738,4949
KARNATAKA,HAVERI,2008,31,23,2,56,5,0,5,10,12,0,12,24,5,1,9,72,118,42,76,323,218,10,53,0,0,276,750,0,48,0,33,0,81,193,1213,2322
KARNATAKA,K.G.F.,2008,13,10,1,24,5,0,5,10,5,5,0,10,1,1,10,59,64,19,45,199,50,3,20,0,0,230,303,3,14,0,33,0,50,0,327,849
KARNATAKA,KODAGU,2008,22,33,2,57,20,0,20,40,6,5,1,12,2,0,9,110,105,13,92,331,40,1,20,2,3,529,598,2,27,1,41,0,71,3,752,1730
KARNATAKA,KOLAR,2008,37,22,23,82,14,0,14,28,15,11,4,30,6,2,14,73,213,64,149,521,172,4,16,1,0,310,508,14,22,0,21,0,57,5,1030,2014
KARNATAKA,KOPPAL,2008,22,4,6,32,6,0,6,12,12,12,0,24,2,0,11,74,107,38,69,301,121,4,44,2,2,174,347,4,26,0,39,0,69,0,1063,1723
KARNATAKA,MANDYA,2008,50,41,1,92,18,0,18,36,14,13,1,28,8,2,18,212,362,169,193,964,270,6,28,4,0,872,1180,11,59,0,72,0,142,0,2699,4747
KARNATAKA,MYSORE COMMR.,2008,26,30,2,58,23,0,23,46,30,22,8,60,1,6,92,194,630,416,214,1553,88,10,92,1,0,297,488,4,28,0,151,0,183,0,1381,3086
KARNATAKA,MYSORE RURAL,2008,54,51,1,106,13,0,13,26,14,7,7,28,8,0,14,220,228,49,179,698,177,7,28,2,0,753,967,15,68,0,97,0,180,0,1423,3173
KARNATAKA,RAICHUR,2008,53,34,2,89,19,0,19,38,21,21,0,42,3,2,20,72,137,54,83,371,207,9,65,3,8,553,855,7,86,0,106,0,199,10,1577,2994
KARNATAKA,RAILWAYS,2008,13,6,0,19,0,0,0,0,2,0,2,4,3,2,28,0,301,7,294,635,13,0,2,2,0,15,32,0,1,0,0,0,1,0,59,447
KARNATAKA,RAMANAGAR,2008,92,60,7,159,17,0,17,34,19,8,11,38,11,3,41,199,409,183,226,1072,227,3,34,1,11,562,838,14,62,0,37,0,113,0,2275,4084
KARNATAKA,SHIMOGA,2008,45,45,3,93,14,0,14,28,27,23,4,54,5,0,65,263,326,138,188,985,211,8,59,1,12,1009,1301,3,101,5,207,0,316,1,2380,4790
KARNATAKA,TUMKUR,2008,69,55,1,125,12,0,12,24,18,10,8,36,17,2,41,244,453,129,324,1210,245,8,70,4,25,694,1063,16,90,0,80,0,186,17,2652,4813
KARNATAKA,UDUPI,2008,21,10,2,33,11,0,11,22,7,3,4,14,4,1,19,127,133,76,57,417,84,2,25,2,5,267,392,0,17,0,15,0,32,7,1576,2335
KARNATAKA,UTTAR KANNADA,2008,18,15,3,36,10,0,10,20,11,9,2,22,4,1,13,89,95,41,54,297,57,13,30,1,8,357,466,1,46,7,84,0,138,0,1717,2580
KERALA,ALAPUZHA,2008,8,37,8,53,16,0,16,32,20,16,4,40,11,0,59,234,348,112,236,1000,470,32,242,1,14,1308,2067,2,224,22,247,0,495,0,5070,8373
KERALA,ERNAKULAM COMMR.,2008,9,11,3,23,12,0,12,24,12,7,5,24,1,0,31,114,313,95,218,772,141,15,225,1,3,355,740,1,59,5,88,0,153,0,6562,7961
KERALA,ERNAKULAM RURAL,2008,36,31,19,86,35,0,35,70,13,9,4,26,12,10,74,232,451,148,303,1230,428,26,144,7,25,1176,1808,3,134,24,175,0,336,2,6102,9159
KERALA,IDUKKI,2008,15,28,1,44,28,0,28,56,15,12,3,30,6,0,16,186,268,60,208,744,202,13,113,3,7,1428,1766,0,131,3,193,0,327,0,2267,4923
KERALA,KANNUR,2008,26,38,5,69,33,0,33,66,13,7,6,26,3,5,73,275,210,96,114,776,872,16,164,1,56,1168,2285,1,111,13,276,0,401,8,2534,5901
KERALA,KASARGOD,2008,19,23,2,44,28,0,28,56,15,6,9,30,4,3,21,160,178,76,102,544,502,13,164,2,28,889,1598,1,92,6,202,0,301,0,1233,3585
KERALA,KOLLAM,2008,26,21,8,55,61,0,61,122,23,20,3,46,5,39,49,258,474,199,275,1299,474,16,189,3,22,1896,2602,2,273,11,442,0,728,2,4423,8717
KERALA,KOTTAYAM,2008,26,16,5,47,31,0,31,62,16,11,5,32,2,0,75,275,404,103,301,1160,359,77,353,5,8,1576,2380,0,221,32,193,0,446,2,4332,8008
KERALA,KOZHIKODE COMMR.,2008,6,16,1,23,15,0,15,30,12,4,8,24,9,17,100,214,295,129,166,930,410,20,169,1,10,578,1190,3,72,10,165,0,250,2,2041,4166
KERALA,KOZHIKODE RURAL,2008,15,17,2,34,39,0,39,78,7,6,1,14,3,7,24,231,254,74,180,773,784,7,139,0,60,1257,2251,2,151,29,288,0,470,4,2109,5429
KERALA,MALAPPURAM,2008,29,27,9,65,51,0,51,102,13,7,6,26,3,30,47,467,480,189,291,1507,618,28,245,3,19,878,1791,2,149,28,525,0,704,0,3768,7419
KERALA,PALAKKAD,2008,34,19,0,53,42,0,42,84,15,8,7,30,5,11,39,188,273,132,141,789,526,62,198,4,29,1176,1996,4,133,4,296,0,437,1,2498,5557
KERALA,PATHANAMTHITTA,2008,17,18,4,39,32,0,32,64,10,8,2,20,2,0,24,155,209,64,145,599,358,9,120,2,23,1100,1615,0,168,12,173,0,353,3,2904,5343
KERALA,RAILWAYS,2008,1,0,0,1,1,0,1,2,0,0,0,0,1,6,1,1,148,0,148,305,1,1,3,1,0,24,30,0,7,3,0,0,10,0,10,209
KERALA,THRISSUR,2008,38,64,12,114,46,0,46,92,17,12,5,34,10,31,61,202,453,144,309,1210,708,21,526,2,41,1029,2333,2,214,29,332,0,577,6,6159,10003
KERALA,TRIVANDRUM COMMR.,2008,10,22,2,34,20,0,20,40,18,6,12,36,1,87,57,233,494,211,283,1366,426,52,330,3,12,716,1542,1,128,7,115,0,251,3,2279,5016
KERALA,TRIVANDRUM RURAL,2008,35,38,9,82,43,0,43,86,25,20,5,50,10,19,52,332,445,122,323,1303,538,16,235,6,27,1914,2738,7,404,9,314,0,734,2,3868,8348
KERALA,WAYANADU,2008,12,8,5,25,35,0,35,70,9,7,2,18,3,2,13,125,121,27,94,385,240,11,100,1,5,710,1069,0,74,11,114,0,199,2,902,2503
MADHYA PRADESH,ALIRAJPUR,2008,59,40,2,101,41,0,41,82,14,14,0,28,1,0,3,42,86,29,57,218,21,1,4,0,12,298,395,1,37,1,7,0,46,59,496,1225
MADHYA PRADESH,ANUPPUR,2008,32,11,2,45,42,0,42,84,4,2,2,8,2,0,14,78,83,32,51,260,13,1,14,2,8,298,346,4,53,1,23,0,81,10,549,1244
MADHYA PRADESH,ASHOK NAGAR,2008,18,20,9,47,47,0,47,94,3,3,0,6,1,1,8,112,142,38,104,406,31,8,17,1,6,799,937,16,107,8,35,0,166,75,577,2041
MADHYA PRADESH,BALAGHAT,2008,56,21,4,81,61,0,61,122,8,6,2,16,1,3,18,100,199,41,158,520,46,8,5,2,10,423,607,8,131,11,38,0,188,113,1293,2559
MADHYA PRADESH,BARWANI,2008,32,21,1,54,39,0,39,78,6,4,2,12,0,1,11,76,218,71,147,524,25,3,10,0,10,332,518,1,81,3,6,0,91,138,893,1907
MADHYA PRADESH,BETUL,2008,57,33,2,92,121,0,121,242,26,22,4,52,0,0,29,171,240,60,180,680,14,0,20,0,24,384,580,17,198,10,50,0,275,138,1707,3241
MADHYA PRADESH,BHIND,2008,54,74,6,134,27,0,27,54,13,9,4,26,6,1,93,155,223,86,137,701,67,6,31,0,13,625,909,30,60,1,38,0,129,167,1481,3171
MADHYA PRADESH,BHOPAL,2008,60,86,15,161,113,0,113,226,42,36,6,84,3,5,227,987,2572,1348,1224,6366,133,31,125,6,35,1642,2276,28,207,39,157,0,431,304,7901,14718
MADHYA PRADESH,BHOPAL RLY.,2008,2,4,1,7,2,0,2,4,3,2,1,6,1,0,7,8,938,15,923,1892,8,0,3,1,0,1,16,1,7,3,3,0,14,3,331,1327
MADHYA PRADESH,BURHANPUR,2008,19,15,0,34,14,0,14,28,2,2,0,4,34,2,6,44,119,30,89,324,59,4,9,0,11,86,211,3,55,0,30,0,88,42,830,1384
MADHYA PRADESH,CHHATARPUR,2008,52,62,4,118,57,0,57,114,26,14,12,52,2,2,59,407,351,73,278,1172,35,14,42,2,31,549,775,22,194,20,58,0,294,102,2837,4928
MADHYA PRADESH,CHHINDWARA,2008,76,23,5,104,120,0,120,240,13,11,2,26,0,0,10,157,293,77,216,753,50,10,31,0,22,1344,1625,17,185,22,121,0,345,168,1922,4589
MADHYA PRADESH,DAMOH,2008,58,47,0,105,46,0,46,92,13,12,1,26,0,4,25,136,149,67,82,463,13,3,16,6,19,1325,1462,15,126,0,47,0,188,80,776,2904
MADHYA PRADESH,DATIYA,2008,44,51,0,95,25,0,25,50,17,11,6,34,0,3,53,110,157,35,122,480,29,1,10,0,9,454,568,17,63,0,32,0,112,65,1248,2388
MADHYA PRADESH,DEWAS,2008,45,73,1,119,73,0,73,146,18,14,4,36,1,5,29,192,638,215,423,1503,76,14,63,0,41,507,872,10,191,42,150,0,393,171,3253,5593
MADHYA PRADESH,DHAR,2008,80,94,6,180,100,0,100,200,29,27,2,58,13,10,28,203,513,242,271,1280,110,24,22,0,27,634,1064,37,185,11,69,0,302,247,2947,5389
MADHYA PRADESH,DINDORI,2008,19,3,5,27,20,0,20,40,1,1,0,2,1,0,4,23,27,7,20,82,5,9,5,0,4,175,252,2,33,1,4,0,40,54,355,750
MADHYA PRADESH,GUNA,2008,53,29,13,95,72,0,72,144,14,13,1,28,3,9,16,123,261,89,172,673,70,16,25,0,8,767,1026,9,134,16,25,0,184,140,1313,3116
MADHYA PRADESH,GWALIOR,2008,98,120,23,241,42,0,42,84,62,47,15,124,10,9,161,928,1897,1285,612,4902,121,39,97,2,31,1287,1808,24,126,17,139,0,306,231,3640,9104
MADHYA PRADESH,HARDA,2008,20,24,0,44,18,0,18,36,9,7,2,18,0,0,13,106,117,48,69,353,16,0,0,0,0,449,465,6,42,39,0,0,87,0,346,1205
MADHYA PRADESH,HOSHANGABAD,2008,52,41,0,93,64,0,64,128,19,14,5,38,2,1,32,180,427,163,264,1069,21,6,10,0,14,498,549,16,130,19,44,0,209,0,1986,3562
MADHYA PRADESH,INDORE,2008,125,197,2,324,122,0,122,244,61,46,15,122,7,8,354,1227,4660,3340,1320,10916,223,43,102,5,55,1588,2442,35,343,63,369,0,810,426,9572,19587
MADHYA PRADESH,INDORE RLY.,2008,3,2,0,5,3,0,3,6,0,0,0,0,0,0,8,1,189,0,189,387,2,0,3,0,0,10,15,1,5,1,0,0,7,0,109,337
MADHYA PRADESH,JABALPUR,2008,69,111,6,186,127,0,127,254,52,40,12,104,1,5,148,458,1065,156,909,2742,123,15,96,8,16,2223,2638,42,288,67,146,0,543,157,5634,10857
MADHYA PRADESH,JABALPUR RLY.,2008,4,2,3,9,1,0,1,2,1,1,0,2,3,0,5,5,218,4,214,449,2,0,5,0,0,6,13,0,7,1,0,0,8,0,102,365
MADHYA PRADESH,JHABUA,2008,19,20,4,43,31,0,31,62,18,18,0,36,5,0,16,47,113,59,54,294,22,4,7,0,15,314,362,4,32,0,9,0,45,0,827,1507
MADHYA PRADESH,KATNI,2008,33,26,4,63,48,0,48,96,7,5,2,14,0,0,14,117,217,94,123,565,30,7,32,1,7,1219,1415,18,97,7,57,0,179,119,904,2964
MADHYA PRADESH,KHANDWA,2008,36,35,0,71,52,0,52,104,12,10,2,24,4,0,18,234,317,102,215,890,53,6,9,0,8,43,210,5,154,27,37,0,223,91,2103,3244
MADHYA PRADESH,KHARGON,2008,49,45,2,96,65,0,65,130,8,8,0,16,2,1,23,164,596,155,441,1382,97,13,17,0,16,279,549,23,154,23,42,0,242,127,2398,4144
MADHYA PRADESH,MANDLA,2008,34,16,0,50,47,0,47,94,3,2,1,6,1,0,4,78,59,14,45,201,4,0,10,0,2,347,437,4,87,14,25,0,130,74,1113,1922
MADHYA PRADESH,MANDSAUR,2008,45,32,0,77,40,0,40,80,19,15,4,38,6,3,36,120,332,66,266,829,54,33,13,1,21,259,525,15,128,4,56,0,203,144,1999,3360
MADHYA PRADESH,MORENA,2008,59,75,2,136,26,0,26,52,35,21,14,70,5,5,74,182,490,272,218,1246,115,2,23,1,5,1914,2188,32,73,1,73,0,179,128,1742,5062
MADHYA PRADESH,NARSINGHPUR,2008,48,41,5,94,61,0,61,122,5,2,3,10,0,0,26,104,197,76,121,524,22,2,21,0,18,993,1171,14,100,16,44,0,174,115,633,2465
MADHYA PRADESH,NEEMUCH,2008,24,14,2,40,19,0,19,38,12,3,9,24,0,4,9,134,274,102,172,695,73,47,25,1,7,645,873,0,45,14,28,0,87,75,630,2082
MADHYA PRADESH,PANNA,2008,34,17,0,51,28,0,28,56,7,6,1,14,0,0,14,148,86,22,64,334,3,1,6,0,9,303,384,17,77,0,26,0,120,62,866,1704
MADHYA PRADESH,RAISEN,2008,42,42,0,84,67,0,67,134,24,17,7,48,0,1,17,93,223,53,170,557,34,0,2,0,6,373,570,19,150,0,35,0,204,155,2072,3355
MADHYA PRADESH,RAJGARH,2008,38,63,1,102,83,0,83,166,28,22,6,56,2,3,19,115,323,88,235,785,98,11,18,0,50,336,651,10,166,36,136,0,348,138,3001,4675
MADHYA PRADESH,RATLAM,2008,43,44,0,87,63,0,63,126,16,14,2,32,2,1,29,112,290,92,198,724,42,63,26,0,24,365,632,11,105,11,57,0,184,112,2072,3488
MADHYA PRADESH,REWA,2008,52,42,0,94,82,0,82,164,27,26,1,54,0,1,56,509,606,232,374,1778,65,19,54,0,24,873,1225,26,124,7,67,0,224,190,2355,5179
MADHYA PRADESH,SAGAR,2008,83,90,0,173,119,0,119,238,31,28,3,62,2,6,61,421,551,203,348,1592,101,6,26,0,47,3032,3412,37,349,38,154,0,578,200,2815,8169
MADHYA PRADESH,SATNA,2008,62,50,2,114,102,0,102,204,20,15,5,40,5,6,64,418,577,275,302,1647,40,9,22,2,23,982,1337,32,207,9,137,0,385,259,2770,5798
MADHYA PRADESH,SEONI,2008,41,23,1,65,61,0,61,122,16,14,2,32,0,0,7,110,109,35,74,335,32,4,18,0,5,295,471,7,103,14,21,0,145,117,1567,2551
MADHYA PRADESH,SHAHDOL,2008,31,12,4,47,47,0,47,94,13,13,0,26,2,0,36,219,200,49,151,657,17,6,21,0,11,237,292,16,139,9,57,0,221,0,1882,2959
MADHYA PRADESH,SHAJAPUR,2008,27,44,4,75,57,0,57,114,16,13,3,32,4,5,44,167,464,128,336,1148,59,15,25,0,34,1289,1540,12,161,34,77,0,284,118,1155,3811
MADHYA PRADESH,SHEOPUR,2008,9,19,0,28,13,0,13,26,10,5,5,20,0,0,17,32,59,16,43,167,38,1,21,1,6,498,594,0,32,2,19,0,53,29,433,1239
MADHYA PRADESH,SHIVPURI,2008,74,47,2,123,64,0,64,128,31,24,7,62,4,6,46,205,257,88,169,775,58,12,16,0,37,1093,1387,16,128,3,53,0,200,171,1781,4104
MADHYA PRADESH,SIDHI,2008,30,12,0,42,37,0,37,74,17,17,0,34,0,1,20,172,170,18,152,533,51,1,13,0,5,380,547,18,83,5,30,0,136,97,1225,2367
MADHYA PRADESH,SIHORE,2008,28,47,1,76,57,0,57,114,20,18,2,40,7,4,18,136,332,92,240,829,41,4,26,0,21,389,627,8,89,16,57,0,170,146,1956,3403
MADHYA PRADESH,SINGRAULI,2008,26,17,2,45,40,0,40,80,13,12,1,26,2,1,5,131,171,21,150,481,25,3,10,0,5,344,464,22,87,1,27,0,137,77,1093,2102
MADHYA PRADESH,TIKAMGARH,2008,46,28,3,77,35,0,35,70,13,10,3,26,4,0,30,145,160,46,114,499,55,8,13,0,28,750,940,25,107,2,36,0,170,86,1461,3035
MADHYA PRADESH,UJJAIN,2008,60,122,3,185,78,0,78,156,32,25,7,64,9,5,147,415,1154,437,717,2884,158,22,76,5,34,1142,1611,23,215,37,158,0,433,174,4695,8764
MADHYA PRADESH,UMARIYA,2008,22,10,50,82,25,0,25,50,6,2,4,12,0,0,4,72,95,30,65,266,14,3,10,0,9,163,203,5,60,7,13,0,85,4,687,1259
MADHYA PRADESH,VIDISHA,2008,40,45,2,87,93,0,93,186,14,13,1,28,2,2,19,243,379,117,262,1024,54,12,43,0,15,783,1017,24,205,25,63,0,317,110,2180,4353
MAHARASHTRA,AHMEDNAGAR,2008,134,107,1,242,49,0,49,98,51,33,18,102,55,5,117,558,1472,506,966,3679,553,41,226,19,49,727,2238,0,125,4,537,0,666,623,1617,7070
MAHARASHTRA,AKOLA,2008,54,72,2,128,26,0,26,52,35,33,2,70,8,3,54,249,1002,119,883,2318,157,24,102,7,38,723,1167,7,111,61,153,0,332,116,1128,4132
MAHARASHTRA,AMRAVATI COMMR.,2008,18,30,1,49,22,0,22,44,10,9,1,20,4,1,35,228,633,133,500,1534,89,26,50,8,4,358,613,4,41,10,85,0,140,78,704,2439
MAHARASHTRA,AMRAVATI RURAL,2008,75,27,3,105,47,0,47,94,18,18,0,36,10,1,33,238,1003,76,927,2288,119,24,35,1,58,829,1260,3,137,33,146,0,319,194,1116,4150
MAHARASHTRA,AURANGABAD COMMR.,2008,39,38,0,77,21,0,21,42,38,30,8,76,2,11,71,245,975,355,620,2279,241,25,128,3,11,473,1012,4,51,16,138,0,209,131,791,3452
MAHARASHTRA,AURANGABAD RURAL,2008,56,36,2,94,21,0,21,42,11,7,4,22,21,7,50,215,487,109,378,1267,285,13,53,1,36,764,1412,39,65,9,226,0,339,260,690,3347
MAHARASHTRA,BEED,2008,61,34,4,99,26,0,26,52,39,22,17,78,45,8,85,336,617,188,429,1708,485,25,75,1,52,1010,1918,11,92,11,332,0,446,270,881,4500
MAHARASHTRA,BHANDARA,2008,28,14,3,45,26,0,26,52,14,13,1,28,7,1,19,218,617,76,541,1479,107,17,102,5,29,384,790,0,69,18,73,0,160,146,948,2845
MAHARASHTRA,BULDHANA,2008,54,47,1,102,36,0,36,72,28,25,3,56,23,1,44,266,851,119,732,2036,262,43,60,3,68,798,1451,9,153,39,250,0,451,217,1241,4494
MAHARASHTRA,CHANDRAPUR,2008,51,47,6,104,37,0,37,74,34,28,6,68,5,5,37,257,920,133,787,2144,145,30,55,4,64,666,1220,14,112,146,221,0,493,256,1344,4456
MAHARASHTRA,DHULE,2008,54,38,1,93,10,0,10,20,8,8,0,16,64,3,19,215,384,123,261,1069,226,9,75,3,14,391,973,3,32,8,196,0,239,255,775,2783
MAHARASHTRA,GADCHIROLI,2008,56,33,1,90,22,0,22,44,13,11,2,26,4,1,11,88,123,17,106,350,23,17,12,2,56,211,402,2,30,7,46,0,85,81,356,1195
MAHARASHTRA,GONDIA,2008,35,14,0,49,38,0,38,76,14,13,1,28,3,0,18,177,355,86,269,908,61,17,45,2,35,350,631,3,84,25,58,0,170,121,568,2023
MAHARASHTRA,HINGOLI,2008,43,29,3,75,17,0,17,34,10,9,1,20,13,1,34,82,166,27,139,462,143,4,33,0,21,407,718,7,54,6,99,0,166,110,469,1751
MAHARASHTRA,JALGAON,2008,83,57,0,140,42,0,42,84,29,19,10,58,19,1,47,214,777,162,615,1835,304,72,228,3,27,677,1678,18,107,29,456,0,610,367,1344,4901
MAHARASHTRA,JALNA,2008,58,33,0,91,16,0,16,32,13,10,3,26,15,6,56,169,346,84,262,938,196,13,114,0,26,531,1037,27,53,7,309,0,396,157,687,2832
MAHARASHTRA,KOLHAPUR,2008,59,26,2,87,34,0,34,68,30,18,12,60,33,2,47,289,943,335,608,2257,302,99,232,4,21,585,1582,17,76,13,153,0,259,339,1092,4398
MAHARASHTRA,LATUR,2008,74,28,0,102,22,0,22,44,29,29,0,58,16,1,46,235,503,158,345,1304,261,15,75,4,47,839,1463,77,74,0,187,0,338,222,926,3681
MAHARASHTRA,MUMBAI COMMR.,2008,210,132,0,342,218,0,218,436,189,116,73,378,35,27,328,2846,12972,4068,8904,29180,377,481,2025,124,22,4155,7893,11,436,121,502,0,1070,709,6850,32770
MAHARASHTRA,MUMBAI RLY.,2008,8,1,0,9,4,0,4,8,8,2,6,16,5,1,36,0,1938,0,1938,3918,24,7,29,2,0,46,108,1,12,0,0,0,13,0,100,2222
MAHARASHTRA,NAGPUR COMMR.,2008,100,57,4,161,53,0,53,106,43,28,15,86,14,41,321,941,2062,871,1191,5441,258,77,336,21,16,773,1750,7,91,71,237,0,406,269,2869,8661
MAHARASHTRA,NAGPUR RLY.,2008,5,7,0,12,1,0,1,2,3,2,1,6,10,1,17,1,1010,13,997,2049,19,1,8,10,0,27,66,0,8,2,0,0,10,1,116,1247
MAHARASHTRA,NAGPUR RURAL,2008,77,45,5,127,37,0,37,74,24,20,4,48,11,1,37,236,891,118,773,2067,138,37,66,5,43,691,1451,7,89,32,95,0,223,471,1529,4567
MAHARASHTRA,NANDED,2008,88,57,5,150,23,0,23,46,29,22,7,58,32,2,64,345,477,143,334,1397,311,17,117,2,41,1133,1834,8,77,6,252,0,343,213,1479,4778
MAHARASHTRA,NANDURBAR,2008,30,14,1,45,11,0,11,22,10,8,2,20,3,1,21,49,224,69,155,522,111,11,35,1,5,259,552,1,21,7,93,0,122,130,463,1501
MAHARASHTRA,NASIK COMMR.,2008,43,31,0,74,14,0,14,28,34,21,13,68,22,2,78,523,1353,668,685,3331,186,28,166,11,10,276,970,5,42,10,141,0,198,293,545,3813
MAHARASHTRA,NASIK RURAL,2008,90,55,1,146,36,0,36,72,33,17,16,66,32,5,36,175,559,156,403,1366,374,56,113,11,11,761,1886,5,61,24,287,0,377,560,1195,4480
MAHARASHTRA,NAVI MUMBAI,2008,61,39,0,100,12,0,12,24,26,14,12,52,20,20,118,430,1722,918,804,4032,194,58,199,8,5,443,1283,1,31,11,72,0,115,376,840,4686
MAHARASHTRA,OSMANABAD,2008,53,25,1,79,22,0,22,44,22,19,3,44,37,0,28,174,395,100,295,1029,171,23,136,0,33,546,1132,2,80,7,183,0,272,223,911,3072
MAHARASHTRA,PARBHANI,2008,49,37,4,90,12,0,12,24,17,11,6,34,22,2,71,228,355,101,254,1033,201,13,56,2,31,969,1401,15,56,6,204,0,281,129,288,2767
MAHARASHTRA,PUNE COMMR.,2008,137,141,5,283,92,0,92,184,110,80,30,220,37,39,379,1395,5509,3262,2247,12868,530,82,600,30,21,1328,3233,7,113,73,273,0,466,642,2924,14467
MAHARASHTRA,PUNE RLY.,2008,2,2,0,4,1,0,1,2,1,1,0,2,4,0,10,1,378,0,378,771,7,0,5,1,0,5,19,1,3,0,0,0,4,1,33,455
MAHARASHTRA,PUNE RURAL,2008,146,77,26,249,66,0,66,132,46,30,16,92,34,15,89,588,1400,696,704,3526,357,59,191,7,23,874,2538,13,104,30,189,0,336,1027,1822,7183
MAHARASHTRA,RAIGAD,2008,43,31,3,77,17,0,17,34,6,5,1,12,15,2,14,112,320,68,252,783,143,27,59,12,2,253,817,5,33,10,41,0,89,321,592,2061
MAHARASHTRA,RATNAGIRI,2008,18,15,1,34,26,0,26,52,15,12,3,30,4,1,10,118,236,45,191,605,91,27,61,1,27,196,555,0,33,27,55,0,115,152,447,1561
MAHARASHTRA,SANGLI,2008,46,27,6,79,42,0,42,84,21,13,8,42,5,5,25,217,615,217,398,1482,176,19,166,4,28,385,1094,12,67,14,140,0,233,316,573,2909
MAHARASHTRA,SATARA,2008,60,27,6,93,30,0,30,60,21,14,7,42,24,5,73,404,1099,351,748,2704,252,62,134,11,32,482,1400,3,66,26,164,0,259,427,1226,4634
MAHARASHTRA,SINDHUDURG,2008,6,7,1,14,8,0,8,16,2,2,0,4,0,0,4,85,120,18,102,329,36,10,23,1,15,121,279,0,34,15,14,0,63,73,220,795
MAHARASHTRA,SOLAPUR COMMR.,2008,17,15,1,33,24,0,24,48,12,8,4,24,3,3,32,119,464,212,252,1085,57,11,97,4,2,192,460,0,17,3,66,0,86,97,448,1684
MAHARASHTRA,SOLAPUR RURAL,2008,88,59,0,147,63,0,63,126,48,37,11,96,27,7,82,290,682,190,492,1770,303,30,90,7,53,686,1620,9,101,0,241,0,351,451,1403,4720
MAHARASHTRA,THANE COMMR.,2008,99,76,2,177,74,0,74,148,103,72,31,206,20,19,132,1210,2514,1157,1357,6409,381,121,592,39,20,1393,2936,12,149,46,384,0,591,390,1703,9479
MAHARASHTRA,THANE RURAL,2008,147,39,1,187,71,0,71,142,50,36,14,100,30,11,70,602,1101,396,705,2915,310,48,159,9,37,841,2113,7,128,24,134,0,293,709,1264,5792
MAHARASHTRA,WARDHA,2008,36,27,3,66,26,0,26,52,26,22,4,52,6,1,42,258,841,77,764,1989,158,23,62,4,74,808,1305,5,128,36,116,0,285,176,1513,4369
MAHARASHTRA,WASHIM,2008,30,29,0,59,20,0,20,40,22,18,4,44,8,1,36,119,469,50,419,1102,117,18,33,4,25,421,711,2,59,18,110,0,189,93,588,2222
MAHARASHTRA,YAVATMAL,2008,74,55,5,134,43,0,43,86,34,33,1,68,4,4,55,259,980,130,850,2282,147,20,38,4,56,955,1500,6,114,30,171,0,321,280,1565,4899
MANIPUR,BISHNUPUR,2008,16,43,0,59,3,0,3,6,14,11,3,28,0,23,0,9,35,9,26,102,6,0,13,1,2,37,59,0,16,0,4,0,20,0,105,327
MANIPUR,CHANDEL,2008,13,10,0,23,0,0,0,0,2,0,2,4,0,2,0,2,3,0,3,10,0,0,1,0,4,20,25,0,0,0,0,0,0,0,17,74
MANIPUR,CHURACHANDPUR,2008,18,5,1,24,2,0,2,4,5,0,5,10,0,2,0,9,14,6,8,39,0,0,6,1,2,2,11,0,0,0,0,0,0,0,64,131
MANIPUR,CID,2008,0,0,0,0,0,0,0,0,0,0,0,0,0,0,0,0,0,0,0,0,0,1,1,0,0,0,2,0,0,0,0,0,0,0,0,2
MANIPUR,IMPHAL EAST,2008,30,103,1,134,9,0,9,18,43,24,19,86,0,78,1,15,78,25,53,250,4,5,39,0,4,59,111,0,14,0,5,0,19,0,237,725
MANIPUR,IMPHAL WEST,2008,42,192,2,236,12,0,12,24,60,31,29,120,0,55,0,27,219,138,81,520,18,17,38,1,15,86,176,1,22,0,7,0,30,1,376,1191
MANIPUR,SENAPATI,2008,14,6,0,20,2,0,2,4,6,0,6,12,0,12,3,4,23,2,21,65,6,0,0,0,1,10,18,0,0,0,0,0,0,1,51,139
MANIPUR,TAMENGLONG,2008,3,3,0,6,0,0,0,0,2,0,2,4,0,2,0,0,4,1,3,10,1,0,0,0,0,2,3,0,0,0,0,0,0,0,10,27
MANIPUR,THOUBAL,2008,46,126,0,172,9,0,9,18,44,21,23,88,1,35,3,8,62,42,20,171,11,1,46,0,10,81,149,0,5,0,12,0,17,0,148,648
MANIPUR,UKHRUL,2008,5,10,0,15,1,0,1,2,0,0,0,0,0,3,0,2,8,0,8,21,2,0,17,0,3,4,26,0,0,0,0,0,0,0,30,85
MEGHALAYA,GARO HILLS EAST,2008,10,5,3,18,1,0,1,2,10,2,8,20,8,0,3,10,27,6,21,75,2,0,1,1,0,10,14,0,1,0,0,0,1,0,38,130
MEGHALAYA,GARO HILLS SOUTH,2008,4,1,0,5,2,0,2,4,2,0,2,4,5,0,1,1,12,0,12,31,0,0,1,0,0,0,1,0,0,0,0,0,0,0,8,37
MEGHALAYA,GARO HILLS WEST,2008,16,20,1,37,10,0,10,20,9,4,5,18,11,0,14,29,142,25,117,338,5,3,13,5,13,75,130,0,21,3,13,0,37,16,114,533
MEGHALAYA,JAINTIA HILLS,2008,38,5,0,43,18,0,18,36,7,4,3,14,5,0,11,23,86,26,60,211,0,9,10,2,5,40,83,0,7,0,0,0,7,17,56,339
MEGHALAYA,KHASI HILLS EAST,2008,30,16,2,48,34,0,34,68,19,10,9,38,9,0,29,96,307,66,241,748,0,15,72,2,8,57,185,2,14,1,19,0,36,31,133,896
MEGHALAYA,KHASI HILLS WEST,2008,13,7,0,20,16,0,16,32,5,3,2,10,21,0,3,8,24,2,22,80,1,5,1,0,0,10,17,0,2,0,0,0,2,0,38,154
MEGHALAYA,RI-BHOI,2008,15,1,0,16,7,0,7,14,4,2,2,8,4,0,4,1,71,12,59,151,0,0,6,0,2,12,20,0,9,0,0,0,9,0,93,229
MIZORAM,AIZAWL,2008,12,7,4,23,39,0,39,78,1,0,1,2,0,0,3,157,393,22,371,946,1,23,36,11,4,42,147,0,36,0,4,0,40,30,173,976
MIZORAM,CHAMPHAI,2008,4,1,0,5,7,0,7,14,1,0,1,2,0,0,0,27,72,0,72,171,0,3,4,0,1,10,21,0,5,0,0,0,5,3,13,151
MIZORAM,KOLASIB,2008,2,1,1,4,9,0,9,18,4,1,3,8,3,0,1,34,84,0,84,206,0,1,3,1,1,10,23,0,11,0,1,0,12,7,43,217
MIZORAM,LAWNGTLAI,2008,3,1,0,4,8,0,8,16,0,0,0,0,0,0,0,18,32,0,32,82,0,0,6,2,1,11,20,0,2,0,0,0,2,0,63,147
MIZORAM,LUNGLEI,2008,8,0,0,8,8,0,8,16,2,0,2,4,0,0,2,53,100,4,96,255,0,5,6,1,8,17,45,0,13,0,0,0,13,8,34,265
MIZORAM,MAMIT,2008,1,0,1,2,2,0,2,4,1,0,1,2,1,0,0,17,17,0,17,52,0,1,1,0,2,5,12,0,3,0,0,0,3,3,7,62
MIZORAM,SAIHA,2008,2,0,0,2,0,0,0,0,0,0,0,0,0,0,0,13,18,0,18,49,0,0,1,0,1,13,15,0,1,0,0,0,1,0,29,78
MIZORAM,SERCHHIP,2008,3,0,0,3,4,0,4,8,0,0,0,0,0,0,0,19,31,1,30,81,0,1,0,0,0,10,13,0,7,0,0,0,7,2,16,93
NAGALAND,DIMAPUR,2008,64,13,1,78,6,0,6,12,31,5,26,62,2,0,66,66,182,135,47,498,0,12,15,0,6,8,71,0,11,0,2,0,13,30,43,558
NAGALAND,KIPHIRE,2008,4,0,0,4,0,0,0,0,0,0,0,0,0,0,0,0,6,0,6,12,0,0,0,0,0,0,0,0,0,0,0,0,0,0,11,21
NAGALAND,KOHIMA,2008,27,7,1,35,6,0,6,12,5,0,5,10,2,0,11,22,43,33,10,121,0,3,7,3,0,9,22,0,1,0,2,0,3,0,32,181
NAGALAND,LONGLENG,2008,0,2,0,2,0,0,0,0,0,0,0,0,0,0,1,2,0,0,0,3,0,0,1,0,0,0,1,0,0,0,0,0,0,0,3,9
NAGALAND,MOKOKCHUNG,2008,15,3,8,26,1,0,1,2,3,0,3,6,0,0,2,12,16,6,10,46,2,0,2,1,1,4,18,0,0,0,0,0,0,8,4,82
NAGALAND,MON,2008,12,5,2,19,1,0,1,2,0,0,0,0,0,0,2,4,23,2,21,52,0,0,2,0,0,2,5,0,1,0,0,0,1,1,29,84
NAGALAND,PEREN,2008,4,2,0,6,1,0,1,2,0,0,0,0,0,0,1,3,4,1,3,12,0,0,0,0,0,1,2,0,0,0,0,0,0,1,1,18
NAGALAND,PHEK,2008,9,8,1,18,2,0,2,4,1,0,1,2,1,0,0,2,8,0,8,19,0,0,1,0,0,4,5,0,1,0,0,0,1,0,17,55
NAGALAND,TUENSANG,2008,3,0,0,3,1,0,1,2,0,0,0,0,0,0,2,5,2,0,2,11,0,0,0,0,1,0,1,0,0,0,0,0,0,0,22,36
NAGALAND,WOKHA,2008,5,5,0,10,0,0,0,0,4,2,2,8,1,0,1,0,42,2,40,86,2,1,2,0,6,10,25,0,1,1,0,0,2,4,10,95
NAGALAND,ZUNHEBOTO,2008,0,2,0,2,1,0,1,2,0,0,0,0,0,0,1,11,19,3,16,50,0,0,1,0,0,8,9,0,0,0,0,0,0,0,20,63
ODISHA,ANGUL,2008,53,64,0,117,47,0,47,94,49,41,8,98,17,4,62,129,380,67,313,972,149,9,24,0,27,21,400,16,186,11,61,0,274,170,1064,2543
ODISHA,BALASORE,2008,31,44,1,76,50,0,50,100,47,44,3,94,12,4,37,201,321,84,237,896,34,47,53,3,29,1258,1427,27,76,24,217,0,344,3,284,2803
ODISHA,BARAGARH,2008,35,77,0,112,29,0,29,58,8,7,1,16,4,1,29,78,150,25,125,412,100,4,39,0,17,68,366,9,64,6,14,0,93,138,643,1513
ODISHA,BERHAMPUR,2008,12,51,0,63,23,0,23,46,22,16,6,44,4,6,29,77,128,46,82,372,45,11,33,1,20,190,371,4,90,9,9,0,112,71,224,1059
ODISHA,BHADRAK,2008,34,20,13,67,58,0,58,116,46,39,7,92,8,0,23,68,107,18,89,313,36,10,46,3,18,34,207,16,73,27,106,0,222,60,1272,2078
ODISHA,BOLANGIR,2008,30,41,0,71,34,0,34,68,24,19,5,48,7,0,33,98,161,41,120,460,98,9,50,1,16,149,397,12,132,8,18,0,170,74,839,1834
ODISHA,BOUDH,2008,10,8,0,18,5,0,5,10,2,2,0,4,1,0,2,16,23,2,21,65,41,8,1,0,19,180,249,3,61,3,9,0,76,0,71,463
ODISHA,CUTTACK,2008,26,38,0,64,35,0,35,70,35,34,1,70,7,0,44,117,199,27,172,566,37,8,43,1,22,66,448,31,16,3,124,0,174,271,1178,2301
ODISHA,DCP BBSR,2008,51,58,2,111,36,0,36,72,45,24,21,90,14,10,106,334,1216,578,638,2896,68,13,243,4,12,768,1272,23,61,7,38,0,129,164,783,4056
ODISHA,DCP CTC,2008,14,21,51,86,18,0,18,36,21,17,4,42,15,8,66,138,581,248,333,1389,27,7,51,0,4,55,413,15,18,3,55,0,91,269,475,1912
ODISHA,DEOGARH,2008,16,47,0,63,13,0,13,26,8,6,2,16,4,0,10,21,37,3,34,109,26,3,8,0,9,193,281,5,96,3,36,0,140,42,109,686
ODISHA,DHENKANAL,2008,50,54,1,105,26,0,26,52,24,20,4,48,11,0,47,80,155,28,127,448,91,5,41,0,21,66,314,19,187,9,31,0,246,90,824,1832
ODISHA,GAJAPATI,2008,14,15,0,29,8,0,8,16,4,3,1,8,5,0,3,22,15,4,11,60,78,4,6,1,43,82,237,2,52,6,3,0,63,23,95,481
ODISHA,GANJAM,2008,68,142,2,212,48,0,48,96,45,33,12,90,14,9,61,163,141,36,105,529,133,25,27,0,34,432,784,13,259,16,12,0,300,133,349,2126
ODISHA,JAGATSINGHPUR,2008,24,9,0,33,25,0,25,50,29,27,2,58,4,1,29,78,154,26,128,420,33,7,44,0,9,123,365,20,22,0,51,0,93,149,573,1384
ODISHA,JAJPUR,2008,74,66,0,140,36,0,36,72,64,62,2,128,11,0,47,91,243,61,182,635,55,22,39,0,8,835,1060,40,98,15,109,0,262,101,266,2220
ODISHA,JHARSUGUDA,2008,27,29,7,63,12,0,12,24,12,8,4,24,14,1,44,102,288,76,212,737,59,11,16,0,15,346,552,6,67,8,35,0,116,105,327,1531
ODISHA,KALAHANDI,2008,24,15,0,39,38,0,38,76,29,29,0,58,6,0,29,55,71,16,55,232,95,8,39,0,13,185,401,3,82,5,27,0,117,61,575,1360
ODISHA,KANDHAMAL,2008,27,30,0,57,46,0,46,92,15,11,4,30,4,0,16,60,45,1,44,170,759,4,82,2,374,25,1246,3,70,2,39,0,114,0,27,1630
ODISHA,KENDRAPARA,2008,53,8,0,61,30,0,30,60,31,31,0,62,15,2,41,74,103,22,81,338,39,1,21,0,11,4,80,32,8,1,93,0,134,4,828,1399
ODISHA,KEONJHAR,2008,91,152,0,243,66,0,66,132,58,46,12,116,14,0,87,78,280,81,199,739,92,30,33,1,18,27,672,22,203,27,34,0,286,471,516,2300
ODISHA,KHURDA,2008,19,11,0,30,25,0,25,50,33,33,0,66,11,0,35,86,132,20,112,396,26,3,11,0,6,0,46,0,14,1,0,0,15,0,967,1380
ODISHA,KORAPUT,2008,51,52,3,106,47,0,47,94,28,27,1,56,14,0,35,71,135,23,112,390,98,6,24,0,8,9,229,3,113,7,45,0,168,84,636,1469
ODISHA,MALKANGIR,2008,46,34,1,81,12,0,12,24,8,7,1,16,4,0,5,12,46,11,35,113,20,2,5,0,7,50,106,0,33,5,10,0,48,22,62,384
ODISHA,MAYURBHANJ,2008,83,65,0,148,90,0,90,180,51,45,6,102,10,0,32,97,252,32,220,643,24,16,44,3,14,462,718,27,200,23,58,0,308,155,742,2448
ODISHA,NAYAGARH,2008,33,8,0,41,34,0,34,68,25,21,4,50,12,1,27,57,100,12,88,297,35,6,20,1,13,432,514,10,7,5,85,0,107,7,196,1114
ODISHA,NOWRANGPUR,2008,26,29,0,55,26,0,26,52,21,19,2,42,5,0,10,37,83,23,60,218,53,4,6,1,6,45,139,0,79,16,32,0,127,24,337,840
ODISHA,NUAPADA,2008,11,8,0,19,14,0,14,28,17,11,6,34,2,0,7,42,70,10,60,191,30,7,8,0,7,20,102,2,59,4,37,0,102,30,345,720
ODISHA,PURI,2008,25,33,0,58,37,0,37,74,31,18,13,62,11,0,125,173,398,95,303,1105,83,3,53,0,15,51,475,13,24,7,87,0,131,270,1491,2930
ODISHA,RAYAGADA,2008,24,10,3,37,19,0,19,38,14,10,4,28,8,0,11,39,72,5,67,202,58,9,19,1,22,0,245,6,54,1,23,0,84,136,186,715
ODISHA,ROURKELA,2008,54,39,0,93,38,0,38,76,23,19,4,46,2,11,65,117,316,82,234,827,38,11,57,1,3,338,538,5,98,5,66,0,174,90,870,2247
ODISHA,SAMBALPUR,2008,49,55,0,104,33,0,33,66,13,12,1,26,20,6,72,172,327,67,260,924,95,10,37,1,14,210,506,6,82,4,39,0,131,139,993,2377
ODISHA,SONEPUR,2008,7,28,0,35,15,0,15,30,3,3,0,6,1,0,5,31,71,5,66,179,23,3,6,0,3,14,76,1,24,2,8,0,35,27,183,455
ODISHA,SRP(CUTTACK),2008,2,3,0,5,1,0,1,2,4,1,3,8,1,1,14,8,320,55,265,664,0,1,4,0,0,32,37,0,6,0,0,0,6,0,107,504
ODISHA,SRP(ROURKELA),2008,8,2,0,10,1,0,1,2,2,2,0,4,0,0,9,13,136,25,111,294,3,2,1,0,0,2,16,0,3,1,1,0,5,8,112,304
ODISHA,SUNDARGARH,2008,48,49,0,97,38,0,38,76,17,15,2,34,13,2,48,65,163,20,143,454,40,13,10,1,12,241,461,7,65,8,6,0,86,144,367,1357
PUNJAB,AMRITSAR,2008,46,71,9,126,15,0,15,30,54,44,10,108,1,25,21,142,466,211,255,1121,0,20,321,6,5,245,696,6,25,11,66,0,108,99,673,2327
PUNJAB,AMRITSAR RURAL,2008,29,39,2,70,10,0,10,20,23,17,6,46,1,4,2,40,68,9,59,183,0,4,94,3,6,107,275,6,5,2,27,0,40,61,160,693
PUNJAB,BARNALA,2008,24,33,2,59,12,0,12,24,7,6,1,14,1,1,4,43,60,11,49,169,0,7,49,2,1,149,274,1,11,0,10,0,22,66,222,705
PUNJAB,BATALA,2008,13,12,5,30,20,0,20,40,19,13,6,38,2,1,2,67,92,28,64,256,0,1,113,1,0,203,376,6,9,0,46,0,61,58,133,803
PUNJAB,BHATINDA,2008,44,63,6,113,20,0,20,40,44,28,16,88,1,6,15,253,431,214,217,1137,1,12,134,5,14,275,442,4,29,5,39,0,77,1,804,2206
PUNJAB,FARIDKOT,2008,17,20,2,39,15,0,15,30,13,10,3,26,1,0,3,65,140,60,80,349,0,4,73,1,3,183,265,1,9,0,16,0,26,1,328,895
PUNJAB,FATEHGARH SAHIB,2008,17,11,3,31,13,0,13,26,16,9,7,32,0,2,2,62,161,42,119,388,0,11,91,0,0,151,392,0,5,1,31,0,37,139,282,998
PUNJAB,FEROZPUR,2008,56,68,3,127,30,0,30,60,30,22,8,60,0,4,6,127,320,162,158,777,0,15,169,6,8,461,779,8,29,0,39,0,76,120,493,1992
PUNJAB,G.R.P,2008,11,2,2,15,1,0,1,2,0,0,0,0,1,0,1,0,45,10,35,92,0,0,15,1,0,32,48,4,2,0,0,0,6,0,284,401
PUNJAB,GURDASPUR,2008,20,21,37,78,24,0,24,48,25,21,4,50,0,0,0,45,142,47,95,329,0,9,49,3,0,107,327,9,15,0,28,0,52,159,245,938
PUNJAB,HOSHIARPUR,2008,33,49,4,86,35,0,35,70,22,17,5,44,2,1,7,90,181,55,126,462,0,7,124,3,6,356,678,13,21,0,73,0,107,182,320,1529
PUNJAB,JALANDHAR,2008,72,105,7,184,51,0,51,102,110,83,27,220,2,12,15,306,745,303,442,1825,0,18,401,12,10,594,1255,10,52,0,133,0,195,220,1011,3886
PUNJAB,KAPURTHALA,2008,23,70,5,98,24,0,24,48,23,14,9,46,5,15,17,125,289,50,239,740,0,4,160,1,1,214,483,4,19,0,27,0,50,103,340,1469
PUNJAB,KHANNA,2008,21,16,4,41,12,0,12,24,19,12,7,38,6,1,6,80,177,60,117,447,0,3,94,3,0,135,438,7,5,0,28,0,40,203,269,1089
PUNJAB,LUDHIANA,2008,73,69,10,152,46,0,46,92,115,78,37,230,5,21,17,217,577,300,277,1414,0,23,278,4,2,292,876,10,36,21,92,0,159,277,963,3148
PUNJAB,LUDHIANA RURAL,2008,16,20,4,40,14,0,14,28,21,12,9,42,0,4,2,53,120,36,84,299,0,9,46,2,0,131,248,4,4,5,19,0,32,60,255,789
PUNJAB,MANSA,2008,31,42,6,79,13,0,13,26,11,9,2,22,1,2,3,62,78,28,50,224,0,9,41,0,1,225,276,3,6,0,12,0,21,0,278,824
PUNJAB,MOGA,2008,27,29,9,65,19,0,19,38,24,17,7,48,1,2,7,75,136,46,90,357,0,17,106,5,4,313,530,3,19,0,22,0,44,85,203,1106
PUNJAB,MUKTSAR,2008,25,42,1,68,12,0,12,24,12,8,4,24,0,0,2,75,115,37,78,307,0,9,41,0,3,172,289,3,6,0,19,0,28,64,183,784
PUNJAB,PATIALA,2008,42,49,5,96,35,0,35,70,44,37,7,88,1,8,1,210,373,197,176,966,0,11,180,3,3,391,871,13,17,0,116,0,146,283,812,2597
PUNJAB,ROPAR,2008,9,14,1,24,10,0,10,20,11,9,2,22,0,0,7,78,109,43,66,303,0,5,85,0,6,91,323,2,18,1,27,0,48,136,276,886
PUNJAB,SANGRUR,2008,42,53,6,101,34,0,34,68,23,13,10,46,6,9,13,136,231,80,151,626,0,12,105,2,2,247,526,4,15,3,62,0,84,158,673,1836
PUNJAB,SAS NGR,2008,26,10,4,40,20,0,20,40,28,18,10,56,1,3,3,176,353,119,234,889,0,9,190,0,0,135,531,3,0,0,0,0,3,197,526,1684
PUNJAB,SBS NAGAR,2008,20,12,4,36,14,0,14,28,7,3,4,14,0,0,9,49,74,22,52,206,0,6,109,0,0,210,413,2,9,0,28,0,39,88,155,796
PUNJAB,TARN TARAN,2008,32,36,5,73,18,0,18,36,17,14,3,34,2,1,2,45,80,12,68,210,0,11,124,15,0,178,413,2,22,0,24,0,48,85,234,933
RAJASTHAN,AJMER,2008,47,36,0,83,45,0,45,90,102,84,18,204,2,0,31,256,701,303,398,1691,32,13,650,6,11,267,1396,17,108,0,516,0,641,417,3082,6339
RAJASTHAN,ALWAR,2008,101,59,8,168,88,0,88,176,142,91,51,284,0,13,38,233,1272,665,607,2828,22,28,649,0,32,2583,3754,38,134,0,429,0,601,440,2026,8335
RAJASTHAN,BANSWARA,2008,33,18,2,53,42,0,42,84,50,45,5,100,0,1,10,53,108,28,80,280,111,3,68,0,31,780,1088,8,66,1,85,0,160,95,745,2310
RAJASTHAN,BARAN,2008,37,109,2,148,52,0,52,104,45,45,0,90,4,3,13,102,285,60,225,692,9,29,157,2,14,471,796,10,169,0,181,0,360,114,1224,3032
RAJASTHAN,BARMER,2008,18,23,0,41,20,0,20,40,24,21,3,48,0,0,6,99,181,64,117,467,6,7,208,3,23,505,930,14,82,0,116,0,212,178,1336,2849
RAJASTHAN,BHARATPUR,2008,63,53,0,116,74,0,74,148,100,75,25,200,5,14,34,58,882,368,514,1875,5,16,528,4,20,673,1458,24,39,0,371,0,434,212,4028,7203
RAJASTHAN,BHILWARA,2008,37,35,0,72,42,0,42,84,68,58,10,136,1,0,45,212,711,333,378,1680,32,26,398,1,18,46,804,13,77,0,370,0,460,283,2393,4808
RAJASTHAN,BIKANER,2008,38,70,0,108,48,0,48,96,29,28,1,58,2,0,16,113,367,117,250,865,0,14,390,0,16,561,1233,12,74,0,306,0,392,252,1746,4054
RAJASTHAN,BUNDI,2008,17,67,4,88,33,0,33,66,70,52,18,140,0,0,8,80,243,97,146,574,24,9,144,0,14,763,1084,3,98,0,224,0,325,130,1170,3101
RAJASTHAN,CHITTORGARH,2008,36,20,0,56,40,0,40,80,104,80,24,208,1,6,21,162,502,184,318,1194,71,18,239,0,43,1209,1806,6,73,1,402,0,482,226,1353,4533
RAJASTHAN,CHURU,2008,16,39,0,55,37,0,37,74,43,22,21,86,1,0,4,93,205,50,155,508,2,1,269,0,10,536,979,16,16,0,212,0,244,161,1098,2759
RAJASTHAN,DAUSA,2008,33,32,2,67,21,0,21,42,61,48,13,122,0,3,18,112,820,431,389,1773,50,9,266,0,14,192,784,9,34,0,100,0,143,253,2574,4603
RAJASTHAN,DHOLPUR,2008,51,77,3,131,21,0,21,42,64,46,18,128,3,3,20,51,425,149,276,927,12,9,123,3,9,1457,1738,19,9,0,127,0,155,125,1005,3616
RAJASTHAN,DUNGARPUR,2008,23,15,0,38,26,0,26,52,50,48,2,100,1,0,15,45,79,18,61,219,100,12,48,0,23,164,463,11,66,0,94,0,171,116,1145,2033
RAJASTHAN,G.R.P.,2008,4,4,0,8,2,0,2,4,4,1,3,8,1,1,6,1,368,27,341,745,3,2,9,2,1,3,21,1,17,0,0,0,18,1,315,745
RAJASTHAN,GANGANAGAR,2008,39,71,2,112,70,0,70,140,66,43,23,132,0,2,7,181,347,89,258,884,21,25,564,1,10,1027,1789,16,59,2,276,0,353,141,1705,4632
RAJASTHAN,HANUMANGARH,2008,55,82,1,138,33,0,33,66,35,29,6,70,0,2,6,88,201,62,139,498,0,13,401,0,11,415,984,17,68,0,232,0,317,144,1550,3354
RAJASTHAN,JAIPUR EAST,2008,15,27,2,44,20,0,20,40,64,61,3,128,2,2,110,290,2532,1835,697,5468,126,35,571,9,10,8,975,6,54,2,140,0,202,216,2214,6455
RAJASTHAN,JAIPUR NORTH,2008,14,37,1,52,25,0,25,50,69,69,0,138,2,1,26,121,745,437,308,1640,56,31,475,0,6,417,1113,5,26,0,149,0,180,128,1183,3517
RAJASTHAN,JAIPUR RURAL,2008,66,32,1,99,35,0,35,70,110,82,28,220,9,2,19,236,1137,458,679,2540,71,53,791,2,32,654,2264,11,108,5,205,0,329,661,4811,9051
RAJASTHAN,JAIPUR SOUTH,2008,17,25,0,42,15,0,15,30,52,44,8,104,2,7,46,276,1539,1006,533,3409,61,154,966,2,7,372,1730,9,26,0,162,0,197,168,1529,5435
RAJASTHAN,JAISALMER,2008,6,1,0,7,4,0,4,8,11,6,5,22,0,0,4,47,114,15,99,279,17,4,73,2,7,192,340,10,19,0,24,0,53,45,413,993
RAJASTHAN,JALORE,2008,24,19,1,44,13,0,13,26,27,17,10,54,0,0,9,63,149,41,108,370,18,12,136,4,28,66,388,8,50,0,106,0,164,124,1615,2472
RAJASTHAN,JHALAWAR,2008,58,99,0,157,44,0,44,88,66,44,22,132,5,4,15,117,395,155,240,931,78,13,132,1,26,683,1075,6,144,2,262,0,414,142,1076,3368
RAJASTHAN,JHUNJHUNU,2008,34,20,0,54,40,0,40,80,44,35,9,88,0,2,3,109,404,76,328,922,36,14,350,2,18,856,1433,22,32,0,240,0,294,157,1476,3859
RAJASTHAN,JODHPUR CITY,2008,13,56,3,72,19,0,19,38,43,35,8,86,1,1,32,141,759,511,248,1693,22,23,460,1,5,561,1184,10,25,1,212,0,248,112,716,3216
RAJASTHAN,JODHPUR RURAL,2008,14,34,0,48,32,0,32,64,31,21,10,62,4,0,12,95,251,55,196,613,8,4,146,0,16,1113,1517,17,47,0,81,0,145,230,894,3029
RAJASTHAN,KARAULI,2008,39,34,0,73,33,0,33,66,64,32,32,128,6,0,19,23,566,257,309,1180,11,20,156,1,12,23,293,11,27,0,99,0,137,70,2557,3771
RAJASTHAN,KOTA CITY,2008,36,132,6,174,24,0,24,48,66,55,11,132,4,3,75,166,946,703,243,2140,2,23,363,1,9,97,613,10,40,1,307,0,358,118,1479,3908
RAJASTHAN,KOTA RURAL,2008,33,41,4,78,34,0,34,68,30,26,4,60,1,0,17,66,190,70,120,464,5,14,112,0,10,284,516,4,76,0,201,0,281,91,706,1919
RAJASTHAN,NAGAUR,2008,36,42,1,79,33,0,33,66,64,48,16,128,0,0,14,158,367,120,247,906,1,18,304,0,16,195,748,18,142,0,257,0,417,214,1895,3775
RAJASTHAN,PALI,2008,33,24,1,58,43,0,43,86,96,79,17,192,0,0,9,169,335,128,207,848,12,16,305,2,8,41,667,13,116,1,323,0,453,283,2874,4704
RAJASTHAN,PRATAPGARH,2008,20,24,1,45,49,0,49,98,54,52,2,108,0,0,5,35,130,25,105,300,35,3,69,0,12,502,686,2,51,0,138,0,191,65,652,1847
RAJASTHAN,RAJSAMAND,2008,17,7,0,24,12,0,12,24,48,34,14,96,1,1,12,76,166,55,111,422,26,10,100,1,9,577,872,0,35,0,195,0,230,149,717,2159
RAJASTHAN,SAWAI MADHOPUR,2008,25,31,0,56,16,0,16,32,50,39,11,100,0,3,17,86,466,295,171,1038,6,3,212,0,2,5,310,6,29,0,144,0,179,82,2252,3435
RAJASTHAN,SIKAR,2008,43,28,2,73,40,0,40,80,48,38,10,96,3,0,11,152,417,128,289,1000,27,8,406,0,24,321,1078,15,18,0,217,0,250,292,2130,4202
RAJASTHAN,SIROHI,2008,26,21,3,50,17,0,17,34,40,36,4,80,0,1,13,79,140,38,102,373,39,16,142,0,13,367,734,5,66,0,110,0,181,157,579,1834
RAJASTHAN,TONK,2008,15,28,1,44,22,0,22,44,50,46,4,100,0,0,8,104,314,152,162,740,86,8,186,1,9,880,1343,6,41,3,206,0,256,173,1062,3203
RAJASTHAN,UDAIPUR,2008,65,77,3,145,91,0,91,182,174,148,26,348,3,2,55,188,652,252,400,1552,147,21,531,0,36,1251,2343,11,159,0,294,0,464,357,2599,6716
SIKKIM,EAST,2008,5,5,1,11,5,0,5,10,2,2,0,4,1,0,1,40,69,5,64,180,1,6,39,0,12,36,111,0,5,0,3,0,8,17,103,351
SIKKIM,NORTH,2008,1,2,0,3,1,0,1,2,0,0,0,0,0,0,0,2,7,0,7,16,1,0,2,0,0,7,14,0,1,0,0,0,1,4,13,41
SIKKIM,SOUTH,2008,1,0,2,3,9,0,9,18,1,1,0,2,0,0,6,29,26,2,24,87,8,0,1,0,6,30,55,0,10,0,0,0,10,10,56,195
SIKKIM,WEST,2008,2,0,0,2,5,0,5,10,1,1,0,2,0,0,0,10,25,2,23,60,7,0,4,0,5,27,52,0,3,0,2,0,5,9,43,143
TAMIL NADU,CHENNAI,2008,100,130,0,230,35,0,35,70,43,32,11,86,5,0,41,322,1545,269,1276,3458,55,5,293,135,0,726,1827,25,46,67,165,0,303,613,7478,11829
TAMIL NADU,CHENNAI RLY.,2008,0,5,0,5,0,0,0,0,1,1,0,2,0,0,17,1,250,8,242,518,9,0,1,0,0,24,36,0,5,0,0,0,5,2,224,539
TAMIL NADU,CHENNAISUBURBAN,2008,74,76,0,150,21,0,21,42,29,24,5,58,0,0,16,228,563,117,446,1370,48,7,66,2,1,437,808,28,42,42,41,0,153,247,1489,3457
TAMIL NADU,COIMBATORE RURAL,2008,88,77,0,165,14,0,14,28,63,46,17,126,16,0,48,278,1278,603,675,2898,210,17,111,4,30,952,2332,8,107,8,115,0,238,1008,6566,10998
TAMIL NADU,COIMBATORE URBAN,2008,20,28,0,48,9,0,9,18,17,7,10,34,1,0,11,78,621,166,455,1332,24,11,93,168,4,240,847,6,29,7,62,0,104,307,2444,4180
TAMIL NADU,CUDDALORE,2008,63,71,0,134,16,0,16,32,56,52,4,112,3,0,16,89,456,131,325,1020,176,0,16,0,17,653,1290,1,29,80,50,0,160,428,4289,6509
TAMIL NADU,DHARMAPURI,2008,49,57,8,114,12,0,12,24,49,36,13,98,3,0,42,57,203,69,134,508,215,1,26,8,29,1582,2114,2,136,3,43,0,184,253,1918,4696
TAMIL NADU,DINDIGUL,2008,56,71,0,127,13,0,13,26,53,53,0,106,0,0,10,85,401,74,327,897,88,3,103,13,18,415,1037,3,47,13,99,0,162,397,2739,4627
TAMIL NADU,ERODE,2008,60,43,0,103,21,0,21,42,57,45,12,114,6,1,27,172,664,103,561,1534,44,12,51,7,20,652,1452,1,78,16,30,0,125,666,5378,8006
TAMIL NADU,KANCHIPURAM,2008,75,76,0,151,24,0,24,48,18,18,0,36,2,0,7,109,370,76,294,858,76,0,21,26,17,427,1355,7,20,2,8,0,37,788,4843,6916
TAMIL NADU,KANYAKUMARI,2008,29,58,1,88,8,0,8,16,42,42,0,84,5,1,18,160,397,56,341,978,1,14,158,9,37,670,1110,6,27,70,71,0,174,221,2732,4735
TAMIL NADU,KARUR,2008,21,16,0,37,4,0,4,8,13,12,1,26,2,0,11,23,329,141,188,694,23,6,15,14,3,152,462,4,10,3,13,0,30,249,1553,2464
TAMIL NADU,KRISHNAGIRI,2008,54,65,0,119,20,0,20,40,44,36,8,88,8,35,36,87,300,143,157,766,185,10,37,12,23,807,1547,2,40,5,21,0,68,473,2816,5080
TAMIL NADU,MADURAI RURAL,2008,55,79,0,134,18,0,18,36,32,24,8,64,2,0,14,77,282,23,259,657,187,11,88,0,23,544,1244,9,72,1,75,0,157,391,2831,4791
TAMIL NADU,MADURAI URBAN,2008,39,38,0,77,4,0,4,8,24,14,10,48,1,0,8,65,532,174,358,1138,19,3,117,26,5,91,400,5,11,2,42,0,60,139,1299,2470
TAMIL NADU,NAGAPATTINAM,2008,47,64,1,112,10,0,10,20,28,24,4,56,1,1,2,49,232,66,166,517,41,1,18,2,15,367,623,4,59,1,8,0,72,179,3003,4133
TAMIL NADU,NAMAKKAL,2008,46,34,0,80,19,0,19,38,49,37,12,98,7,2,29,75,302,95,207,717,88,0,79,14,11,568,1078,5,49,24,25,0,103,318,2881,4625
TAMIL NADU,NILGIRIS,2008,6,10,0,16,4,0,4,8,4,4,0,8,0,0,6,86,103,16,87,298,25,4,9,4,0,223,322,1,20,0,9,0,30,57,800,1371
TAMIL NADU,PERAMBALUR,2008,29,50,0,79,26,0,26,52,31,29,2,62,1,0,2,41,327,145,182,698,49,1,41,5,9,267,586,7,70,9,6,0,92,214,1953,3138
TAMIL NADU,PUDUKOTTAI,2008,37,42,2,81,4,0,4,8,34,31,3,68,0,0,3,53,179,35,144,414,38,9,35,1,13,253,606,8,45,2,39,0,94,257,1978,3032
TAMIL NADU,RAMNATHAPURAM,2008,45,95,0,140,6,0,6,12,28,16,12,56,4,0,20,82,223,31,192,552,62,2,43,8,13,401,695,2,34,1,12,0,49,166,1660,2907
TAMIL NADU,SALEM RURAL,2008,69,103,2,174,35,0,35,70,112,101,11,224,5,2,19,101,347,60,287,821,346,5,35,6,41,2341,3222,3,217,0,94,0,314,448,3050,7381
TAMIL NADU,SALEM URBAN,2008,29,40,0,69,22,0,22,44,32,27,5,64,1,0,18,45,263,132,131,590,40,12,71,11,1,378,646,7,16,11,33,0,67,133,1150,2313
TAMIL NADU,SIVAGANGAI,2008,34,47,2,83,1,0,1,2,43,35,8,86,2,0,18,103,264,62,202,651,41,9,91,6,17,295,657,4,7,16,56,0,83,198,1634,2888
TAMIL NADU,THANJAVUR,2008,66,93,0,159,7,0,7,14,29,29,0,58,1,22,20,158,532,111,421,1265,68,2,27,0,30,809,1354,7,108,0,20,0,135,418,5003,7420
TAMIL NADU,THENI,2008,28,55,1,84,7,0,7,14,35,32,3,70,0,0,21,75,263,30,233,622,60,2,88,2,17,484,841,4,30,5,35,0,74,188,3592,4992
TAMIL NADU,THIRUNELVELI RURAL,2008,89,248,1,338,42,0,42,84,68,60,8,136,0,0,26,213,460,63,397,1159,4,7,93,5,59,1062,1548,3,115,0,97,0,215,318,4912,7822
TAMIL NADU,THIRUNELVELI URBAN,2008,20,45,0,65,8,0,8,16,16,12,4,32,1,0,15,41,239,47,192,535,4,0,27,0,1,112,231,2,7,49,7,0,65,87,893,1574
TAMIL NADU,THIRUVALLUR,2008,35,41,2,78,17,0,17,34,22,22,0,44,4,0,30,80,232,26,206,578,75,6,33,4,9,486,907,9,18,0,30,0,57,294,2689,4116
TAMIL NADU,THIRUVANNAMALAI,2008,32,65,0,97,20,0,20,40,34,34,0,68,3,0,6,95,289,82,207,682,117,0,53,11,32,675,1238,3,20,47,16,0,86,350,2757,4625
TAMIL NADU,THIRUVARUR,2008,26,36,0,62,6,0,6,12,14,12,2,28,4,0,9,53,123,14,109,312,34,2,27,3,18,1012,1201,1,51,2,3,0,57,105,1241,2770
TAMIL NADU,THOOTHUGUDI,2008,72,127,0,199,11,0,11,22,48,40,8,96,0,0,33,198,555,81,474,1341,2,16,115,8,10,498,929,4,3,343,64,0,414,280,3121,5508
TAMIL NADU,TRICHY RLY.,2008,1,1,0,2,0,0,0,0,0,0,0,0,0,0,1,0,38,1,37,77,0,0,2,0,0,4,10,0,0,0,0,0,0,4,47,98
TAMIL NADU,TRICHY RURAL,2008,55,27,0,82,11,0,11,22,28,26,2,56,0,0,6,53,261,84,177,581,25,0,16,1,8,177,545,5,16,0,28,0,49,318,2563,3598
TAMIL NADU,TRICHY URBAN,2008,13,30,2,45,2,0,2,4,10,4,6,20,1,1,6,59,444,84,360,955,10,0,54,7,2,68,282,5,7,37,25,0,74,141,2349,3273
TAMIL NADU,VELLORE,2008,74,33,4,111,21,0,21,42,53,52,1,106,2,0,8,139,422,153,269,993,14,6,58,57,26,621,1460,7,25,0,49,0,81,678,4753,7050
TAMIL NADU,VILLUPURAM,2008,82,78,2,162,58,0,58,116,64,50,14,128,6,1,20,98,311,108,203,747,249,10,38,1,30,608,1685,6,70,31,88,0,195,749,4031,6631
TAMIL NADU,VIRUDHUNAGAR,2008,41,73,0,114,17,0,17,34,52,41,11,104,3,0,22,121,419,43,376,984,59,37,100,19,21,448,930,3,19,77,69,0,168,246,2425,4271
TRIPURA,DHALAI,2008,20,3,0,23,32,0,32,64,18,7,11,36,3,0,14,24,39,4,35,119,18,2,3,1,6,73,112,2,22,0,34,0,58,9,94,417
TRIPURA,NORTH,2008,28,16,0,44,46,0,46,92,27,21,6,54,1,1,7,41,87,4,83,224,19,5,18,5,6,235,324,2,62,0,169,0,233,36,182,993
TRIPURA,SOUTH,2008,35,20,1,56,45,0,45,90,34,27,7,68,2,0,41,50,150,14,136,393,45,15,28,5,22,254,416,6,135,0,161,0,302,47,410,1506
TRIPURA,WEST,2008,72,14,1,87,81,0,81,162,67,55,12,134,7,2,33,103,223,21,202,591,115,20,43,12,13,362,668,6,127,4,371,0,508,103,641,2420
UTTAR PRADESH,AGRA,2008,109,133,40,282,42,0,42,84,229,183,46,458,17,2,61,208,1826,1233,593,3940,233,153,339,35,12,431,1794,77,123,109,479,0,788,591,1676,6925
UTTAR PRADESH,ALIGARH,2008,139,143,30,312,62,0,62,124,162,124,38,324,6,10,73,137,701,289,412,1628,176,104,241,8,18,311,1139,58,37,74,213,0,382,281,1085,4069
UTTAR PRADESH,ALLAHABAD,2008,143,89,33,265,49,0,49,98,144,124,20,288,3,3,62,245,763,416,347,1839,177,113,226,24,3,413,1320,68,91,55,259,0,473,364,1834,5161
UTTAR PRADESH,AMBEDKAR NAGAR,2008,33,19,12,64,18,0,18,36,51,45,6,102,1,0,13,27,131,33,98,303,23,28,70,0,1,184,340,13,20,20,133,0,186,34,209,1040
UTTAR PRADESH,AURAIYA,2008,26,20,11,57,11,0,11,22,29,27,2,58,4,0,10,6,94,40,54,208,17,18,17,0,7,81,387,12,7,14,36,0,69,247,155,822
UTTAR PRADESH,AZAMGARH,2008,74,37,21,132,24,0,24,48,60,56,4,120,3,0,30,62,179,60,119,453,57,31,74,3,0,258,431,35,17,35,86,0,173,8,666,1760
UTTAR PRADESH,BADAUN,2008,68,109,40,217,11,0,11,22,53,41,12,106,0,3,14,24,126,27,99,293,15,43,71,3,4,205,350,32,27,47,25,0,131,9,1183,2112
UTTAR PRADESH,BAGHPAT,2008,66,70,9,145,19,0,19,38,51,43,8,102,5,0,51,42,169,56,113,436,69,23,74,1,0,135,389,15,16,8,61,0,100,87,568,1539
UTTAR PRADESH,BAHRAICH,2008,46,39,18,103,24,0,24,48,64,62,2,128,5,4,17,61,130,42,88,347,32,33,22,9,10,138,340,27,24,22,37,0,110,96,359,1217
UTTAR PRADESH,BALLIA,2008,32,39,19,90,12,0,12,24,33,27,6,66,1,0,15,62,149,69,80,376,53,14,61,5,1,131,312,20,15,12,43,0,90,47,172,936
UTTAR PRADESH,BALRAMPUR,2008,15,11,6,32,12,0,12,24,21,20,1,42,0,1,3,13,48,20,28,113,10,9,14,2,0,23,71,5,12,10,13,0,40,13,110,351
UTTAR PRADESH,BANDA,2008,37,21,24,82,35,0,35,70,40,26,14,80,0,1,20,84,126,21,105,357,64,56,100,2,13,95,418,36,70,19,67,0,192,88,832,1830
UTTAR PRADESH,BARABANKI,2008,54,70,15,139,23,0,23,46,83,82,1,166,0,0,22,80,209,47,162,520,14,134,14,5,2,273,569,47,34,54,110,0,245,127,1616,2986
UTTAR PRADESH,BAREILLY,2008,130,162,45,337,46,0,46,92,155,121,34,310,15,0,48,147,622,258,364,1454,120,110,234,4,0,238,740,47,110,89,202,0,448,34,2664,5222
UTTAR PRADESH,BASTI,2008,26,22,13,61,7,0,7,14,18,18,0,36,0,2,7,29,82,32,50,202,26,32,109,3,0,117,359,15,5,15,24,0,59,72,375,999
UTTAR PRADESH,BIJNOR,2008,93,68,19,180,30,0,30,60,92,80,12,184,5,0,32,36,228,81,147,529,54,51,198,9,0,423,915,19,52,53,249,0,373,180,404,2295
UTTAR PRADESH,BULANDSHAHAR,2008,104,98,19,221,28,0,28,56,77,60,17,154,1,0,11,39,227,67,160,505,52,77,181,6,0,462,1077,29,51,74,151,0,305,299,1582,3568
UTTAR PRADESH,CHANDOLI,2008,24,27,5,56,4,0,4,8,11,9,2,22,0,0,8,53,116,56,60,293,8,35,70,2,0,165,347,19,10,19,91,0,139,67,395,1129
UTTAR PRADESH,CHITRAKOOT DHAM,2008,28,14,9,51,22,0,22,44,20,5,15,40,5,0,10,35,52,14,38,154,6,5,36,3,7,69,159,17,21,0,17,0,55,33,119,528
UTTAR PRADESH,DEORIA,2008,33,16,16,65,15,0,15,30,20,13,7,40,0,0,4,36,81,40,41,202,41,6,20,5,2,77,220,36,6,17,27,0,86,69,270,797
UTTAR PRADESH,ETAH,2008,64,82,20,166,20,0,20,40,80,66,14,160,3,0,23,53,249,103,146,577,46,36,94,4,9,166,530,34,41,17,71,0,163,175,697,1984
UTTAR PRADESH,ETAWAH,2008,70,72,12,154,19,0,19,38,89,64,25,178,12,0,27,72,341,211,130,793,15,54,103,2,0,240,593,28,43,29,108,0,208,179,893,2408
UTTAR PRADESH,FAIZABAD,2008,43,14,12,69,23,0,23,46,58,56,2,116,1,3,15,65,208,74,134,500,36,52,119,10,0,175,549,18,26,43,86,0,173,157,569,1733
UTTAR PRADESH,FATEHGARH,2008,65,60,19,144,23,0,23,46,61,41,20,122,4,0,13,44,145,55,90,351,22,21,39,5,0,270,379,26,35,56,84,0,201,22,419,1433
UTTAR PRADESH,FATEHPUR,2008,74,35,39,148,16,0,16,32,53,42,11,106,12,0,22,76,133,56,77,376,8,38,106,1,0,177,524,41,32,15,67,0,155,194,680,1819
UTTAR PRADESH,FIROZABAD,2008,121,139,20,280,27,0,27,54,114,78,36,228,14,0,41,67,442,242,200,1006,113,62,140,0,6,201,527,41,43,77,77,0,238,5,1259,3009
UTTAR PRADESH,G.R.P.,2008,14,16,8,38,2,0,2,4,11,8,3,22,18,7,40,4,1521,82,1439,3111,27,14,42,4,0,7,99,0,18,38,0,0,56,5,836,2632
UTTAR PRADESH,GAUTAMBUDH NAGAR,2008,65,63,16,144,22,0,22,44,70,49,21,140,0,0,42,84,1703,1081,622,3532,70,97,256,8,0,15,636,25,19,53,68,0,165,190,756,3622
UTTAR PRADESH,GHAZIABAD,2008,143,138,44,325,30,0,30,60,199,138,61,398,7,3,63,115,1141,733,408,2470,64,157,267,11,6,49,881,39,30,83,202,0,354,327,1770,4888
UTTAR PRADESH,GHAZIPUR,2008,41,36,28,105,6,0,6,12,25,22,3,50,12,0,57,39,120,47,73,348,121,15,58,11,4,105,318,33,17,15,64,0,129,4,248,1059
UTTAR PRADESH,GONDA,2008,49,53,20,122,27,0,27,54,54,44,10,108,8,0,19,59,142,58,84,370,44,34,116,2,2,243,526,43,39,10,12,0,104,85,334,1395
UTTAR PRADESH,GORAKHPUR,2008,76,38,39,153,46,0,46,92,150,117,33,300,1,2,49,152,480,294,186,1164,114,72,190,9,2,362,1008,43,30,43,216,0,332,259,519,2892
UTTAR PRADESH,HAMIRPUR,2008,23,8,21,52,9,0,9,18,21,19,2,42,0,0,0,13,23,5,18,59,9,21,22,0,0,17,126,13,13,5,10,0,41,57,165,450
UTTAR PRADESH,HARDOI,2008,71,53,18,142,42,0,42,84,64,60,4,128,3,0,18,38,176,33,143,411,30,24,54,0,3,280,612,50,67,30,68,0,215,221,804,2114
UTTAR PRADESH,HATHRAS,2008,58,40,24,122,17,0,17,34,62,37,25,124,8,0,43,33,192,60,132,468,37,41,79,2,0,138,429,27,43,18,92,0,180,132,361,1447
UTTAR PRADESH,J.P.NAGAR,2008,42,30,10,82,20,0,20,40,38,34,4,76,2,0,10,26,136,60,76,310,28,31,124,1,0,22,335,16,26,37,40,0,119,129,376,1144
UTTAR PRADESH,JALAUN,2008,43,12,14,69,6,0,6,12,34,30,4,68,1,6,16,25,74,43,31,196,7,12,46,6,5,0,172,37,34,24,47,0,142,96,561,1106
UTTAR PRADESH,JAUNPUR,2008,40,51,28,119,19,0,19,38,47,41,6,94,5,1,31,70,187,69,118,481,77,38,166,9,3,457,942,44,38,39,161,0,282,192,527,2230
UTTAR PRADESH,JHANSI,2008,33,21,23,77,7,0,7,14,25,18,7,50,0,0,10,41,134,66,68,319,10,30,61,4,1,34,179,26,24,46,11,0,107,39,431,1011
UTTAR PRADESH,KANNAUJ,2008,37,37,21,95,11,0,11,22,42,36,6,84,3,0,19,19,70,25,45,181,22,35,46,5,4,22,254,31,27,9,91,0,158,120,489,1160
UTTAR PRADESH,KANPUR DEHAT,2008,50,35,15,100,26,0,26,52,67,56,11,134,2,0,11,36,143,33,110,335,96,40,85,4,1,322,613,31,64,24,185,0,304,65,782,2084
UTTAR PRADESH,KANPUR NAGAR,2008,168,114,39,321,72,0,72,144,296,227,69,592,24,4,144,279,1293,821,472,3037,220,328,645,24,7,505,1856,86,136,578,632,0,1432,127,3164,8885
UTTAR PRADESH,KANSHIRAM NAGAR,2008,60,54,8,122,19,0,19,38,40,29,11,80,2,0,7,31,76,18,58,192,25,14,19,1,6,19,145,30,31,5,31,0,97,61,366,905
UTTAR PRADESH,KAUSHAMBI,2008,56,31,12,99,26,0,26,52,46,42,4,92,2,0,32,86,107,10,97,334,49,34,75,1,0,147,378,26,59,12,117,0,214,72,684,1674
UTTAR PRADESH,KHIRI,2008,79,77,35,191,58,0,58,116,95,91,4,190,2,1,22,63,309,131,178,706,54,29,119,10,5,353,764,48,74,29,88,0,239,194,1024,2768
UTTAR PRADESH,KUSHI NAGAR,2008,22,10,13,45,6,0,6,12,15,14,1,30,0,0,2,7,38,15,23,85,20,11,58,3,2,118,249,14,8,6,24,0,52,37,562,976
UTTAR PRADESH,LALITPUR,2008,22,4,10,36,16,0,16,32,12,9,3,24,0,0,3,24,56,13,43,139,20,4,32,1,1,7,90,10,11,14,40,0,75,25,183,495
UTTAR PRADESH,LUCKNOW,2008,130,160,32,322,82,0,82,164,389,331,58,778,17,1,147,804,3100,1548,1552,7169,441,589,1140,23,3,57,2743,62,226,340,778,0,1406,490,4696,13707
UTTAR PRADESH,MAHARAJGANJ,2008,24,4,9,37,17,0,17,34,26,26,0,52,0,0,11,16,40,13,27,107,23,15,48,6,0,60,221,14,12,14,37,0,77,69,362,807
UTTAR PRADESH,MAHOBA,2008,23,11,6,40,12,0,12,24,26,21,5,52,3,0,15,43,51,16,35,163,18,21,22,1,8,34,145,17,24,15,30,0,86,41,231,652
UTTAR PRADESH,MAINPURI,2008,100,98,16,214,9,0,9,18,88,65,23,176,22,0,35,60,236,121,115,589,57,48,144,1,1,202,602,38,20,9,40,0,107,149,834,2207
UTTAR PRADESH,MATHURA,2008,95,123,25,243,24,0,24,48,76,62,14,152,1,0,45,63,659,388,271,1427,102,95,252,5,0,159,1288,31,64,65,222,0,382,675,1130,3911
UTTAR PRADESH,MAU,2008,27,38,12,77,19,0,19,38,50,44,6,100,0,0,14,43,134,38,96,325,89,29,90,3,0,134,410,12,29,44,74,0,159,65,204,1110
UTTAR PRADESH,MEERUT,2008,166,160,25,351,50,0,50,100,178,123,55,356,3,0,111,125,965,504,461,2169,145,118,302,22,0,22,926,37,73,165,326,0,601,317,1715,5025
UTTAR PRADESH,MIRZAPUR,2008,51,15,16,82,19,0,19,38,23,19,4,46,4,1,19,50,173,68,105,420,12,34,90,1,0,124,349,24,16,6,133,0,179,88,395,1294
UTTAR PRADESH,MORADABAD,2008,126,118,42,286,75,0,75,150,179,163,16,358,6,3,60,166,783,315,468,1801,77,84,239,10,0,82,711,38,117,114,139,0,408,219,2416,5093
UTTAR PRADESH,MUZAFFARNAGAR,2008,168,175,50,393,40,0,40,80,135,112,23,270,12,2,76,91,613,253,360,1407,131,71,206,10,0,9,612,28,39,74,258,0,399,185,1519,3892
UTTAR PRADESH,PILIBHIT,2008,47,60,14,121,41,0,41,82,108,100,8,216,0,0,8,47,167,42,125,389,36,61,145,2,0,13,326,35,90,10,359,0,494,69,1158,2470
UTTAR PRADESH,PRATAPGARH,2008,48,64,27,139,33,0,33,66,92,83,9,184,5,1,34,111,220,71,149,591,137,90,106,4,16,262,751,32,52,18,155,0,257,136,840,2483
UTTAR PRADESH,RAIBAREILLY,2008,63,47,15,125,38,0,38,76,60,51,9,120,6,1,12,47,184,41,143,434,54,80,133,8,2,220,659,33,43,44,90,0,210,162,886,2228
UTTAR PRADESH,RAMPUR,2008,56,94,17,167,46,0,46,92,107,83,24,214,4,0,42,81,334,109,225,795,53,78,163,4,7,10,453,21,46,17,4,0,88,138,930,2252
UTTAR PRADESH,SAHARANPUR,2008,56,73,20,149,8,0,8,16,31,25,6,62,0,11,24,46,381,165,216,843,71,72,194,11,0,25,587,23,23,66,153,0,265,214,1235,2737
UTTAR PRADESH,SANT KABIRNAGAR,2008,12,17,6,35,9,0,9,18,40,40,0,80,0,0,10,31,63,23,40,167,11,25,47,3,2,131,287,7,5,18,12,0,42,68,306,823
UTTAR PRADESH,SHAHJAHANPUR,2008,114,143,31,288,68,0,68,136,121,94,27,242,3,0,28,50,227,61,166,535,33,66,118,2,2,181,631,68,80,25,10,0,183,229,1041,2640
UTTAR PRADESH,SHRAWASTI,2008,20,13,9,42,6,0,6,12,16,15,1,32,0,0,5,26,44,6,38,119,8,5,22,0,0,54,136,6,13,2,4,0,25,47,90,390
UTTAR PRADESH,SIDHARTHNAGAR,2008,19,11,19,49,12,0,12,24,32,30,2,64,3,0,4,33,105,53,52,250,21,17,15,3,0,63,152,16,30,20,30,0,96,33,279,765
UTTAR PRADESH,SITAPUR,2008,82,69,39,190,53,0,53,106,138,129,9,276,2,1,37,91,390,90,300,911,40,42,86,2,9,254,639,77,47,21,110,0,255,206,1479,3275
UTTAR PRADESH,SONBHADRA,2008,39,10,17,66,26,0,26,52,30,24,6,60,0,0,7,48,100,30,70,255,12,22,56,0,1,105,320,20,38,37,30,0,125,124,247,969
UTTAR PRADESH,ST.RAVIDASNAGAR,2008,19,20,7,46,2,0,2,4,11,9,2,22,1,0,6,32,59,28,31,157,11,3,9,1,0,89,158,11,2,6,16,0,35,45,83,433
UTTAR PRADESH,SULTANPUR,2008,54,82,15,151,25,0,25,50,54,49,5,108,1,0,13,62,239,100,139,554,44,49,59,5,26,332,705,12,26,19,43,0,100,190,552,1902
UTTAR PRADESH,UNNAO,2008,58,61,34,153,36,0,36,72,78,69,9,156,1,1,19,48,177,58,119,423,28,43,66,2,2,134,331,52,50,26,61,0,189,56,550,1583
UTTAR PRADESH,VARANASI,2008,58,37,18,113,12,0,12,24,59,38,21,118,2,1,25,157,804,584,220,1793,96,120,243,24,2,247,904,36,14,98,183,0,331,172,1331,3739
UTTARAKHAND,ALMORA,2008,12,7,1,20,2,0,2,4,7,7,0,14,1,0,5,18,30,3,27,84,11,1,11,2,2,23,67,8,5,3,9,0,25,17,77,252
UTTARAKHAND,BAGESHWAR,2008,6,0,1,7,2,0,2,4,3,1,2,6,0,0,0,7,9,0,9,25,2,0,2,0,1,4,12,2,3,4,2,0,11,3,14,65
UTTARAKHAND,CHAMOLI,2008,1,2,1,4,2,0,2,4,6,1,5,12,0,0,1,11,17,0,17,46,3,1,2,0,1,10,24,1,3,0,3,0,7,7,22,94
UTTARAKHAND,CHAMPAWAT,2008,2,2,1,5,2,0,2,4,4,4,0,8,0,0,1,4,13,4,9,31,1,2,1,3,0,4,13,3,0,3,5,0,11,2,26,79
UTTARAKHAND,DEHRADUN,2008,42,51,5,98,20,0,20,40,65,65,0,130,1,1,37,131,559,174,385,1288,170,47,150,8,2,263,799,9,24,128,85,0,246,159,501,2458
UTTARAKHAND,HARIDWAR,2008,74,62,13,149,24,0,24,48,61,47,14,122,6,1,53,82,491,268,223,1124,141,59,147,8,4,506,1050,18,29,122,138,0,307,185,298,2522
UTTARAKHAND,NAINITAL,2008,24,24,5,53,9,0,9,18,22,22,0,44,2,0,11,33,160,63,97,366,20,13,41,3,0,13,161,10,5,26,21,0,62,71,379,892
UTTARAKHAND,PAURI GARHWAL,2008,4,5,2,11,0,0,0,0,4,3,1,8,0,0,4,12,25,7,18,66,6,5,21,0,2,20,65,5,3,6,6,0,20,11,37,178
UTTARAKHAND,PITHORAGARH,2008,3,6,3,12,0,0,0,0,0,0,0,0,0,0,4,13,12,0,12,41,1,7,2,0,1,12,23,3,6,0,11,0,20,0,76,160
UTTARAKHAND,RUDRA PRAYAG,2008,0,0,0,0,0,0,0,0,0,0,0,0,0,0,0,3,11,2,9,25,3,0,0,0,0,5,14,0,0,2,0,0,2,6,7,37
UTTARAKHAND,TEHRI GARHWAL,2008,7,4,3,14,3,0,3,6,3,3,0,6,0,0,5,19,27,2,25,78,14,4,8,0,2,16,44,2,4,8,8,0,22,0,104,241
UTTARAKHAND,UDHAMSINGH NAGAR,2008,45,50,5,100,22,0,22,44,67,64,3,134,6,0,23,78,250,202,48,607,124,29,75,7,0,59,423,11,34,0,51,0,96,129,684,1749
UTTARAKHAND,UTTARKASHI,2008,3,4,0,7,1,0,1,2,5,5,0,10,0,0,0,12,18,1,17,48,13,3,3,0,0,2,21,1,4,4,1,0,10,0,55,129
WEST BENGAL,24 PARGANAS NORTH,2008,192,168,47,407,192,0,192,384,317,215,102,634,15,329,43,19,1452,257,1195,3310,579,184,239,12,13,234,1273,67,209,5,1946,0,2227,12,4973,11247
WEST BENGAL,24 PARGANAS SOUTH,2008,239,35,43,317,308,0,308,616,280,275,5,560,16,236,35,11,1773,229,1544,3844,1115,30,217,3,6,292,1794,53,192,0,2551,1,2797,131,6353,13920
WEST BENGAL,ASANSOL,2008,40,13,10,63,20,0,20,40,18,12,6,36,1,29,3,4,222,120,102,481,27,7,45,0,7,94,266,9,20,0,166,0,195,86,855,1676
WEST BENGAL,BANKURA,2008,54,37,6,97,46,0,46,92,21,18,3,42,8,20,22,9,183,20,163,425,126,15,28,0,9,252,553,20,45,1,170,0,236,123,265,1460
WEST BENGAL,BIRBHUM,2008,96,24,31,151,58,0,58,116,46,27,19,92,2,23,30,3,361,77,284,780,372,7,50,3,11,253,888,26,67,0,289,0,382,192,582,2526
WEST BENGAL,BURDWAN,2008,91,69,26,186,61,0,61,122,87,28,59,174,11,59,29,6,519,118,401,1143,333,7,152,4,5,136,1561,24,107,2,507,0,640,924,969,4128
WEST BENGAL,COOCHBEHAR,2008,57,51,4,112,141,0,141,282,108,92,16,216,1,3,4,15,193,37,156,409,139,13,28,7,2,137,421,17,148,0,367,0,532,95,969,2499
WEST BENGAL,DAKSHIN DINAJPUR,2008,33,109,15,157,47,0,47,94,50,36,14,100,1,4,9,2,132,24,108,280,19,12,12,4,6,72,201,8,78,0,206,0,292,76,656,1551
WEST BENGAL,DARJEELING,2008,48,1,16,65,47,0,47,94,46,40,6,92,5,23,14,5,543,110,433,1133,73,43,27,3,11,717,1006,5,60,0,135,0,200,132,292,2246
WEST BENGAL,HOOGHLY,2008,92,84,32,208,54,0,54,108,50,50,0,100,15,34,52,26,652,103,549,1431,376,15,20,4,10,177,770,17,19,0,567,0,603,168,1380,3844
WEST BENGAL,HOWRAH,2008,82,11,29,122,46,0,46,92,105,89,16,210,11,34,25,11,874,226,648,1829,236,39,242,4,2,58,972,20,63,0,595,0,678,391,2609,5487
WEST BENGAL,HOWRAH G.R.P.,2008,5,42,0,47,0,0,0,0,3,2,1,6,5,5,1,0,521,0,521,1053,3,2,8,1,0,1,17,0,5,0,0,0,5,2,62,666
WEST BENGAL,JALPAIGURI,2008,126,134,44,304,334,0,334,668,299,239,60,598,11,0,76,135,2879,176,2703,5980,129,143,93,5,0,1493,2079,18,376,0,1062,0,1456,216,5419,12992
WEST BENGAL,KHARAGPUR G.R.P.,2008,7,0,1,8,0,0,0,0,0,0,0,0,0,8,1,0,102,0,102,213,3,0,0,0,0,0,3,0,1,0,0,0,1,0,16,139
WEST BENGAL,KOLKATA,2008,51,77,23,151,35,0,35,70,116,92,24,232,14,45,86,138,3365,546,2819,7013,211,246,1273,35,0,1470,3662,12,211,81,405,4,713,427,4680,13005
WEST BENGAL,MALDA,2008,78,129,24,231,130,0,130,260,92,57,35,184,3,16,16,8,310,134,176,663,36,9,50,13,0,75,183,12,83,0,401,0,496,0,1313,2798
WEST BENGAL,MURSHIDABAD,2008,134,237,34,405,308,0,308,616,194,165,29,388,8,75,30,11,522,138,384,1168,282,16,111,9,18,1459,2153,34,184,3,1441,0,1662,258,934,6302
WEST BENGAL,NADIA,2008,102,345,28,475,178,0,178,356,216,204,12,432,15,37,34,13,1237,93,1144,2573,319,21,180,13,24,1366,2200,46,296,2,1186,0,1530,277,1312,7247
WEST BENGAL,PASCHIM MIDNAPUR,2008,98,40,41,179,56,0,56,112,57,57,0,114,12,37,28,16,286,41,245,665,230,38,36,14,6,194,520,20,58,0,582,0,660,2,1082,2933
WEST BENGAL,PURAB MIDNAPUR,2008,63,26,10,99,60,0,60,120,118,117,1,236,13,11,18,16,389,72,317,836,600,6,74,3,0,0,955,28,45,0,613,0,686,272,1522,3887
WEST BENGAL,PURULIA,2008,44,0,7,51,61,0,61,122,23,23,0,46,3,9,27,3,263,19,244,568,120,5,28,0,3,0,156,4,63,0,193,0,260,0,888,1744
WEST BENGAL,SEALDAH G.R.P.,2008,10,2,1,13,2,0,2,4,6,3,3,12,0,6,7,0,147,0,147,307,14,4,4,1,0,17,40,0,1,0,0,0,1,0,35,257
WEST BENGAL,SILIGURI G.R.P.,2008,2,0,2,4,1,0,1,2,6,6,0,12,0,0,2,1,96,0,96,195,3,0,1,0,0,0,4,0,2,0,1,0,3,0,18,135
WEST BENGAL,UTTAR DINAJPUR,2008,67,98,14,179,78,0,78,156,74,60,14,148,14,12,21,10,313,53,260,683,80,14,20,10,17,536,682,11,63,0,280,0,354,5,993,2730
A & N ISLANDS,ANDAMAN,2008,8,10,2,20,12,0,12,24,16,13,3,32,0,0,14,72,125,11,114,336,16,12,19,1,15,105,172,2,24,3,25,0,54,4,374,859
A & N ISLANDS,NICOBAR,2008,0,1,0,1,0,0,0,0,1,0,1,2,0,0,0,6,3,0,3,12,0,0,0,0,0,2,2,0,0,0,1,0,1,0,9,23
CHANDIGARH,CHANDIGARH,2008,17,28,6,51,20,0,20,40,50,42,8,100,1,4,23,257,1991,1094,897,4267,85,37,213,0,2,73,421,3,19,2,49,0,73,11,1040,3931
D & N HAVELI,D and N HAVELI,2008,9,2,0,11,6,0,6,12,17,11,6,34,1,0,0,49,54,18,36,158,24,10,24,1,6,26,101,0,4,0,4,0,8,10,154,401
DAMAN & DIU,DAMAN,2008,2,1,0,3,0,0,0,0,2,0,2,4,2,0,3,36,41,24,17,123,29,3,2,0,2,11,80,0,2,0,0,0,2,33,23,192
DAMAN & DIU,DIU,2008,0,1,0,1,0,0,0,0,2,1,1,4,0,0,1,9,8,7,1,26,6,1,0,1,1,1,16,0,0,1,5,0,6,6,13,56
DELHI UT,CAW,2008,0,0,0,0,0,0,0,0,0,0,0,0,0,0,0,0,0,0,0,0,0,0,0,0,0,1,1,0,1,0,104,0,105,0,1,107
DELHI UT,CENTRAL,2008,34,33,4,71,30,0,30,60,84,61,23,168,0,6,33,92,1392,792,600,2915,2,32,144,2,0,208,400,6,38,12,81,0,137,12,855,3100
DELHI UT,CRIME BRANCH,2008,1,1,0,2,0,0,0,0,0,0,0,0,0,0,0,0,1,0,1,2,0,0,14,1,0,0,15,0,0,0,0,0,0,0,12,30
DELHI UT,EAST,2008,49,51,1,101,73,0,73,146,191,125,66,382,5,13,74,180,2471,1490,981,5214,13,34,137,4,5,217,578,21,93,14,184,0,312,168,1542,5540
DELHI UT,EOW,2008,0,0,0,0,0,0,0,0,0,0,0,0,0,0,0,0,0,0,0,0,0,8,137,0,0,0,145,0,0,2,0,0,2,0,23,170
DELHI UT,GRP(RLY),2008,6,0,0,6,0,0,0,0,6,5,1,12,1,2,2,1,821,27,794,1648,0,2,11,0,1,15,29,1,1,0,1,0,3,0,80,951
DELHI UT,IGI AIRPORT,2008,1,1,0,2,0,0,0,0,1,0,1,2,0,0,3,0,80,37,43,163,1,3,11,0,0,1,19,0,2,0,0,0,2,3,423,530
DELHI UT,NEW DELHI,2008,9,3,1,13,3,0,3,6,19,14,5,38,0,0,14,46,696,244,452,1452,11,12,146,7,2,41,220,1,18,3,9,0,31,1,817,1859
DELHI UT,NORTH,2008,25,18,7,50,20,0,20,40,80,61,19,160,2,3,56,75,932,422,510,2000,4,39,138,5,2,109,310,4,35,9,79,0,127,13,1458,3113
DELHI UT,NORTH-EAST,2008,92,50,12,154,32,0,32,64,210,169,41,420,0,5,47,182,1518,995,523,3270,7,31,71,1,6,302,588,17,77,23,172,0,289,170,1489,4514
DELHI UT,NORTH-WEST,2008,54,48,2,104,59,0,59,118,137,103,34,274,3,11,85,250,1760,1143,617,3869,2,18,76,0,5,173,291,12,48,8,82,0,150,17,1354,4204
DELHI UT,OUTER,2008,77,53,14,144,59,0,59,118,355,252,103,710,7,7,43,249,1871,1277,594,4048,3,39,111,1,2,212,393,21,48,5,162,0,236,25,1873,5237
DELHI UT,SOUTH,2008,37,18,5,60,37,0,37,74,70,51,19,140,1,23,42,262,1958,1228,730,4244,8,36,159,1,3,103,331,8,52,16,76,0,152,21,1885,4821
DELHI UT,SOUTH-EAST,2008,66,37,6,109,61,0,61,122,182,123,59,364,1,38,66,222,2162,1342,820,4651,9,41,148,6,5,181,643,15,82,25,156,0,278,253,2142,5904
DELHI UT,SOUTH-WEST,2008,57,36,6,99,38,0,38,76,87,66,21,174,2,20,37,136,1113,725,388,2421,7,19,62,4,4,131,251,9,39,7,109,0,164,24,1998,3945
DELHI UT,STF,2008,0,10,0,10,0,0,0,0,0,0,0,0,0,1,0,0,0,0,0,1,0,0,10,5,0,0,15,0,0,0,0,0,0,0,13,39
DELHI UT,WEST,2008,46,30,8,84,54,0,54,108,145,106,39,290,2,5,39,231,2092,1298,794,4461,4,41,118,4,6,242,434,14,77,6,172,0,269,19,1931,5286
LAKSHADWEEP,LAKSHADWEEP,2008,1,0,0,1,2,0,2,4,1,1,0,2,0,0,0,3,8,1,7,19,12,0,0,0,2,12,26,0,0,0,1,0,1,0,53,95
PUDUCHERRY,KARAIKAL,2008,5,6,0,11,1,0,1,2,2,1,1,4,0,0,0,14,71,37,34,156,36,0,5,0,1,176,262,0,25,4,2,0,31,44,335,727
PUDUCHERRY,PUDUCHERRY,2008,30,29,3,62,7,0,7,14,15,8,7,30,10,3,10,76,617,406,211,1333,129,13,48,2,8,697,1060,2,40,17,10,0,69,163,2333,4262
ANDHRA PRADESH,ADILABAD,2009,85,39,11,135,67,0,67,134,73,56,17,146,6,0,20,200,351,82,269,928,101,11,161,7,35,1254,1902,13,192,163,428,0,796,333,1762,5312
ANDHRA PRADESH,ANANTAPUR,2009,140,78,4,222,22,0,22,44,68,60,8,136,9,0,24,176,547,47,500,1303,98,24,104,26,22,1049,1972,14,157,13,143,0,327,649,1814,5181
ANDHRA PRADESH,CHITTOOR,2009,85,68,2,155,33,0,33,66,74,46,28,148,4,0,17,251,1208,521,687,2688,104,25,276,32,45,1040,2204,19,120,268,333,0,740,682,2582,7268
ANDHRA PRADESH,CUDDAPAH,2009,93,44,0,137,27,0,27,54,57,47,10,114,2,0,9,103,460,144,316,1034,162,30,206,5,44,1061,2030,17,165,52,124,0,358,522,2327,5510
ANDHRA PRADESH,CYBERABAD,2009,186,84,15,285,82,0,82,164,168,113,55,336,11,1,72,1348,3358,1365,1993,8148,83,124,1174,13,71,3136,5664,46,173,155,991,0,1365,1063,2487,14841
ANDHRA PRADESH,EAST GODAVARI,2009,93,96,5,194,47,0,47,94,80,60,20,160,1,0,29,456,1120,325,795,2726,62,101,301,32,35,3047,4244,23,196,178,440,0,837,666,1652,8660
ANDHRA PRADESH,GUNTAKAL RLY.,2009,7,0,0,7,0,0,0,0,0,0,0,0,0,0,0,0,169,0,169,338,0,2,1,1,0,5,12,0,3,1,0,0,4,3,22,214
ANDHRA PRADESH,GUNTUR,2009,150,140,0,290,40,0,40,80,79,62,17,158,4,2,44,343,1186,407,779,2765,71,28,384,45,72,2023,3408,26,340,451,720,0,1537,785,2873,9806
ANDHRA PRADESH,HYDERABAD CITY,2009,153,110,5,268,47,0,47,94,108,55,53,216,5,0,59,969,5091,2095,2996,11215,199,85,2007,49,7,3516,6379,36,295,63,1363,0,1757,516,3157,17840
ANDHRA PRADESH,KARIMNAGAR,2009,91,98,15,204,48,0,48,96,128,106,22,256,2,20,15,250,528,125,403,1343,185,25,396,3,75,2751,3952,40,292,234,635,0,1201,517,1554,7902
ANDHRA PRADESH,KHAMMAM,2009,118,69,3,190,98,0,98,196,108,96,12,216,6,3,23,253,512,184,328,1309,138,31,164,8,11,1111,1941,18,205,152,519,0,894,478,2200,6228
ANDHRA PRADESH,KRISHNA,2009,72,104,3,179,43,0,43,86,49,35,14,98,2,1,11,168,519,134,385,1220,43,26,135,11,36,2578,3226,14,297,130,402,0,843,397,852,5893
ANDHRA PRADESH,KURNOOL,2009,103,170,2,275,31,0,31,62,83,73,10,166,9,0,19,282,495,189,306,1300,167,28,265,15,46,1713,2756,17,398,365,239,0,1019,522,3033,8002
ANDHRA PRADESH,MAHABOOBNAGAR,2009,158,68,18,244,74,0,74,148,103,101,2,206,1,0,16,256,1009,5,1004,2291,120,18,171,16,73,2269,3407,24,215,75,299,0,613,740,1249,6972
ANDHRA PRADESH,MEDAK,2009,120,61,8,189,46,0,46,92,61,51,10,122,4,0,25,260,598,128,470,1485,69,19,268,4,54,2010,3031,27,118,58,368,0,571,607,1102,5887
ANDHRA PRADESH,NALGONDA,2009,124,63,7,194,77,0,77,154,109,75,34,218,9,0,32,272,494,107,387,1301,107,36,282,8,97,1808,3084,41,254,205,364,0,864,746,3482,8617
ANDHRA PRADESH,NELLORE,2009,66,82,3,151,32,0,32,64,50,48,2,100,14,0,7,189,599,206,393,1408,41,44,193,17,38,2304,3122,3,287,128,305,0,723,485,980,5867
ANDHRA PRADESH,NIZAMABAD,2009,106,55,3,164,27,0,27,54,46,41,5,92,4,0,16,241,417,105,312,1095,37,18,201,15,49,1595,2323,19,79,75,518,0,691,408,961,4890
ANDHRA PRADESH,PRAKASHAM,2009,78,91,6,175,27,0,27,54,66,44,22,132,1,0,3,180,423,132,291,1030,47,31,194,15,26,1303,2126,14,197,51,248,0,510,510,2614,6125
ANDHRA PRADESH,RANGA REDDY,2009,63,27,4,94,26,0,26,52,29,20,9,58,2,0,5,99,128,12,116,362,18,3,57,2,20,777,1016,20,44,25,108,0,197,139,446,2042
ANDHRA PRADESH,SECUNDERABAD RLY.,2009,9,1,0,10,0,0,0,0,0,0,0,0,0,0,0,0,463,0,463,926,0,0,3,0,0,8,16,0,3,0,0,0,3,5,96,588
ANDHRA PRADESH,SRIKAKULAM,2009,31,2,1,34,21,0,21,42,20,20,0,40,1,0,5,125,162,2,160,455,8,22,63,16,18,755,1111,6,67,44,211,0,328,229,1547,3354
ANDHRA PRADESH,VIJAYAWADA CITY,2009,34,54,1,89,23,0,23,46,63,53,10,126,0,0,22,176,1137,439,698,2472,8,23,306,38,16,1547,2228,17,177,198,433,0,825,290,617,5180
ANDHRA PRADESH,VIJAYAWADA RLY.,2009,3,4,0,7,0,0,0,0,0,0,0,0,0,0,3,1,510,0,510,1024,0,5,4,1,0,23,34,0,0,0,0,0,0,1,37,592
ANDHRA PRADESH,VISAKHA RURAL,2009,47,36,2,85,14,0,14,28,18,7,11,36,0,0,4,94,158,34,124,414,40,5,79,7,20,1172,1655,8,57,56,167,0,288,332,422,2738
ANDHRA PRADESH,VISAKHAPATNAM,2009,28,25,4,57,39,0,39,78,48,26,22,96,1,0,21,311,1040,420,620,2413,12,62,270,19,13,473,1277,13,95,54,481,0,643,428,1979,5416
ANDHRA PRADESH,VIZIANAGARAM,2009,30,24,2,56,13,0,13,26,15,12,3,30,1,0,4,128,242,1,241,617,8,12,118,19,15,523,960,8,103,105,297,0,513,265,1519,3451
ANDHRA PRADESH,WARANGAL,2009,103,42,5,150,70,0,70,140,140,130,10,280,3,0,14,277,516,216,300,1326,289,9,365,7,40,1421,2641,49,234,25,432,0,740,510,2928,7479
ANDHRA PRADESH,WEST GODAVARI,2009,73,124,5,202,114,0,114,228,115,89,26,230,0,0,25,364,1252,379,873,2893,44,57,380,30,61,2216,3398,14,384,196,729,0,1323,610,1793,8586
ARUNACHAL PRADESH,ANJAW,2009,0,0,0,0,0,0,0,0,0,0,0,0,0,0,0,2,0,0,0,2,0,0,0,0,0,6,13,0,0,0,0,0,0,7,5,20
ARUNACHAL PRADESH,CHANGLANG,2009,3,2,0,5,8,0,8,16,7,6,1,14,5,0,7,28,38,0,38,116,1,4,3,1,3,38,55,0,3,0,4,0,7,5,47,207
ARUNACHAL PRADESH,DIBANG VALLEY,2009,1,1,1,3,3,0,3,6,6,4,2,12,0,0,3,10,22,10,12,57,0,0,1,0,1,31,38,0,2,0,1,0,3,5,27,115
ARUNACHAL PRADESH,K/KUMEY,2009,6,4,0,10,5,0,5,10,0,0,0,0,1,0,0,8,6,0,6,21,1,2,2,0,4,9,20,0,0,0,0,0,0,2,22,72
ARUNACHAL PRADESH,KAMENG EAST,2009,5,0,0,5,3,0,3,6,5,3,2,10,4,0,5,11,17,2,15,54,5,1,2,0,0,44,56,0,1,0,0,0,1,4,56,163
ARUNACHAL PRADESH,KAMENG WEST,2009,3,5,2,10,1,0,1,2,0,0,0,0,2,0,3,7,10,3,7,32,2,0,0,0,2,43,63,0,5,0,1,0,6,16,35,137
ARUNACHAL PRADESH,LOHIT,2009,9,1,0,10,8,0,8,16,6,2,4,12,2,0,4,13,35,4,31,89,5,2,1,0,1,29,46,0,5,0,0,0,5,8,41,170
ARUNACHAL PRADESH,PAPUM PARE,2009,7,4,0,11,11,0,11,22,13,3,10,26,3,0,10,33,89,57,32,224,3,12,0,2,7,81,133,0,10,6,1,0,17,28,136,456
ARUNACHAL PRADESH,SIANG EAST,2009,3,2,1,6,9,0,9,18,10,3,7,20,0,0,0,24,58,17,41,140,9,4,3,2,1,50,73,0,6,0,1,0,7,4,35,222
ARUNACHAL PRADESH,SIANG UPPER,2009,0,0,0,0,2,0,2,4,1,0,1,2,0,0,0,11,9,1,8,29,0,0,3,1,1,16,22,0,1,0,0,0,1,1,9,55
ARUNACHAL PRADESH,SIANG WEST,2009,11,3,0,14,5,0,5,10,5,4,1,10,1,0,7,9,29,6,23,75,19,6,7,0,6,56,102,0,6,0,4,0,10,8,61,243
ARUNACHAL PRADESH,SUBANSIRI LOWER,2009,1,3,1,5,2,0,2,4,4,1,3,8,0,0,2,16,13,3,10,44,3,2,2,1,1,37,50,0,8,0,0,0,8,4,27,127
ARUNACHAL PRADESH,SUBANSIRI UPPER,2009,4,3,0,7,1,0,1,2,1,1,0,2,0,0,5,3,16,2,14,40,0,1,1,0,0,39,45,0,5,0,1,0,6,4,52,136
ARUNACHAL PRADESH,TAWANG,2009,1,0,0,1,0,0,0,0,0,0,0,0,0,0,0,5,14,0,14,33,0,0,2,0,0,4,13,0,0,0,0,0,0,7,11,44
ARUNACHAL PRADESH,TIRAP,2009,5,3,0,8,1,0,1,2,4,1,3,8,2,0,9,12,25,4,21,73,1,2,2,1,1,40,53,0,6,0,0,0,6,6,46,166
ARUNACHAL PRADESH,UPPER DIBANG VALLEY,2009,0,2,0,2,0,0,0,0,0,0,0,0,0,0,0,9,0,0,0,9,3,2,0,0,0,3,9,0,0,0,0,0,0,1,9,29
ASSAM,BARPETA,2009,46,20,0,66,123,0,123,246,113,98,15,226,10,3,26,168,186,35,151,579,166,25,31,7,21,176,680,29,130,0,206,0,365,254,756,2496
ASSAM,BASKA,2009,29,14,1,44,18,0,18,36,38,23,15,76,0,0,5,18,30,1,29,83,5,9,8,0,5,57,105,3,8,0,25,0,36,21,119,413
ASSAM,BONGAIGAON,2009,13,9,0,22,54,0,54,108,58,53,5,116,11,0,12,95,139,45,94,396,75,13,34,1,10,86,333,4,5,0,118,0,127,114,402,1253
ASSAM,C.I.D.,2009,1,0,0,1,0,0,0,0,0,0,0,0,0,0,0,0,1,0,1,2,0,0,12,1,0,0,13,0,0,0,0,0,0,0,7,22
ASSAM,CACHAR,2009,56,10,0,66,70,0,70,140,152,131,21,304,29,0,25,270,522,145,377,1368,191,70,79,1,41,84,540,23,29,1,479,0,532,74,2395,4601
ASSAM,CHIRANG,2009,34,1,0,35,35,0,35,70,58,51,7,116,3,0,3,35,58,11,47,157,5,0,2,0,10,26,71,1,1,0,51,0,53,28,231,582
ASSAM,DARRANG,2009,29,8,0,37,80,0,80,160,99,96,3,198,11,0,13,119,222,37,185,587,27,60,50,13,20,357,639,7,139,0,236,0,382,112,719,2321
ASSAM,DHEMAJI,2009,20,27,0,47,62,0,62,124,71,63,8,142,4,0,11,27,130,25,105,302,7,21,19,2,12,218,338,1,42,0,110,0,153,59,173,1016
ASSAM,DHUBRI,2009,53,16,2,71,150,0,150,300,185,147,38,370,9,1,26,118,258,25,233,670,347,42,109,16,38,496,1138,20,154,2,375,0,551,90,784,3291
ASSAM,DIBRUGARH,2009,77,4,0,81,46,0,46,92,110,6,104,220,2,0,26,103,494,61,433,1119,7,34,22,0,0,467,638,3,44,0,92,0,139,108,516,2155
ASSAM,G.R.P.,2009,8,0,0,8,0,0,0,0,2,0,2,4,10,0,9,2,146,0,146,313,8,1,4,1,0,0,14,0,0,0,0,0,0,0,115,306
ASSAM,GOALPARA,2009,51,4,0,55,90,0,90,180,89,89,0,178,8,0,5,82,166,32,134,427,120,0,52,1,5,376,599,2,2,0,252,0,256,45,426,1776
ASSAM,GOLAGHAT,2009,55,22,1,78,35,0,35,70,101,97,4,202,2,1,25,72,239,32,207,578,1,35,34,1,15,347,593,0,46,0,108,0,154,160,286,1586
ASSAM,GUWAHATI CITY,2009,86,34,4,124,54,0,54,108,293,231,62,586,24,8,165,631,1728,728,1000,4284,49,148,227,9,45,721,1510,9,162,0,321,0,492,311,2251,7280
ASSAM,HAILAKANDI,2009,12,1,0,13,45,0,45,90,59,44,15,118,3,1,5,71,77,3,74,234,144,18,25,0,17,17,249,8,12,0,81,0,101,28,578,1202
ASSAM,JORHAT,2009,26,4,2,32,36,0,36,72,54,40,14,108,2,0,29,93,249,72,177,622,22,17,24,1,10,256,469,1,53,0,116,0,170,139,228,1362
ASSAM,KAMRUP,2009,43,20,1,64,57,0,57,114,121,108,13,242,11,2,18,107,241,55,186,620,54,14,34,6,17,218,452,3,35,0,108,0,146,109,1116,2335
ASSAM,KARBI ANGLONG,2009,40,13,0,53,17,0,17,34,21,14,7,42,7,0,11,30,109,27,82,266,28,12,8,0,0,58,137,0,9,0,23,0,32,31,207,624
ASSAM,KARIMGANJ,2009,34,10,0,44,26,0,26,52,39,36,3,78,8,0,7,70,73,17,56,231,44,13,4,5,22,82,211,12,9,0,106,1,128,41,534,1140
ASSAM,KOKRAJHAR,2009,69,25,0,94,44,0,44,88,71,35,36,142,10,0,6,35,148,24,124,347,71,10,20,5,31,176,356,1,26,0,70,0,97,43,330,1191
ASSAM,LAKHIMPUR,2009,31,20,8,59,54,0,54,108,123,97,26,246,0,0,13,79,209,34,175,510,23,9,4,0,10,365,508,3,42,0,187,0,232,97,584,1861
ASSAM,MORIGAON,2009,26,10,2,38,88,0,88,176,77,69,8,154,5,0,12,51,84,7,77,236,82,4,33,2,0,475,695,3,60,0,98,0,161,99,111,1322
ASSAM,N.C.HILLS,2009,73,12,10,95,3,0,3,6,16,6,10,32,0,0,1,4,20,2,18,45,1,4,1,0,13,13,51,0,4,0,3,0,7,19,57,254
ASSAM,NAGAON,2009,75,67,2,144,162,0,162,324,233,221,12,466,36,4,76,259,439,95,344,1253,209,132,99,1,69,655,1347,12,134,7,655,0,808,182,1695,5203
ASSAM,NALBARI,2009,23,22,0,45,31,0,31,62,58,48,10,116,10,0,23,75,158,46,112,424,8,3,27,2,10,304,392,6,76,0,73,0,155,38,401,1348
ASSAM,R.P.O.,2009,4,0,0,4,7,0,7,14,1,0,1,2,5,0,2,2,6,0,6,21,8,0,0,0,0,0,8,0,0,0,0,0,0,0,55,90
ASSAM,SIBSAGAR,2009,68,24,1,93,71,0,71,142,120,0,120,240,5,0,37,155,426,76,350,1049,33,14,47,6,15,179,379,4,52,0,149,0,205,85,672,2163
ASSAM,SONITPUR,2009,109,20,1,130,89,0,89,178,174,169,5,348,5,1,27,177,347,23,324,904,35,31,73,0,18,145,635,11,38,0,246,0,295,333,1027,2907
ASSAM,TINSUKIA,2009,85,0,0,85,58,0,58,116,106,87,19,212,18,0,39,136,632,50,582,1457,30,53,13,3,16,154,323,2,8,0,62,0,72,54,905,2374
ASSAM,UDALGURI,2009,47,0,0,47,26,0,26,52,76,33,43,152,3,0,23,65,107,5,102,305,8,10,3,0,6,39,127,2,22,0,48,0,72,61,293,839
BIHAR,ARARIA,2009,50,21,5,76,28,0,28,56,56,50,6,112,29,3,50,44,252,27,225,630,196,37,24,0,15,85,399,21,4,0,18,0,43,42,1149,2129
BIHAR,ARWAL,2009,23,15,3,41,2,0,2,4,16,10,6,32,2,0,5,10,55,4,51,127,44,0,13,0,12,39,130,10,9,0,6,0,25,22,369,655
BIHAR,AURANGABAD,2009,67,6,8,81,19,0,19,38,54,53,1,108,23,0,27,122,346,27,319,864,364,17,55,2,33,917,1505,37,16,0,46,0,99,117,837,3113
BIHAR,BAGAHA,2009,38,41,3,82,8,0,8,16,46,34,12,92,7,3,12,37,134,2,132,327,60,20,29,1,14,580,723,14,44,0,13,0,71,19,377,1500
BIHAR,BANKA,2009,78,53,13,144,31,0,31,62,54,45,9,108,20,2,37,88,139,9,130,425,114,11,32,3,16,431,608,19,4,1,24,0,48,1,649,1820
BIHAR,BEGUSARAI,2009,109,237,1,347,12,0,12,24,79,39,40,158,18,1,61,62,303,13,290,748,273,90,77,0,16,323,1013,46,10,0,47,2,105,234,1386,3387
BIHAR,BETTIAH,2009,65,16,2,83,22,0,22,44,82,76,6,164,11,2,23,71,277,22,255,661,198,60,38,5,10,1036,1502,37,3,0,38,0,78,155,1051,3202
BIHAR,BHABHUA,2009,56,27,0,83,4,0,4,8,38,25,13,76,6,0,28,62,200,34,166,496,127,12,29,0,0,70,260,19,0,0,16,0,35,22,1064,1780
BIHAR,BHAGALPUR,2009,73,8,6,87,28,0,28,56,57,44,13,114,2,1,27,130,515,189,326,1190,222,44,44,1,9,569,891,15,2,0,47,0,64,2,1438,3240
BIHAR,BHOJPUR,2009,94,34,0,128,11,0,11,22,50,37,13,100,18,0,41,99,444,111,333,1046,184,0,78,2,4,25,558,54,0,2,275,0,331,265,2056,3736
BIHAR,BUXAR,2009,53,37,0,90,14,0,14,28,64,45,19,128,15,0,25,52,225,46,179,542,172,30,35,4,37,476,814,26,17,0,50,0,93,60,468,1860
BIHAR,DARBHANGA,2009,49,121,6,176,27,0,27,54,83,77,6,166,20,2,28,101,301,58,243,753,481,66,163,4,26,114,947,33,10,0,247,0,290,93,2286,4261
BIHAR,GAYA,2009,155,33,17,205,20,0,20,40,108,66,42,216,52,2,85,163,667,169,498,1636,374,28,126,2,38,10,737,46,12,0,106,5,169,159,2418,4626
BIHAR,GOPALGANJ,2009,81,127,15,223,37,0,37,74,112,71,41,224,13,1,21,66,226,63,163,553,221,22,77,0,16,86,617,42,39,0,127,0,208,195,1117,2641
BIHAR,JAMALPUR RLY.,2009,6,2,0,8,1,0,1,2,3,0,3,6,7,3,11,1,124,7,117,270,4,1,3,0,0,0,8,0,2,0,0,0,2,0,64,232
BIHAR,JAMUI,2009,65,156,2,223,15,0,15,30,35,21,14,70,14,2,30,53,148,26,122,395,181,3,71,0,5,821,1134,17,7,0,56,0,80,53,523,2257
BIHAR,JEHANABAD,2009,48,10,2,60,8,0,8,16,40,9,31,80,10,0,12,40,128,17,111,318,127,20,25,0,6,117,339,43,11,0,42,0,96,44,859,1592
BIHAR,KATIHAR,2009,89,19,1,109,120,0,120,240,130,41,89,260,13,2,27,48,183,63,120,456,213,3,61,3,28,405,770,17,5,0,55,0,77,57,1058,2537
BIHAR,KATIHAR RLY.,2009,9,0,0,9,1,0,1,2,2,0,2,4,4,0,6,5,189,0,189,393,3,0,8,0,0,20,33,0,2,0,0,0,2,2,113,364
BIHAR,KHAGARIA,2009,46,114,8,168,8,0,8,16,49,28,21,98,3,0,22,20,141,33,108,327,153,10,33,0,13,620,852,23,37,0,7,1,68,23,340,1671
BIHAR,KISHANGANJ,2009,32,0,1,33,33,0,33,66,41,30,11,82,10,0,5,30,182,43,139,409,135,12,27,1,2,183,373,6,0,0,32,0,38,13,502,1247
BIHAR,LAKHISARAI,2009,45,73,3,121,15,0,15,30,39,16,23,78,5,0,25,29,103,4,99,265,114,20,39,0,10,410,641,13,25,5,25,0,68,48,248,1294
BIHAR,MADHEPURA,2009,45,10,5,60,11,0,11,22,50,28,22,100,1,0,41,31,204,52,152,481,152,23,14,0,8,113,349,19,4,0,11,0,34,39,989,1770
BIHAR,MADHUBANI,2009,66,7,0,73,19,0,19,38,81,78,3,162,12,0,24,89,390,55,335,905,307,15,32,0,18,1055,1523,31,20,0,71,0,122,96,1842,4175
BIHAR,MOTIHARI,2009,127,253,3,383,31,0,31,62,156,117,39,312,19,5,50,155,502,132,370,1233,486,46,177,5,34,1112,2038,49,6,0,41,0,96,178,1799,5234
BIHAR,MUNGER,2009,79,133,1,213,12,0,12,24,68,48,20,136,16,0,53,64,266,43,223,665,168,20,56,2,26,180,514,12,0,0,54,0,66,62,730,2002
BIHAR,MUZAFFARPUR,2009,150,19,17,186,55,0,55,110,151,111,40,302,28,6,66,196,798,263,535,1892,356,108,133,5,29,63,1253,77,13,0,109,0,199,559,2641,5579
BIHAR,MUZAFFARPUR RLY.,2009,19,21,0,40,3,0,3,6,5,1,4,10,12,1,10,10,327,52,275,687,5,1,12,0,0,65,84,1,5,0,0,0,6,1,102,600
BIHAR,NALANDA,2009,114,301,8,423,33,0,33,66,99,67,32,198,23,0,50,120,418,34,384,1029,194,28,53,1,18,665,1217,74,88,0,33,0,195,258,2129,4707
BIHAR,NAUGACHIA,2009,32,63,3,98,6,0,6,12,36,31,5,72,2,0,7,26,65,4,61,165,143,42,36,0,12,153,453,9,56,0,13,0,78,67,802,1573
BIHAR,NAWADAH,2009,60,27,2,89,14,0,14,28,64,34,30,128,4,1,16,41,145,13,132,352,129,18,60,0,5,268,608,21,6,1,60,0,88,128,1094,2164
BIHAR,PATNA,2009,314,104,12,430,46,0,46,92,351,167,184,702,54,2,227,714,2794,1263,1531,6585,476,29,448,17,5,130,1360,95,21,0,341,0,457,255,8011,14446
BIHAR,PATNA RLY.,2009,21,6,7,34,0,0,0,0,17,7,10,34,13,3,14,0,670,57,613,1370,17,5,23,1,0,0,46,3,17,0,0,0,20,0,329,1146
BIHAR,PURNEA,2009,86,119,13,218,49,0,49,98,69,25,44,138,16,5,27,68,196,30,166,508,150,68,104,1,41,242,736,20,35,3,76,0,134,130,1302,2820
BIHAR,ROHTAS,2009,110,63,0,173,18,0,18,36,83,11,72,166,37,0,61,125,569,171,398,1361,219,28,37,0,1,165,735,41,38,0,57,23,159,285,2111,4071
BIHAR,SAHARSA,2009,49,123,8,180,28,0,28,56,55,9,46,110,12,1,77,61,161,31,130,473,287,29,55,0,6,246,684,11,36,0,15,0,62,61,766,2087
BIHAR,SAMASTIPUR,2009,109,211,17,337,26,0,26,52,130,27,103,260,9,1,45,82,409,97,312,955,235,23,26,1,47,267,764,68,21,0,64,0,153,165,2121,4077
BIHAR,SARAN,2009,112,175,9,296,11,0,11,22,91,73,18,182,17,3,76,119,597,41,556,1409,298,22,103,0,38,1369,2001,57,20,0,132,0,209,171,406,3826
BIHAR,SHEIKHPURA,2009,16,0,0,16,6,0,6,12,10,9,1,20,3,0,8,12,96,8,88,215,85,20,25,0,0,29,191,8,0,0,14,0,22,32,600,964
BIHAR,SHEOHAR,2009,20,17,0,37,4,0,4,8,25,16,9,50,2,1,2,17,55,15,40,132,44,1,17,0,2,220,300,7,6,0,12,0,25,16,87,555
BIHAR,SITAMARHI,2009,67,22,4,93,8,0,8,16,104,81,23,208,24,4,51,107,389,125,264,964,109,13,22,0,29,318,546,27,20,0,14,0,61,55,2376,3763
BIHAR,SIWAN,2009,82,50,6,138,14,0,14,28,89,72,17,178,17,5,26,39,272,52,220,631,164,6,38,5,18,490,823,42,6,0,25,0,73,102,746,2242
BIHAR,SUPAUL,2009,36,138,24,198,26,0,26,52,42,29,13,84,14,0,30,36,110,28,82,300,175,24,36,1,15,129,419,12,21,0,30,0,63,39,737,1675
BIHAR,VAISHALI,2009,107,56,8,171,45,0,45,90,208,128,80,416,17,2,50,121,506,141,365,1202,395,111,82,2,23,130,934,73,28,0,83,0,184,191,2073,4311
CHHATTISGARH,BALRAMPUR,2009,41,18,1,60,43,0,43,86,10,10,0,20,9,0,11,49,50,0,50,169,23,0,6,0,6,179,243,2,40,26,0,0,68,29,218,761
CHHATTISGARH,BILASPUR,2009,96,52,1,149,59,0,59,118,45,32,13,90,5,2,68,576,849,326,523,2349,187,16,56,7,42,1741,2284,30,175,17,131,0,353,235,2048,6438
CHHATTISGARH,BIZAPUR,2009,61,102,1,164,10,0,10,20,4,0,4,8,10,0,1,4,6,0,6,27,5,0,7,0,19,7,47,0,1,0,3,0,4,9,56,306
CHHATTISGARH,DANTEWARA,2009,60,76,0,136,14,0,14,28,10,5,5,20,30,0,6,36,58,14,44,188,20,2,8,2,20,50,140,0,14,0,5,0,19,38,288,737
CHHATTISGARH,DHAMTARI,2009,15,16,0,31,24,0,24,48,7,7,0,14,5,0,10,134,127,40,87,403,29,2,19,0,4,66,200,1,64,3,15,0,83,80,821,1442
CHHATTISGARH,DURG,2009,87,45,0,132,109,0,109,218,19,17,2,38,8,3,63,564,726,316,410,2090,81,18,105,12,35,298,943,8,223,20,124,0,375,394,4399,7341
CHHATTISGARH,GRP RAIPUR,2009,8,1,0,9,0,0,0,0,1,1,0,2,0,0,5,6,271,22,249,553,2,0,1,1,0,11,17,0,1,0,1,0,2,2,47,358
CHHATTISGARH,JAGDALPUR,2009,71,45,1,117,60,0,60,120,19,15,4,38,9,0,19,144,174,94,80,520,31,6,13,0,10,599,829,0,36,1,17,0,54,170,786,2211
CHHATTISGARH,JANJGIR,2009,58,23,0,81,25,0,25,50,13,11,2,26,2,0,21,206,268,96,172,765,107,4,56,3,18,966,1290,12,97,10,96,0,215,136,843,2964
CHHATTISGARH,JASHPUR,2009,53,23,1,77,64,0,64,128,26,24,2,52,3,2,30,104,110,36,74,359,10,5,13,6,17,100,226,3,57,2,25,0,87,75,529,1258
CHHATTISGARH,KABIRDHAM,2009,20,14,5,39,20,0,20,40,2,0,2,4,1,0,7,77,98,16,82,281,42,2,14,0,8,662,795,1,55,6,29,0,91,67,437,1567
CHHATTISGARH,KANKER,2009,46,26,0,72,22,0,22,44,11,4,7,22,11,0,10,62,37,13,24,157,28,1,13,1,9,22,143,2,28,2,16,0,48,69,577,993
CHHATTISGARH,KORBA,2009,58,12,1,71,35,0,35,70,6,4,2,12,3,5,38,181,230,105,125,687,49,9,47,3,11,688,976,9,82,8,52,0,151,169,732,2428
CHHATTISGARH,KORIYA,2009,29,15,0,44,70,0,70,140,8,8,0,16,1,0,9,166,126,8,118,428,17,4,19,0,11,482,583,4,83,11,58,0,156,50,411,1574
CHHATTISGARH,MAHASAMUND,2009,15,13,0,28,28,0,28,56,6,4,2,12,0,0,7,138,173,76,97,491,24,2,28,4,10,153,381,8,60,4,17,0,89,160,810,1660
CHHATTISGARH,NARAYANPUR,2009,17,51,0,68,1,0,1,2,0,0,0,0,4,0,2,4,3,0,3,16,1,0,0,0,7,28,39,1,4,0,0,0,5,3,45,171
CHHATTISGARH,RAIGARH,2009,82,24,0,106,43,0,43,86,18,18,0,36,5,1,56,224,402,176,226,1090,63,18,54,2,18,582,917,9,73,4,36,0,122,180,996,2890
CHHATTISGARH,RAIPUR,2009,101,94,1,196,145,0,145,290,42,35,7,84,9,1,119,889,1578,696,882,4174,156,56,150,22,51,2425,3389,26,260,32,120,0,438,529,3109,9915
CHHATTISGARH,RAJNANDGAON,2009,55,31,6,92,47,0,47,94,13,12,1,26,6,0,29,191,262,72,190,750,32,7,20,5,22,93,347,8,78,5,59,0,150,168,1934,3071
CHHATTISGARH,SARGUJA,2009,58,28,1,87,81,0,81,162,15,15,0,30,2,0,26,111,138,60,78,415,29,7,35,0,12,48,217,1,86,0,45,0,132,86,1026,1835
CHHATTISGARH,SURAJPUR,2009,52,23,0,75,76,0,76,152,11,7,4,22,11,2,17,109,106,15,91,351,21,7,18,0,5,343,480,3,81,1,44,0,129,86,434,1450
GOA,NORTH GOA,2009,33,9,8,50,31,0,31,62,17,10,7,34,2,0,20,162,441,186,255,1066,25,35,69,15,16,107,408,1,17,5,12,0,35,141,507,1673
GOA,SOUTH GOA,2009,20,15,3,38,16,0,16,32,16,12,4,32,2,0,10,132,417,150,267,978,25,17,63,12,8,84,288,2,20,5,9,0,36,79,377,1332
GUJARAT,AHMEDABAD COMMR.,2009,83,50,7,140,63,0,63,126,181,132,49,362,16,2,844,751,6283,4232,2051,14179,178,224,205,16,6,1165,1999,5,74,18,1169,0,1266,205,9181,20726
GUJARAT,AHMEDABAD RURAL,2009,19,19,1,39,9,0,9,18,50,38,12,100,13,1,37,125,382,162,220,940,46,76,15,4,8,238,706,1,17,0,131,0,149,319,1730,3241
GUJARAT,AHWA-DANG,2009,5,1,0,6,3,0,3,6,0,0,0,0,0,0,0,5,2,0,2,9,1,2,0,1,3,10,36,0,2,0,4,0,6,19,95,153
GUJARAT,AMRELI,2009,27,8,2,37,8,0,8,16,52,50,2,104,5,0,9,122,217,91,126,570,65,51,5,8,5,303,541,1,21,4,131,0,157,104,1078,2226
GUJARAT,ANAND,2009,36,4,1,41,13,0,13,26,43,35,8,86,8,0,8,105,412,216,196,945,26,50,11,6,7,275,586,0,29,3,231,0,263,211,1976,3455
GUJARAT,BHARUCH,2009,26,19,0,45,18,0,18,36,28,25,3,56,11,0,18,123,429,187,242,1010,53,70,19,6,18,282,802,0,22,3,113,0,138,354,1571,3183
GUJARAT,BHAVNAGAR,2009,41,24,2,67,9,0,9,18,71,64,7,142,6,0,27,235,684,307,377,1636,95,39,53,14,15,130,346,0,41,42,157,0,240,0,2926,4611
GUJARAT,DAHOD,2009,33,36,2,71,10,0,10,20,40,40,0,80,30,0,34,73,188,126,62,513,44,2,11,3,13,290,363,0,22,0,50,0,72,0,578,1459
GUJARAT,GANDHINAGAR,2009,28,8,0,36,7,0,7,14,30,28,2,60,5,0,28,168,572,251,321,1345,30,11,45,7,6,192,506,0,10,3,174,0,187,215,3351,4890
GUJARAT,HIMATNAGAR,2009,34,15,1,50,15,0,15,30,36,35,1,72,12,0,10,86,200,98,102,508,53,73,24,11,9,151,561,0,23,0,208,0,231,240,2164,3365
GUJARAT,JAMNAGAR,2009,32,19,0,51,17,0,17,34,24,20,4,48,1,4,11,142,363,157,206,884,72,33,19,11,2,412,549,1,18,3,241,0,263,0,3269,4694
GUJARAT,JUNAGADH,2009,48,28,0,76,14,0,14,28,69,60,9,138,6,0,45,222,682,305,377,1637,90,56,36,19,21,515,962,1,48,10,473,0,532,225,2913,5521
GUJARAT,KHEDA NORTH,2009,23,12,0,35,15,0,15,30,34,31,3,68,11,0,14,101,290,101,189,706,44,28,27,7,12,276,617,0,27,0,102,0,129,223,2922,4168
GUJARAT,KUTCH,2009,35,20,0,55,10,0,10,20,39,34,5,78,2,0,15,162,423,249,174,1025,59,32,30,7,3,363,800,0,27,2,242,0,271,306,2192,3969
GUJARAT,MEHSANA,2009,29,21,0,50,10,0,10,20,55,50,5,110,10,0,20,137,608,207,401,1383,55,62,20,1,6,287,623,0,23,1,154,0,178,192,2981,4672
GUJARAT,NARMADA,2009,13,3,1,17,6,0,6,12,3,3,0,6,2,0,1,16,32,14,18,83,9,9,2,0,1,83,178,0,6,0,10,0,16,74,484,755
GUJARAT,NAVSARI,2009,18,5,0,23,4,0,4,8,1,1,0,2,2,0,7,32,77,51,26,195,6,21,10,7,4,35,83,0,0,1,31,0,32,0,609,870
GUJARAT,PALANPUR,2009,38,16,0,54,26,0,26,52,89,87,2,178,12,0,40,214,462,185,277,1190,69,28,41,11,18,1116,1486,0,55,1,217,0,273,203,1669,4325
GUJARAT,PANCHMAHAL,2009,35,16,0,51,15,0,15,30,52,51,1,104,15,0,17,117,278,124,154,705,39,41,18,0,26,324,448,0,27,3,147,0,177,0,2290,3460
GUJARAT,PATAN,2009,21,11,1,33,19,0,19,38,21,20,1,42,9,0,18,79,331,126,205,768,38,15,15,6,8,308,526,0,43,0,136,0,179,136,1349,2564
GUJARAT,PORBANDAR,2009,11,7,0,18,3,0,3,6,18,17,1,36,0,0,4,44,76,30,46,200,11,19,6,2,2,97,200,0,2,2,53,0,57,63,553,973
GUJARAT,RAJKOT COMMR.,2009,35,26,1,62,8,0,8,16,47,38,9,94,9,0,41,233,1154,753,401,2591,68,52,40,19,10,407,703,1,19,8,271,0,299,107,1919,4475
GUJARAT,RAJKOT RURAL,2009,41,28,4,73,28,0,28,56,57,52,5,114,7,0,19,166,369,215,154,930,45,50,15,7,14,224,683,5,32,3,279,0,319,328,2548,4269
GUJARAT,SURAT COMMR.,2009,101,15,2,118,28,0,28,56,119,74,45,238,20,3,80,439,2220,1474,746,4982,83,30,171,32,5,623,1417,9,34,2,351,0,396,473,2724,7564
GUJARAT,SURAT RURAL,2009,39,5,0,44,10,0,10,20,12,12,0,24,6,0,8,30,111,68,43,266,12,18,15,1,3,135,532,0,4,0,21,0,25,348,668,1446
GUJARAT,SURENDRANAGAR,2009,40,10,1,51,18,0,18,36,58,54,4,116,4,0,13,87,210,105,105,524,48,62,13,11,2,401,783,0,39,3,120,0,162,246,1565,2951
GUJARAT,TAPI,2009,15,0,0,15,7,0,7,14,4,4,0,8,0,0,5,15,56,24,32,132,5,6,6,2,1,86,215,0,0,0,7,0,7,109,339,663
GUJARAT,VADODARA COMMR.,2009,24,25,0,49,6,0,6,12,33,28,5,66,5,0,21,276,1426,939,487,3154,134,32,92,7,2,253,645,0,17,0,178,0,195,125,2404,5060
GUJARAT,VADODARA RURAL,2009,52,14,4,70,23,0,23,46,69,66,3,138,9,0,11,61,267,109,158,615,42,44,8,8,8,304,761,0,35,0,75,0,110,347,1455,2836
GUJARAT,VALSAD,2009,22,2,0,24,10,0,10,20,12,12,0,24,5,1,7,115,266,169,97,660,12,17,41,3,2,128,203,0,5,0,27,0,32,0,1102,1777
GUJARAT,W.RLY,2009,16,1,0,17,1,0,1,2,1,1,0,2,5,0,8,7,599,55,544,1218,7,3,1,1,0,43,61,0,5,2,3,0,10,6,153,862
HARYANA,AMBALA,2009,35,18,1,54,28,0,28,56,20,16,4,40,5,2,21,244,421,260,161,1114,3,22,106,2,7,190,337,14,18,17,155,0,204,7,1009,2345
HARYANA,BHIWANI,2009,48,40,6,94,37,0,37,74,74,53,21,148,5,0,23,176,460,295,165,1124,172,15,91,2,16,250,556,17,37,21,88,0,163,10,1144,2732
HARYANA,FARIDABAD,2009,60,47,8,115,35,0,35,70,86,62,24,172,5,42,23,258,1136,887,249,2600,129,132,44,3,4,175,730,17,26,4,179,0,226,243,1753,4409
HARYANA,FATEHABAD,2009,33,14,3,50,9,0,9,18,47,34,13,94,1,2,7,107,272,161,111,661,17,4,35,1,4,159,228,12,10,7,80,0,109,8,795,1627
HARYANA,GRP,2009,25,7,1,33,3,0,3,6,3,1,2,6,5,2,18,0,467,104,363,959,10,1,11,0,0,15,60,10,2,216,1,0,229,23,444,1264
HARYANA,GURGAON,2009,84,38,3,125,29,0,29,58,59,42,17,118,16,45,127,556,2469,1889,580,5682,89,82,250,6,14,160,626,24,21,40,128,0,213,25,2075,6340
HARYANA,HISSAR,2009,56,60,4,120,33,0,33,66,42,26,16,84,7,43,43,216,590,385,205,1489,43,20,107,4,9,372,559,15,27,14,208,0,264,4,1429,3346
HARYANA,JHAJJAR,2009,66,36,8,110,20,0,20,40,27,15,12,54,7,1,30,145,356,223,133,895,58,24,33,0,9,124,433,13,20,20,78,0,131,185,537,1797
HARYANA,JIND,2009,47,39,1,87,35,0,35,70,46,30,16,92,7,3,29,281,431,262,169,1182,119,54,61,2,6,140,384,11,33,49,97,0,190,2,880,2373
HARYANA,KAITHAL,2009,21,19,3,43,24,0,24,48,19,16,3,38,4,10,22,124,285,173,112,730,0,81,15,0,2,184,294,13,20,0,187,0,220,12,699,1744
HARYANA,KARNAL,2009,27,46,2,75,48,0,48,96,51,40,11,102,11,11,22,263,661,392,269,1629,48,17,133,1,14,328,787,17,32,21,225,0,295,246,1127,3351
HARYANA,KURUKSHETRA,2009,29,20,1,50,43,0,43,86,57,47,10,114,13,5,34,214,590,309,281,1446,0,89,25,0,7,167,293,5,20,29,101,0,155,5,1031,2485
HARYANA,MAHENDRAGARH,2009,28,7,3,38,10,0,10,20,21,19,2,42,6,3,12,113,170,75,95,474,77,35,9,2,5,167,303,10,13,0,58,0,81,8,956,1713
HARYANA,MEWAT,2009,18,23,2,43,16,0,16,32,24,12,12,48,11,24,16,32,264,168,96,611,92,20,62,1,0,99,276,5,11,3,181,0,200,2,698,1604
HARYANA,PALWAL,2009,39,38,6,83,33,0,33,66,35,25,10,70,10,25,21,56,558,378,180,1228,134,44,32,0,8,189,414,12,23,0,88,0,123,7,979,2337
HARYANA,PANCHKULA,2009,14,6,1,21,18,0,18,36,17,10,7,34,8,11,23,181,379,212,167,981,2,19,70,3,0,45,140,1,12,0,72,0,85,1,671,1554
HARYANA,PANIPAT,2009,64,30,9,103,45,0,45,90,51,31,20,102,2,13,32,189,758,540,218,1752,34,55,14,0,8,168,546,19,26,44,117,0,206,267,867,2812
HARYANA,REWARI,2009,34,23,3,60,19,0,19,38,36,29,7,72,4,5,27,131,380,244,136,927,36,41,21,1,7,166,276,14,19,20,55,0,108,4,1079,2125
HARYANA,ROHTAK,2009,65,61,6,132,36,0,36,72,43,30,13,86,8,31,46,209,685,462,223,1664,68,33,95,1,4,164,561,18,30,38,113,0,199,196,888,2838
HARYANA,SIRSA,2009,36,18,2,56,24,0,24,48,43,28,15,86,1,1,14,134,319,195,124,788,29,13,29,1,5,277,358,6,10,0,97,0,113,4,659,1722
HARYANA,SONIPAT,2009,83,70,3,156,32,0,32,64,57,42,15,114,12,15,69,257,774,491,283,1901,5,18,109,1,17,239,675,17,21,46,129,0,213,286,1169,3429
HARYANA,YAMUNANAGAR,2009,36,30,2,68,26,0,26,52,58,51,7,116,5,3,20,191,492,344,148,1203,1,8,54,4,7,199,277,11,20,16,180,0,227,4,915,2282
HIMACHAL PRADESH,BADDIPOLICEDIST,2009,10,1,0,11,2,0,2,4,3,1,2,6,0,0,3,26,28,15,13,85,28,7,3,0,1,133,215,0,5,0,9,0,14,43,121,423
HIMACHAL PRADESH,BILASPUR,2009,8,6,2,16,14,0,14,28,6,5,1,12,1,0,1,37,47,17,30,133,41,8,20,0,7,45,161,1,28,4,21,0,54,40,726,1063
HIMACHAL PRADESH,CHAMBA,2009,8,3,3,14,20,0,20,40,16,15,1,32,0,0,1,95,23,3,20,142,28,2,4,0,6,46,140,0,29,0,14,0,43,54,359,711
HIMACHAL PRADESH,CID,2009,0,0,0,0,0,0,0,0,0,0,0,0,0,0,0,0,0,0,0,0,0,0,1,0,0,0,1,0,0,0,0,0,0,0,1,2
HIMACHAL PRADESH,G.R.P.,2009,2,0,0,2,0,0,0,0,0,0,0,0,0,0,0,0,2,0,2,4,2,0,1,0,0,0,3,0,0,0,0,0,0,0,2,9
HIMACHAL PRADESH,HAMIRPUR,2009,6,4,1,11,9,0,9,18,16,14,2,32,0,0,1,35,42,18,24,120,30,7,27,0,13,199,307,0,22,5,30,0,57,31,458,936
HIMACHAL PRADESH,KANGRA,2009,29,17,2,48,23,0,23,46,24,22,2,48,1,0,0,152,136,45,91,425,92,7,63,0,27,224,423,0,49,5,49,0,103,10,1576,2486
HIMACHAL PRADESH,KINNAUR,2009,2,1,0,3,6,0,6,12,2,1,1,4,0,0,0,14,5,0,5,24,8,2,2,0,1,14,67,0,3,0,2,0,5,40,101,203
HIMACHAL PRADESH,KULLU,2009,7,6,1,14,24,0,24,48,12,10,2,24,0,0,3,49,58,17,41,168,29,2,20,0,5,39,155,0,23,1,16,0,40,60,606,961
HIMACHAL PRADESH,LAHAUL-SPITI,2009,1,0,0,1,1,0,1,2,0,0,0,0,0,0,0,0,4,1,3,8,1,0,0,0,1,1,10,0,0,2,2,0,4,7,44,64
HIMACHAL PRADESH,MANDI,2009,9,7,1,17,22,0,22,44,14,11,3,28,1,0,2,75,61,22,39,200,82,8,34,0,16,145,350,0,59,5,29,0,93,65,1302,1937
HIMACHAL PRADESH,SHIMLA,2009,18,12,2,32,28,0,28,56,28,22,6,56,0,0,0,112,200,85,115,512,99,29,32,0,28,55,352,0,32,5,39,0,76,109,935,1763
HIMACHAL PRADESH,SIRMAUR,2009,7,5,0,12,15,0,15,30,10,9,1,20,0,0,5,73,60,30,30,198,68,13,25,0,4,58,233,0,34,2,28,0,64,65,437,909
HIMACHAL PRADESH,SOLAN,2009,7,4,0,11,8,0,8,16,9,6,3,18,1,0,1,67,83,58,25,235,45,12,10,0,6,182,298,0,13,2,15,0,30,43,346,854
HIMACHAL PRADESH,UNA,2009,11,7,1,19,11,0,11,22,10,6,4,20,0,0,4,49,74,16,58,201,38,20,22,2,9,89,229,0,21,6,30,0,57,49,541,994
JAMMU & KASHMIR,ANANTNAG,2009,6,19,0,25,8,0,8,16,81,81,0,162,0,0,7,132,182,36,146,503,136,7,34,2,13,8,234,0,84,38,4,0,126,34,598,1393
JAMMU & KASHMIR,AWANTIPORA,2009,5,3,0,8,5,0,5,10,11,11,0,22,0,0,4,17,50,5,45,121,21,2,8,0,0,0,56,0,17,0,0,0,17,25,304,472
JAMMU & KASHMIR,BANDIPORA,2009,5,3,1,9,4,0,4,8,54,49,5,108,0,0,3,38,54,5,49,149,49,0,9,1,8,0,67,0,66,11,0,0,77,0,159,465
JAMMU & KASHMIR,BARAMULLA,2009,20,54,0,74,14,0,14,28,86,80,6,172,0,0,7,169,222,24,198,620,138,6,31,5,38,8,226,0,127,25,0,0,152,0,630,1580
JAMMU & KASHMIR,BUDGAM,2009,3,28,2,33,10,0,10,20,76,71,5,152,0,0,11,85,265,21,244,626,182,7,23,5,9,2,240,0,105,34,1,0,140,12,509,1369
JAMMU & KASHMIR,CRIME JAMMU,2009,1,0,0,1,0,0,0,0,0,0,0,0,0,0,0,0,1,0,1,2,0,0,15,0,0,0,15,0,0,0,0,0,0,0,0,17
JAMMU & KASHMIR,CRIME SRINAGAR,2009,0,0,0,0,0,0,0,0,0,0,0,0,0,0,0,0,0,0,0,0,0,5,26,1,0,0,32,0,0,0,0,0,0,0,0,32
JAMMU & KASHMIR,DODA,2009,18,43,1,62,18,0,18,36,39,38,1,78,0,0,1,49,31,0,31,112,15,6,6,0,6,16,58,0,21,10,19,0,50,9,413,721
JAMMU & KASHMIR,GANDERBAL,2009,4,1,0,5,7,0,7,14,26,25,1,52,0,0,1,28,57,3,54,143,52,5,12,2,3,4,180,0,45,2,3,0,50,102,92,446
JAMMU & KASHMIR,HANDWARA,2009,6,22,0,28,5,0,5,10,17,16,1,34,0,0,0,25,33,2,31,91,14,1,16,1,9,2,43,0,46,5,0,0,51,0,179,381
JAMMU & KASHMIR,JAMMU,2009,18,77,3,98,29,0,29,58,69,66,3,138,1,0,5,280,603,349,254,1492,82,25,102,3,25,36,445,10,29,59,62,0,160,172,2056,3746
JAMMU & KASHMIR,KARGIL,2009,0,0,0,0,1,0,1,2,1,1,0,2,0,0,0,7,6,0,6,19,3,0,2,0,1,0,15,0,1,0,0,0,1,9,73,104
JAMMU & KASHMIR,KATHUA,2009,10,19,0,29,9,0,9,18,25,23,2,50,0,0,0,47,51,18,33,149,39,7,8,0,10,13,79,1,16,8,4,0,29,2,732,1001
JAMMU & KASHMIR,KISHTWAR,2009,10,26,1,37,3,0,3,6,23,23,0,46,0,0,0,23,24,0,24,71,1,8,3,2,3,1,20,0,3,5,5,0,13,2,133,276
JAMMU & KASHMIR,KULGAM,2009,10,8,0,18,9,0,9,18,52,50,2,104,0,0,5,52,73,13,60,203,79,5,25,1,14,54,211,0,73,9,0,0,82,33,218,720
JAMMU & KASHMIR,KUPWARA,2009,10,37,0,47,6,0,6,12,24,22,2,48,0,0,1,57,31,7,24,120,50,3,4,1,5,4,78,0,20,7,3,0,30,11,143,417
JAMMU & KASHMIR,LEH,2009,4,1,0,5,2,0,2,4,1,1,0,2,0,0,1,14,10,1,9,35,2,1,3,0,0,3,9,0,3,0,0,0,3,0,123,168
JAMMU & KASHMIR,POONCH,2009,17,33,1,51,12,0,12,24,21,19,2,42,0,0,0,25,42,1,41,109,107,3,10,2,0,60,184,0,29,1,17,0,47,2,376,758
JAMMU & KASHMIR,PULWAMA,2009,4,6,2,12,5,0,5,10,32,25,7,64,0,0,2,26,84,12,72,196,81,5,7,1,6,32,138,0,18,7,0,0,25,6,109,433
JAMMU & KASHMIR,RAILWAYS,2009,1,1,0,2,0,0,0,0,0,0,0,0,0,0,0,0,14,1,13,28,0,0,1,0,0,0,1,0,0,2,0,0,2,0,8,27
JAMMU & KASHMIR,RAILWAYS KMR,2009,0,0,0,0,0,0,0,0,0,0,0,0,0,0,0,1,0,0,0,1,0,0,0,0,0,0,0,0,2,0,0,0,2,0,7,10
JAMMU & KASHMIR,RAJOURI,2009,11,19,7,37,22,0,22,44,35,33,2,70,0,0,0,52,47,7,40,146,26,9,23,1,16,44,137,1,25,3,44,0,73,18,807,1210
JAMMU & KASHMIR,RAMBAN,2009,5,12,0,17,12,0,12,24,15,15,0,30,0,0,0,18,20,6,14,58,22,2,6,0,5,4,40,0,8,6,0,0,14,1,533,669
JAMMU & KASHMIR,REASI,2009,15,25,0,40,9,0,9,18,14,13,1,28,0,0,0,18,51,4,47,120,3,2,5,0,11,5,30,0,10,7,0,0,17,4,338,517
JAMMU & KASHMIR,SAMBA,2009,9,6,0,15,6,0,6,12,8,7,1,16,0,0,0,34,46,17,29,126,14,1,7,0,6,6,35,0,4,4,5,0,13,1,526,683
JAMMU & KASHMIR,SHOPIAN,2009,12,18,0,30,5,0,5,10,41,41,0,82,0,0,6,40,83,9,74,212,73,6,11,2,8,3,114,0,48,5,0,0,53,11,118,490
JAMMU & KASHMIR,SRINAGAR,2009,23,70,2,95,21,0,21,42,113,106,7,226,0,0,14,291,505,317,188,1315,266,11,72,7,21,22,461,0,165,118,27,0,310,62,1150,2960
JAMMU & KASHMIR,UDHAMPUR,2009,10,16,3,29,15,0,15,30,9,9,0,18,0,0,1,38,46,18,28,131,17,5,6,0,0,4,33,0,7,5,2,0,14,1,725,910
JHARKHAND,BOKARO,2009,58,17,2,77,18,0,18,36,37,33,4,74,16,0,33,86,570,135,435,1275,93,67,71,0,7,0,238,16,2,0,77,0,95,0,1306,2476
JHARKHAND,CHAIBASA,2009,118,42,2,162,34,0,34,68,13,13,0,26,9,0,25,17,138,45,93,327,22,7,19,0,2,58,140,6,23,0,37,0,66,32,208,812
JHARKHAND,CHATRA,2009,38,40,4,82,16,0,16,32,21,20,1,42,13,0,9,34,70,13,57,196,84,2,9,0,2,65,255,11,0,0,7,0,18,93,340,858
JHARKHAND,DEOGHAR,2009,51,57,1,109,45,0,45,90,29,15,14,58,29,2,27,115,270,49,221,713,115,7,52,0,15,218,484,18,4,22,36,0,80,77,398,1588
JHARKHAND,DHANBAD,2009,69,33,11,113,36,0,36,72,81,65,16,162,73,7,49,251,1056,559,497,2492,204,25,62,2,5,164,463,45,24,3,59,0,131,1,1527,3787
JHARKHAND,DHANBAD RLY.,2009,7,0,0,7,0,0,0,0,3,0,3,6,9,0,16,4,158,20,138,345,6,0,3,0,0,0,9,0,3,0,1,0,4,0,100,310
JHARKHAND,DUMKA,2009,68,8,11,87,61,0,61,122,34,21,13,68,17,0,15,47,188,50,138,455,87,20,29,0,5,317,559,5,2,0,56,0,63,101,448,1519
JHARKHAND,GARHWA,2009,48,31,1,80,27,0,27,54,37,31,6,74,5,1,32,34,88,3,85,248,199,19,47,0,10,267,592,12,11,0,35,0,58,50,367,1321
JHARKHAND,GIRIDIH,2009,86,32,1,119,28,0,28,56,36,0,36,72,40,3,22,61,296,75,221,718,261,51,23,0,13,143,542,45,37,51,3,0,136,51,1281,2564
JHARKHAND,GODDA,2009,66,41,0,107,24,0,24,48,36,29,7,72,6,1,19,48,152,36,116,378,118,12,10,0,8,169,346,7,20,0,30,0,57,29,440,1236
JHARKHAND,GUMLA,2009,168,37,10,215,39,0,39,78,36,14,22,72,13,0,36,14,106,42,64,275,52,6,25,1,17,108,279,1,7,0,12,0,20,70,168,926
JHARKHAND,HAZARIBAGH,2009,61,93,4,158,33,0,33,66,53,48,5,106,11,16,34,66,420,119,301,967,190,20,41,3,15,143,587,32,9,0,9,0,50,175,981,2409
JHARKHAND,JAMSHEDPUR,2009,106,216,18,340,46,0,46,92,64,40,24,128,25,1,72,138,1327,705,622,2890,85,59,112,0,17,758,1195,8,33,4,78,1,124,164,263,3595
JHARKHAND,JAMSHEDPUR RLY.,2009,6,1,0,7,1,0,1,2,3,3,0,6,5,0,10,25,152,7,145,344,0,0,8,0,0,17,25,0,1,0,2,0,3,0,51,282
JHARKHAND,JAMTARA,2009,13,35,0,48,21,0,21,42,12,0,12,24,6,0,7,15,62,24,38,152,32,0,28,1,2,0,85,10,14,0,14,0,38,22,155,449
JHARKHAND,KHUNTI,2009,72,6,1,79,4,0,4,8,15,5,10,30,4,0,13,4,42,7,35,105,30,1,3,0,0,26,104,0,2,0,6,1,9,44,66,340
JHARKHAND,KODERMA,2009,28,4,2,34,6,0,6,12,14,11,3,28,8,3,10,21,130,48,82,302,100,36,53,1,3,5,263,13,8,2,37,0,60,65,438,987
JHARKHAND,LATEHAR,2009,43,19,4,66,13,0,13,26,22,15,7,44,16,3,22,12,58,9,49,169,34,2,11,0,7,56,157,6,4,0,2,0,12,47,277,658
JHARKHAND,LOHARDAGGA,2009,32,8,5,45,20,0,20,40,10,5,5,20,5,3,25,15,63,20,43,174,13,3,16,1,5,1,78,1,5,0,14,0,20,39,188,472
JHARKHAND,PAKUR,2009,33,45,5,83,46,0,46,92,18,6,12,36,2,0,1,10,62,13,49,137,80,2,16,0,2,139,303,3,12,0,33,0,48,64,120,693
JHARKHAND,PALAMU,2009,79,149,1,229,37,0,37,74,61,40,21,122,25,0,55,69,169,40,129,487,208,20,49,0,30,240,622,18,18,0,34,0,70,75,551,1888
JHARKHAND,RAMGARH,2009,26,6,2,34,16,0,16,32,19,18,1,38,10,7,26,31,247,34,213,568,49,16,25,0,4,26,295,12,5,0,20,0,37,175,294,1016
JHARKHAND,RANCHI,2009,202,211,16,429,63,0,63,126,113,42,71,226,43,5,178,192,1582,829,753,3582,166,67,144,4,23,796,1396,19,12,0,68,4,103,196,1034,5138
JHARKHAND,SAHEBGANJ,2009,48,77,0,125,45,0,45,90,35,27,8,70,4,0,12,34,93,22,71,236,48,20,28,2,9,266,419,4,16,1,33,0,54,46,114,935
JHARKHAND,SARAIKELA,2009,47,50,1,98,23,0,23,46,15,11,4,30,11,0,22,42,198,82,116,471,25,7,17,0,0,108,219,3,1,0,7,0,11,62,226,865
JHARKHAND,SIMDEGA,2009,63,16,2,81,17,0,17,34,10,5,5,20,7,1,10,7,19,4,15,63,11,4,9,0,2,42,68,0,3,0,0,0,3,0,89,312
KARNATAKA,BAGALKOT,2009,41,35,2,78,8,0,8,16,18,9,9,36,0,0,9,94,134,62,72,371,144,7,58,6,6,252,473,7,59,0,58,0,124,0,1192,2130
KARNATAKA,BANGALORE COMMR.,2009,256,338,1,595,65,0,65,130,270,2,268,540,41,278,743,1592,11730,7074,4656,26114,337,214,3007,65,8,2653,6371,50,251,35,367,0,703,87,9992,32380
KARNATAKA,BANGALORE RURAL,2009,87,80,0,167,14,0,14,28,23,4,19,46,26,0,76,272,729,416,313,1832,166,15,182,4,0,563,930,14,48,0,79,0,141,0,2006,4384
KARNATAKA,BELGAUM,2009,106,92,2,200,39,0,39,78,60,43,17,120,16,8,76,342,534,265,269,1510,488,25,242,7,20,1079,1908,10,220,3,311,0,544,47,3588,7315
KARNATAKA,BELLARY,2009,44,46,0,90,11,0,11,22,25,19,6,50,4,4,22,149,328,175,153,835,165,10,65,2,9,403,681,7,66,0,75,0,148,27,1747,3209
KARNATAKA,BIDAR,2009,22,41,2,65,12,0,12,24,14,4,10,28,3,1,22,133,157,57,100,473,110,12,36,0,14,912,1093,3,38,0,81,0,122,9,1972,3594
KARNATAKA,BIJAPUR,2009,64,64,2,130,19,0,19,38,28,23,5,56,3,0,18,147,157,81,76,482,288,8,74,2,14,594,980,0,73,0,139,0,212,0,1596,3290
KARNATAKA,CBPURA,2009,47,40,7,94,11,0,11,22,24,18,6,48,6,0,12,159,166,64,102,509,158,4,58,3,0,266,489,11,43,1,38,0,93,0,894,1948
KARNATAKA,CHAMARAJNAGAR,2009,23,19,0,42,8,0,8,16,8,7,1,16,2,0,6,74,150,33,117,382,95,1,25,2,0,433,556,6,55,0,44,0,105,0,710,1661
KARNATAKA,CHICKMAGALUR,2009,32,36,2,70,13,0,13,26,16,12,4,32,4,1,14,160,173,62,111,525,137,6,50,4,6,761,966,1,64,5,104,0,174,2,1324,2915
KARNATAKA,CHITRADURGA,2009,43,27,3,73,26,0,26,52,24,21,3,48,4,1,24,107,238,112,126,612,247,7,40,7,5,870,1176,10,102,0,83,0,195,0,2254,4122
KARNATAKA,DAKSHIN KANNADA,2009,61,64,0,125,14,0,14,28,15,5,10,30,3,0,37,278,304,174,130,926,232,5,129,6,21,402,807,1,61,2,69,0,133,12,2471,4187
KARNATAKA,DAVANAGERE,2009,27,24,3,54,16,0,16,32,17,15,2,34,6,1,28,195,298,110,188,826,278,9,76,4,0,451,821,12,90,0,112,0,214,3,1609,3259
KARNATAKA,DHARWAD COMMR.,2009,17,25,0,42,6,0,6,12,14,9,5,28,3,2,54,147,367,238,129,940,107,11,142,10,3,158,440,5,12,1,52,0,70,9,895,2040
KARNATAKA,DHARWAD RURAL,2009,20,23,1,44,4,0,4,8,12,1,11,24,1,0,8,32,54,10,44,149,112,8,11,0,2,158,291,3,29,0,31,0,63,0,769,1278
KARNATAKA,GADAG,2009,21,12,0,33,4,0,4,8,9,7,2,18,3,0,5,55,65,28,37,193,97,5,26,1,6,197,435,0,44,0,34,0,78,103,463,1150
KARNATAKA,GULBARGA,2009,145,104,1,250,32,0,32,64,49,41,8,98,9,16,77,258,305,131,174,970,548,15,88,5,57,1383,2118,8,68,0,170,0,246,22,2624,5984
KARNATAKA,HASSAN,2009,59,48,2,109,22,0,22,44,22,15,7,44,23,5,54,237,364,164,200,1047,161,9,85,3,0,1189,1447,15,75,0,103,2,195,0,2664,5142
KARNATAKA,HAVERI,2009,21,27,2,50,5,0,5,10,14,0,14,28,8,0,16,89,137,66,71,387,212,7,27,2,0,255,503,3,50,0,47,0,100,0,1217,2139
KARNATAKA,K.G.F.,2009,12,10,1,23,9,0,9,18,14,0,14,28,0,0,5,67,70,20,50,212,62,1,23,3,0,228,359,4,10,0,18,0,32,42,274,853
KARNATAKA,KODAGU,2009,31,23,3,57,14,0,14,28,13,8,5,26,3,0,8,119,94,17,77,318,41,1,18,1,3,556,623,5,24,2,46,0,77,3,818,1826
KARNATAKA,KOLAR,2009,30,28,0,58,10,0,10,20,15,8,7,30,5,5,15,141,163,78,85,492,166,4,16,1,0,236,434,11,17,2,18,0,48,11,965,1859
KARNATAKA,KOPPAL,2009,22,20,10,52,14,0,14,28,13,13,0,26,5,0,8,93,98,53,45,302,109,7,40,1,2,186,345,5,32,0,57,0,94,0,1194,1916
KARNATAKA,MANDYA,2009,74,72,3,149,16,0,16,32,27,19,8,54,12,3,45,333,462,222,240,1317,292,8,50,5,34,1085,1474,8,85,0,125,0,218,0,2752,5491
KARNATAKA,MYSORE COMMR.,2009,34,42,1,77,14,0,14,28,21,19,2,42,12,6,124,151,719,485,234,1731,150,13,128,2,0,270,563,6,22,0,188,0,216,0,1280,3183
KARNATAKA,MYSORE RURAL,2009,54,33,0,87,21,0,21,42,14,9,5,28,6,0,28,219,284,70,214,821,184,5,31,1,0,860,1081,18,89,0,114,0,221,0,1525,3486
KARNATAKA,RAICHUR,2009,49,27,5,81,21,0,21,42,18,18,0,36,3,1,6,88,106,58,48,310,227,11,72,5,4,502,838,9,85,4,141,0,239,17,1506,2907
KARNATAKA,RAILWAYS,2009,12,5,0,17,1,0,1,2,0,0,0,0,2,3,47,2,459,8,451,972,9,0,3,1,0,15,28,1,2,0,0,0,3,0,42,604
KARNATAKA,RAMANAGAR,2009,66,62,3,131,12,0,12,24,21,13,8,42,15,2,41,235,519,255,264,1331,240,3,40,4,20,648,955,11,70,0,62,0,143,0,2163,4237
KARNATAKA,SHIMOGA,2009,53,54,6,113,15,0,15,30,38,27,11,76,13,1,70,237,441,184,257,1203,342,11,82,5,19,1193,1661,5,137,3,255,0,400,9,2610,5599
KARNATAKA,TUMKUR,2009,83,54,9,146,19,0,19,38,23,6,17,46,17,6,59,212,585,258,327,1464,176,9,104,6,19,746,1065,13,85,0,79,0,177,5,2636,4945
KARNATAKA,UDUPI,2009,28,12,1,41,5,0,5,10,3,3,0,6,4,2,44,139,113,44,69,415,104,8,18,3,6,291,439,0,26,1,22,0,49,9,1567,2406
KARNATAKA,UTTAR KANNADA,2009,18,20,7,45,9,0,9,18,10,10,0,20,11,0,24,73,73,19,54,254,85,2,33,0,15,310,445,2,54,5,63,0,124,0,1789,2603
KERALA,ALAPUZHA,2009,20,33,8,61,26,0,26,52,14,10,4,28,7,0,36,220,304,107,197,871,410,14,231,0,13,1185,1853,1,174,23,217,0,415,0,4718,7654
KERALA,ERNAKULAM COMMR.,2009,12,12,1,25,20,0,20,40,11,5,6,22,5,6,28,67,322,119,203,750,92,7,277,1,6,313,698,1,49,14,95,0,159,2,7417,8758
KERALA,ERNAKULAM RURAL,2009,34,17,5,56,26,0,26,52,11,10,1,22,6,16,54,333,509,125,384,1427,307,16,136,5,10,1093,1570,0,130,24,161,0,315,3,9454,12350
KERALA,IDUKKI,2009,19,16,1,36,23,0,23,46,3,1,2,6,3,0,14,182,231,49,182,661,209,5,120,2,14,1286,1636,1,130,20,199,0,350,0,2672,5150
KERALA,KANNUR,2009,14,35,3,52,37,0,37,74,10,5,5,20,14,2,99,184,191,73,118,681,1016,8,99,4,113,1186,2431,0,131,16,280,0,427,5,3392,6839
KERALA,KASARGOD,2009,20,31,8,59,47,0,47,94,8,3,5,16,2,2,30,137,144,64,80,459,636,33,172,1,52,815,1710,0,77,6,190,0,273,1,1155,3567
KERALA,KOLLAM,2009,34,29,15,78,51,0,51,102,21,19,2,42,10,37,33,264,422,187,235,1188,693,31,159,4,22,1911,2823,2,299,11,432,0,744,3,4889,9372
KERALA,KOTTAYAM,2009,19,18,2,39,28,0,28,56,14,8,6,28,6,5,49,346,377,86,291,1160,371,31,298,4,18,1663,2385,0,162,34,192,0,388,0,4211,7848
KERALA,KOZHIKODE COMMR.,2009,5,10,1,16,18,0,18,36,8,3,5,16,3,27,114,158,325,192,133,952,330,32,156,5,20,513,1059,2,66,40,167,0,275,3,2002,4005
KERALA,KOZHIKODE RURAL,2009,19,25,5,49,33,0,33,66,28,22,6,56,1,2,20,166,175,74,101,539,744,9,122,1,70,1142,2090,1,137,14,267,0,419,2,2500,5483
KERALA,MALAPPURAM,2009,24,31,6,61,35,0,35,70,17,10,7,34,9,13,52,275,358,178,180,1065,521,9,213,14,21,737,1516,0,141,33,545,0,719,1,3939,6994
KERALA,PALAKKAD,2009,36,21,10,67,49,0,49,98,13,7,6,26,6,13,34,215,234,96,138,736,458,51,241,2,23,1051,1832,3,105,30,315,0,453,6,5108,8024
KERALA,PATHANAMTHITTA,2009,15,18,0,33,24,0,24,48,11,10,1,22,2,5,27,162,213,77,136,622,336,11,102,4,12,991,1459,0,156,19,120,0,295,3,3188,5419
KERALA,RAILWAYS,2009,1,1,0,2,0,0,0,0,0,0,0,0,0,27,3,1,182,0,182,395,3,0,3,0,0,20,26,0,11,6,0,0,17,0,11,269
KERALA,THRISSUR,2009,23,38,24,85,32,0,32,64,19,10,9,38,7,26,75,211,409,169,240,1137,699,24,392,3,37,993,2155,3,153,29,345,0,530,7,6582,10131
KERALA,TRIVANDRUM COMMR.,2009,12,32,1,45,40,0,40,80,18,13,5,36,22,58,77,215,621,241,380,1614,518,41,370,6,34,777,1747,1,175,43,106,0,325,1,2738,5906
KERALA,TRIVANDRUM RURAL,2009,27,34,9,70,57,0,57,114,43,32,11,86,9,23,79,339,445,160,285,1340,581,22,218,9,30,1871,2731,3,382,18,279,0,682,0,3830,8308
KERALA,WAYANADU,2009,9,7,1,17,22,0,22,44,7,5,2,14,0,4,6,79,102,32,70,293,162,10,85,1,8,727,997,2,62,15,97,0,176,4,882,2292
MADHYA PRADESH,ALIRAJPUR,2009,70,40,0,110,31,0,31,62,10,10,0,20,2,0,12,33,60,11,49,167,29,2,8,0,12,282,396,1,22,0,1,0,24,63,599,1277
MADHYA PRADESH,ANUPPUR,2009,26,9,0,35,35,0,35,70,7,6,1,14,3,1,19,98,73,28,45,267,20,1,17,0,10,167,231,8,65,2,50,0,125,16,700,1327
MADHYA PRADESH,ASHOK NAGAR,2009,32,19,5,56,38,0,38,76,6,5,1,12,1,0,7,91,121,41,80,341,16,0,16,0,8,746,844,6,79,3,45,0,133,58,757,2054
MADHYA PRADESH,BALAGHAT,2009,56,23,4,83,62,0,62,124,8,8,0,16,1,1,15,115,142,38,104,416,21,9,11,0,6,360,523,7,96,4,37,0,144,116,1294,2388
MADHYA PRADESH,BARWANI,2009,33,12,3,48,31,0,31,62,5,5,0,10,1,1,16,55,171,45,126,415,13,1,5,1,3,263,432,3,53,7,11,0,74,146,915,1749
MADHYA PRADESH,BETUL,2009,65,32,2,99,130,1,129,260,30,30,0,60,1,1,28,132,241,64,177,644,21,0,22,0,20,335,556,18,155,15,71,0,259,158,1697,3174
MADHYA PRADESH,BHIND,2009,76,79,5,160,23,0,23,46,32,24,8,64,3,13,80,142,219,83,136,676,63,5,26,1,13,1102,1346,38,57,13,67,0,175,136,1481,3674
MADHYA PRADESH,BHOPAL,2009,65,93,2,160,152,0,152,304,77,58,19,154,2,7,188,1079,2817,1715,1102,6910,143,10,356,4,10,2343,3138,46,244,34,231,0,555,272,7265,15440
MADHYA PRADESH,BHOPAL RLY.,2009,4,4,0,8,3,0,3,6,3,1,2,6,0,2,32,9,1021,17,1004,2085,3,0,5,0,1,4,14,2,12,2,0,0,16,1,251,1359
MADHYA PRADESH,BURHANPUR,2009,14,13,0,27,14,0,14,28,3,3,0,6,1,0,4,45,112,33,79,274,6,4,8,0,3,101,181,12,47,5,21,0,85,59,703,1175
MADHYA PRADESH,CHHATARPUR,2009,67,76,2,145,64,0,64,128,20,15,5,40,3,4,77,369,255,111,144,963,67,16,48,1,28,635,924,17,178,6,85,0,286,129,2900,5047
MADHYA PRADESH,CHHINDWARA,2009,73,22,2,97,138,0,138,276,32,27,5,64,0,0,21,225,322,125,197,890,70,2,48,0,26,1340,1702,18,252,36,160,0,466,216,2169,5172
MADHYA PRADESH,DAMOH,2009,47,59,0,106,39,0,39,78,18,17,1,36,2,0,45,195,173,79,94,588,19,7,30,0,16,1182,1329,23,147,0,70,0,240,75,983,3130
MADHYA PRADESH,DATIYA,2009,36,51,0,87,20,0,20,40,24,17,7,48,3,5,38,106,185,39,146,522,33,1,12,0,6,462,592,13,69,0,32,0,114,78,1441,2615
MADHYA PRADESH,DEWAS,2009,40,45,1,86,59,0,59,118,11,9,2,22,4,6,25,141,528,200,328,1232,44,5,30,0,25,456,749,7,154,20,142,0,323,189,2858,4790
MADHYA PRADESH,DHAR,2009,80,73,3,156,99,0,99,198,34,32,2,68,8,5,41,243,456,194,262,1209,94,63,19,0,33,530,1038,41,167,18,87,0,313,299,3423,5816
MADHYA PRADESH,DINDORI,2009,23,1,2,26,35,0,35,70,2,1,1,4,0,0,1,31,19,7,12,70,5,1,8,0,2,132,214,4,48,5,38,0,95,66,484,907
MADHYA PRADESH,GUNA,2009,43,20,3,66,54,0,54,108,9,8,1,18,5,5,20,115,219,84,135,583,54,6,18,2,13,897,1157,11,124,14,38,0,187,167,1296,3133
MADHYA PRADESH,GWALIOR,2009,104,128,23,255,73,0,73,146,85,67,18,170,9,12,244,923,1849,1279,570,4886,157,48,135,3,13,1266,1911,23,183,20,209,0,435,289,4233,10029
MADHYA PRADESH,HARDA,2009,12,11,0,23,19,0,19,38,7,4,3,14,0,0,6,92,128,62,66,354,8,3,6,0,1,496,560,3,36,7,5,0,51,46,493,1379
MADHYA PRADESH,HOSHANGABAD,2009,46,47,0,93,59,0,59,118,23,23,0,46,4,5,41,214,347,176,171,958,29,3,18,0,12,485,547,10,114,21,101,0,246,0,1983,3562
MADHYA PRADESH,INDORE,2009,132,208,3,343,82,0,82,164,36,29,7,72,5,20,320,1009,3927,2802,1125,9208,109,39,159,1,40,2505,3274,44,419,91,484,0,1038,421,8252,18306
MADHYA PRADESH,INDORE RLY.,2009,2,2,1,5,0,0,0,0,1,1,0,2,0,0,3,1,216,0,216,436,0,0,1,0,0,4,5,0,1,1,0,0,2,0,71,304
MADHYA PRADESH,JABALPUR,2009,92,92,0,184,129,0,129,258,44,33,11,88,1,2,96,455,1063,193,870,2680,90,9,137,1,11,785,1287,26,221,63,186,0,496,254,6233,9990
MADHYA PRADESH,JABALPUR RLY.,2009,1,1,0,2,1,0,1,2,1,1,0,2,0,1,8,5,406,10,396,826,2,0,0,0,0,4,6,0,6,2,1,0,9,0,90,529
MADHYA PRADESH,JHABUA,2009,20,17,0,37,30,0,30,60,18,18,0,36,2,2,23,69,111,54,57,318,14,2,1,0,8,437,462,5,42,0,9,0,56,0,779,1589
MADHYA PRADESH,KATNI,2009,37,19,3,59,48,0,48,96,13,10,3,26,0,2,19,121,198,94,104,538,11,7,31,1,9,1147,1351,21,117,17,87,0,242,145,985,3038
MADHYA PRADESH,KHANDWA,2009,34,33,2,69,70,0,70,140,13,12,1,26,5,6,23,231,274,95,179,813,40,1,11,0,8,48,232,6,149,19,37,0,211,124,2024,3158
MADHYA PRADESH,KHARGON,2009,45,51,3,99,45,0,45,90,5,5,0,10,1,0,25,159,531,138,393,1247,38,4,12,0,19,305,518,27,142,9,29,0,207,140,2489,4079
MADHYA PRADESH,MANDLA,2009,23,14,0,37,43,0,43,86,9,9,0,18,0,0,7,80,57,18,39,201,7,1,12,0,3,247,351,4,58,12,19,0,93,81,977,1654
MADHYA PRADESH,MANDSAUR,2009,34,33,0,67,46,0,46,92,30,17,13,60,0,2,33,161,317,126,191,830,51,17,33,3,19,230,462,4,124,17,93,0,238,109,2089,3445
MADHYA PRADESH,MORENA,2009,63,80,1,144,31,0,31,62,40,29,11,80,3,22,54,130,379,217,162,967,116,2,32,0,4,1808,2112,37,83,5,66,0,191,150,1774,4880
MADHYA PRADESH,NARSINGHPUR,2009,39,36,4,79,52,0,52,104,5,4,1,10,0,0,11,98,185,65,120,479,34,6,22,1,11,1127,1299,26,101,23,42,0,192,98,768,2689
MADHYA PRADESH,NEEMUCH,2009,13,12,5,30,34,0,34,68,16,10,6,32,3,2,17,128,295,122,173,740,52,55,17,0,6,611,807,1,52,6,34,0,93,66,615,2040
MADHYA PRADESH,PANNA,2009,39,13,1,53,31,0,31,62,6,4,2,12,3,1,26,137,106,25,81,379,9,7,17,0,13,276,389,22,76,0,32,0,130,67,800,1682
MADHYA PRADESH,RAISEN,2009,55,44,4,103,93,0,93,186,10,8,2,20,0,1,26,113,273,89,184,686,35,0,14,0,13,1549,1760,19,165,16,66,0,266,149,1256,3901
MADHYA PRADESH,RAJGARH,2009,32,47,1,80,68,0,68,136,33,27,6,66,2,1,34,154,339,146,193,869,75,4,16,0,61,350,657,9,153,25,76,0,263,151,2798,4429
MADHYA PRADESH,RATLAM,2009,45,31,0,76,67,0,67,134,19,18,1,38,2,2,45,131,306,118,188,792,49,62,36,0,17,233,512,6,111,21,73,0,211,115,2266,3637
MADHYA PRADESH,REWA,2009,64,43,0,107,73,0,73,146,30,25,5,60,1,1,46,353,527,204,323,1455,47,15,47,1,22,734,1049,44,119,2,80,1,246,183,2725,5158
MADHYA PRADESH,SAGAR,2009,76,115,7,198,127,0,127,254,44,40,4,88,2,3,55,395,526,247,279,1507,102,24,26,0,27,2763,3133,46,361,5,168,0,580,191,3529,8592
MADHYA PRADESH,SATNA,2009,60,48,3,111,145,0,145,290,23,18,5,46,3,3,72,383,469,285,184,1399,43,17,35,0,18,1112,1524,40,194,11,119,0,364,299,2607,5704
MADHYA PRADESH,SEONI,2009,38,26,3,67,61,0,61,122,12,8,4,24,1,2,21,106,139,52,87,408,56,15,43,0,10,269,522,15,85,14,26,0,140,129,1627,2698
MADHYA PRADESH,SHAHDOL,2009,28,12,0,40,42,0,42,84,11,8,3,22,1,0,23,211,209,57,152,653,18,9,29,0,9,210,275,11,113,5,73,0,202,0,1829,2843
MADHYA PRADESH,SHAJAPUR,2009,34,40,1,75,79,0,79,158,18,13,5,36,1,2,33,139,469,194,275,1113,31,15,10,0,33,1211,1452,8,138,22,71,0,239,152,1168,3675
MADHYA PRADESH,SHEOPUR,2009,17,17,0,34,14,0,14,28,7,3,4,14,1,0,16,43,60,15,45,180,42,0,11,1,2,302,384,5,18,0,26,0,49,26,669,1277
MADHYA PRADESH,SHIVPURI,2009,62,40,4,106,55,0,55,110,32,20,12,64,7,3,57,143,265,120,145,740,57,11,24,3,26,1148,1441,16,124,8,43,0,191,172,1794,4094
MADHYA PRADESH,SIDHI,2009,23,7,1,31,24,0,24,48,14,13,1,28,1,0,11,135,125,22,103,397,7,4,14,2,4,327,459,20,80,6,36,0,142,101,1242,2184
MADHYA PRADESH,SIHORE,2009,34,54,1,89,63,0,63,126,25,23,2,50,3,3,18,170,293,99,194,780,27,16,31,0,18,380,611,9,88,16,47,0,160,139,1902,3337
MADHYA PRADESH,SINGRAULI,2009,37,14,4,55,45,0,45,90,16,14,2,32,12,0,11,114,156,33,123,449,48,2,7,0,7,268,423,16,92,2,72,0,182,91,1025,2039
MADHYA PRADESH,TIKAMGARH,2009,51,34,3,88,67,0,67,134,13,12,1,26,1,3,29,139,140,43,97,452,50,4,33,0,9,919,1122,18,136,3,52,0,209,107,1519,3330
MADHYA PRADESH,UJJAIN,2009,76,121,4,201,46,0,46,92,27,23,4,54,3,2,106,399,1025,429,596,2560,168,25,70,1,31,1398,1873,20,167,45,210,0,442,180,4582,8706
MADHYA PRADESH,UMARIYA,2009,20,4,0,24,29,0,29,58,4,3,1,8,0,0,9,62,75,21,54,221,11,0,12,0,4,90,162,3,54,0,38,0,95,45,740,1200
MADHYA PRADESH,VIDISHA,2009,48,47,1,96,80,0,80,160,15,13,2,30,0,2,33,234,341,141,200,951,55,15,41,0,18,751,1007,19,216,30,87,0,352,127,2218,4378
MAHARASHTRA,AHMEDNAGAR,2009,81,75,3,159,55,0,55,110,42,25,17,84,52,9,146,479,1399,539,860,3484,497,53,206,15,34,690,2127,0,106,0,557,0,663,632,1399,6530
MAHARASHTRA,AKOLA,2009,43,68,7,118,21,0,21,42,33,26,7,66,10,2,77,308,943,174,769,2283,159,15,93,6,32,765,1196,10,97,63,131,0,301,126,1218,4227
MAHARASHTRA,AMRAVATI COMMR.,2009,16,26,0,42,17,0,17,34,23,20,3,46,3,8,41,227,697,191,506,1673,89,19,60,8,12,328,594,0,28,27,99,0,154,78,823,2629
MAHARASHTRA,AMRAVATI RURAL,2009,75,37,4,116,49,0,49,98,29,27,2,58,8,0,24,254,867,85,782,2020,91,18,54,5,82,916,1360,1,121,34,149,0,305,194,1197,4209
MAHARASHTRA,AURANGABAD COMMR.,2009,37,46,2,85,22,0,22,44,28,17,11,56,11,7,97,319,1123,510,613,2680,159,33,124,1,8,478,961,5,61,21,159,0,246,158,828,3727
MAHARASHTRA,AURANGABAD RURAL,2009,44,37,5,86,14,0,14,28,5,4,1,10,18,5,20,158,465,159,306,1131,204,6,43,3,32,675,1237,28,49,4,248,0,329,274,597,2934
MAHARASHTRA,BEED,2009,80,53,1,134,26,0,26,52,36,20,16,72,48,6,93,284,525,166,359,1481,499,24,113,2,38,940,1892,16,79,10,389,0,494,276,800,4338
MAHARASHTRA,BHANDARA,2009,26,8,0,34,17,0,17,34,12,12,0,24,4,0,13,189,527,63,464,1260,40,4,50,6,20,295,557,4,31,13,68,0,116,142,790,2259
MAHARASHTRA,BULDHANA,2009,53,59,0,112,27,0,27,54,29,23,6,58,18,5,37,261,827,176,651,1975,199,14,69,8,56,780,1349,27,128,55,221,0,431,223,1164,4260
MAHARASHTRA,CHANDRAPUR,2009,49,33,3,85,44,0,44,88,19,17,2,38,5,2,22,266,730,152,578,1755,110,28,64,5,57,715,1224,9,132,171,158,0,470,245,1616,4483
MAHARASHTRA,DHULE,2009,45,36,1,82,12,0,12,24,13,9,4,26,16,1,22,174,351,105,246,915,172,30,92,6,14,414,981,7,34,8,281,0,330,253,680,2662
MAHARASHTRA,GADCHIROLI,2009,66,45,4,115,12,0,12,24,14,13,1,28,19,0,5,81,165,34,131,435,20,4,9,2,75,201,390,1,23,6,27,0,57,79,330,1188
MAHARASHTRA,GONDIA,2009,43,23,1,67,33,0,33,66,20,17,3,40,4,3,9,143,334,57,277,827,32,3,44,4,30,322,568,3,67,21,48,0,139,133,591,1911
MAHARASHTRA,HINGOLI,2009,50,34,1,85,10,0,10,20,16,12,4,32,9,1,41,100,187,41,146,525,120,7,47,2,16,349,635,3,27,8,106,0,144,94,439,1667
MAHARASHTRA,JALGAON,2009,75,52,1,128,30,0,30,60,25,25,0,50,38,1,46,245,717,212,505,1764,289,95,221,5,15,720,1744,10,109,39,423,0,581,399,1182,4737
MAHARASHTRA,JALNA,2009,55,38,1,94,22,0,22,44,20,17,3,40,19,5,62,183,415,136,279,1099,192,12,92,2,17,534,1013,25,54,14,346,0,439,164,667,2939
MAHARASHTRA,KOLHAPUR,2009,46,36,1,83,35,0,35,70,22,18,4,44,17,0,49,295,745,330,415,1851,215,101,283,4,22,437,1375,18,61,15,130,0,224,313,1072,3917
MAHARASHTRA,LATUR,2009,70,36,1,107,33,0,33,66,28,28,0,56,14,3,33,212,427,198,229,1116,195,8,84,4,24,715,1239,15,49,0,159,0,223,209,1088,3407
MAHARASHTRA,MUMBAI COMMR.,2009,217,160,6,383,182,0,182,364,149,86,63,298,39,34,316,2769,12009,4183,7826,27176,305,511,2132,129,14,3892,7693,15,400,101,434,0,950,710,6738,31262
MAHARASHTRA,MUMBAI RLY.,2009,7,3,0,10,4,0,4,8,3,0,3,6,2,3,39,3,2076,0,2076,4199,6,12,36,0,0,45,100,0,12,4,0,0,16,1,91,2347
MAHARASHTRA,NAGPUR COMMR.,2009,95,72,2,169,45,0,45,90,73,52,21,146,18,17,317,724,1733,831,902,4542,209,68,302,19,16,791,1665,7,60,39,232,0,338,260,2686,7785
MAHARASHTRA,NAGPUR RLY.,2009,4,3,0,7,1,0,1,2,1,1,0,2,11,5,20,2,942,22,920,1922,6,3,6,7,0,21,44,0,7,2,0,0,9,1,118,1160
MAHARASHTRA,NAGPUR RURAL,2009,74,36,1,111,33,0,33,66,23,13,10,46,9,6,42,256,829,157,672,1971,106,28,31,5,28,618,1250,6,71,22,84,0,183,434,1241,3983
MAHARASHTRA,NANDED,2009,102,71,6,179,34,0,34,68,40,29,11,80,32,2,90,338,450,142,308,1362,271,28,126,14,69,1151,1906,30,62,3,346,0,441,247,1479,4991
MAHARASHTRA,NANDURBAR,2009,43,13,1,57,23,0,23,46,13,13,0,26,2,0,10,84,181,60,121,458,101,4,37,2,10,250,523,1,33,11,75,0,120,119,343,1356
MAHARASHTRA,NASIK COMMR.,2009,41,28,2,71,24,0,24,48,24,16,8,48,22,2,79,621,1705,850,855,4134,137,21,173,12,22,247,945,5,49,20,131,0,205,333,520,4218
MAHARASHTRA,NASIK RURAL,2009,73,48,1,122,46,0,46,92,25,20,5,50,31,2,39,195,571,188,383,1409,346,73,115,11,14,793,2018,9,64,31,290,0,394,666,1397,4840
MAHARASHTRA,NAVI MUMBAI,2009,45,41,4,90,19,0,19,38,20,10,10,40,11,23,128,460,1774,875,899,4170,139,72,313,13,3,411,1347,6,36,34,84,0,160,396,844,4876
MAHARASHTRA,OSMANABAD,2009,33,23,0,56,20,0,20,40,19,16,3,38,25,3,37,153,285,81,204,788,162,20,81,1,19,516,1011,3,64,9,153,0,229,212,854,2692
MAHARASHTRA,PARBHANI,2009,52,31,0,83,30,0,30,60,24,14,10,48,14,2,29,236,378,140,238,1037,132,7,57,3,26,953,1305,7,49,7,219,0,282,127,325,2708
MAHARASHTRA,PUNE COMMR.,2009,119,120,9,248,67,0,67,134,105,84,21,210,36,52,513,1305,5181,3261,1920,12268,468,76,613,58,19,1215,2988,7,100,72,235,0,414,539,2939,13848
MAHARASHTRA,PUNE RLY.,2009,3,3,0,6,1,0,1,2,2,1,1,4,9,0,23,1,443,2,441,919,4,2,5,0,0,5,18,0,0,0,0,0,0,2,38,541
MAHARASHTRA,PUNE RURAL,2009,125,61,6,192,72,0,72,144,57,38,19,114,45,19,116,746,1804,893,911,4534,387,50,178,8,16,808,2446,9,133,15,218,0,375,999,1665,7537
MAHARASHTRA,RAIGAD,2009,31,31,0,62,21,0,21,42,4,3,1,8,4,1,13,156,318,88,230,810,107,20,77,11,4,211,762,4,26,19,30,0,79,332,633,2053
MAHARASHTRA,RATNAGIRI,2009,24,4,0,28,14,0,14,28,12,8,4,24,3,0,14,103,212,46,166,544,99,25,53,12,19,179,516,0,36,20,51,0,107,129,468,1477
MAHARASHTRA,SANGLI,2009,67,32,0,99,37,0,37,74,22,9,13,44,7,3,25,219,513,155,358,1280,175,15,194,7,37,417,1141,12,45,10,66,0,133,296,578,2777
MAHARASHTRA,SATARA,2009,47,38,7,92,26,0,26,52,22,18,4,44,32,7,115,405,1023,409,614,2605,216,52,163,1,18,398,1291,4,57,7,131,0,199,443,1138,4350
MAHARASHTRA,SINDHUDURG,2009,11,5,1,17,8,0,8,16,4,3,1,8,1,0,8,97,132,40,92,370,52,15,53,7,9,109,331,1,12,6,11,0,30,86,244,872
MAHARASHTRA,SOLAPUR COMMR.,2009,18,19,0,37,22,0,22,44,7,6,1,14,3,1,30,145,347,166,181,873,47,3,97,3,3,133,387,0,10,5,68,0,83,101,403,1465
MAHARASHTRA,SOLAPUR RURAL,2009,80,68,5,153,50,0,50,100,43,29,14,86,37,6,79,332,584,203,381,1622,309,37,175,1,24,693,1716,5,96,0,210,0,311,477,1323,4634
MAHARASHTRA,THANE COMMR.,2009,122,74,2,198,66,0,66,132,87,55,32,174,16,25,170,1138,2770,1228,1542,6889,320,170,860,32,8,1217,2963,12,148,52,387,0,599,356,1538,9570
MAHARASHTRA,THANE RURAL,2009,138,47,4,189,53,0,53,106,34,20,14,68,30,11,98,587,1094,473,621,2914,351,51,197,20,18,744,2035,1,97,30,106,0,234,654,1055,5420
MAHARASHTRA,WARDHA,2009,29,28,4,61,41,0,41,82,18,15,3,36,6,4,38,251,800,86,714,1899,112,17,49,9,58,766,1198,1,84,32,100,0,217,187,1407,4041
MAHARASHTRA,WASHIM,2009,22,22,0,44,25,0,25,50,13,12,1,26,14,1,37,91,418,72,346,979,78,13,47,1,30,483,757,5,61,16,109,0,191,105,530,2121
MAHARASHTRA,YAVATMAL,2009,77,57,1,135,40,0,40,80,28,25,3,56,8,0,52,246,914,154,760,2134,103,28,58,4,37,986,1471,9,128,23,212,0,372,255,1384,4650
MANIPUR,BISHNUPUR,2009,16,35,0,51,2,0,2,4,7,5,2,14,0,16,0,5,20,8,12,61,3,0,9,0,12,30,54,0,10,0,0,0,10,0,103,268
MANIPUR,CHANDEL,2009,6,31,0,37,0,0,0,0,0,0,0,0,0,13,0,3,3,1,2,22,2,1,1,0,2,2,8,0,0,0,0,0,0,0,16,80
MANIPUR,CHURACHANDPUR,2009,15,10,0,25,3,0,3,6,4,3,1,8,0,3,0,2,10,4,6,25,0,0,5,0,2,0,7,0,1,0,0,0,1,0,33,88
MANIPUR,CID,2009,0,0,0,0,0,0,0,0,0,0,0,0,0,0,0,0,0,0,0,0,0,1,0,0,0,0,1,0,0,0,0,0,0,0,0,1
MANIPUR,IMPHAL EAST,2009,29,106,1,136,7,0,7,14,56,36,20,112,0,59,1,8,70,46,24,208,15,2,17,0,21,46,101,0,12,0,4,0,16,0,161,615
MANIPUR,IMPHAL WEST,2009,32,156,0,188,8,0,8,16,52,30,22,104,0,48,2,37,239,207,32,565,17,11,29,1,16,72,146,0,9,1,9,0,19,0,332,1071
MANIPUR,SENAPATI,2009,7,27,0,34,1,0,1,2,6,0,6,12,0,12,0,3,16,1,15,47,2,0,5,0,1,7,15,0,1,0,0,0,1,0,51,139
MANIPUR,TAMENGLONG,2009,5,5,0,10,0,0,0,0,0,0,0,0,0,3,0,0,2,0,2,7,2,1,1,0,1,4,9,0,0,0,0,0,0,0,11,35
MANIPUR,THOUBAL,2009,15,89,1,105,9,0,9,18,32,23,9,64,1,27,0,9,28,16,12,93,7,3,27,0,19,61,117,0,6,1,12,0,19,0,139,486
MANIPUR,UKHRUL,2009,6,19,0,25,1,0,1,2,2,0,2,4,0,7,0,1,6,0,6,20,0,1,2,0,7,2,12,0,0,0,0,0,0,0,15,69
MEGHALAYA,GARO HILLS EAST,2009,9,6,1,16,3,0,3,6,3,1,2,6,18,1,9,9,30,3,27,97,3,4,4,1,3,20,35,0,6,1,0,0,7,0,36,167
MEGHALAYA,GARO HILLS SOUTH,2009,4,1,0,5,0,0,0,0,3,0,3,6,5,0,0,1,14,0,14,34,0,0,1,1,0,2,5,0,2,0,1,0,3,1,13,49
MEGHALAYA,GARO HILLS WEST,2009,13,10,7,30,8,0,8,16,16,13,3,32,13,0,12,22,138,66,72,323,12,6,23,5,11,62,137,0,22,0,13,0,35,18,180,591
MEGHALAYA,JAINTIA HILLS,2009,40,5,1,46,24,0,24,48,8,1,7,16,2,0,3,20,61,14,47,147,0,9,13,1,11,53,101,0,8,0,0,0,8,14,110,383
MEGHALAYA,KHASI HILLS EAST,2009,28,10,1,39,34,0,34,68,17,7,10,34,10,0,34,72,230,81,149,576,0,4,61,1,14,38,157,0,26,0,9,0,35,39,176,804
MEGHALAYA,KHASI HILLS WEST,2009,18,6,0,24,20,0,20,40,2,0,2,4,10,0,5,22,27,3,24,91,2,1,2,0,9,10,24,0,4,0,0,0,4,0,76,214
MEGHALAYA,RI-BHOI,2009,16,1,2,19,23,0,23,46,7,4,3,14,6,0,4,1,45,13,32,101,1,2,9,0,6,22,40,0,4,0,1,1,6,0,89,240
MIZORAM,AIZAWL,2009,14,8,5,27,27,0,27,54,7,0,7,14,0,0,2,214,408,52,356,1032,0,12,37,9,4,45,133,0,29,0,4,0,33,26,197,1048
MIZORAM,CHAMPHAI,2009,6,2,0,8,15,0,15,30,0,0,0,0,0,0,0,35,74,0,74,183,0,1,3,0,0,10,14,0,4,0,0,0,4,0,20,170
MIZORAM,KOLASIB,2009,3,1,0,4,7,0,7,14,0,0,0,0,0,0,0,25,75,9,66,175,1,5,8,0,4,11,36,0,9,0,0,0,9,7,51,207
MIZORAM,LAWNGTLAI,2009,3,2,1,6,5,0,5,10,0,0,0,0,0,0,0,24,37,0,37,98,0,3,5,0,0,7,15,0,0,0,0,0,0,0,67,154
MIZORAM,LUNGLEI,2009,1,0,0,1,12,0,12,24,1,0,1,2,0,0,1,38,84,14,70,207,0,4,5,0,2,12,23,0,8,1,0,0,9,0,31,200
MIZORAM,MAMIT,2009,1,0,0,1,9,1,8,18,1,0,1,2,2,0,1,21,29,0,29,82,0,3,1,0,11,14,32,0,4,0,0,0,4,3,4,104
MIZORAM,SAIHA,2009,2,0,2,4,3,0,3,6,0,0,0,0,0,0,0,13,28,0,28,69,0,1,0,0,1,12,14,0,0,0,0,0,0,0,21,83
MIZORAM,SERCHHIP,2009,1,1,0,2,5,0,5,10,0,0,0,0,0,0,0,11,26,2,24,63,0,1,2,0,2,9,14,0,7,0,0,0,7,0,16,81
NAGALAND,DIMAPUR,2009,15,8,3,26,7,0,7,14,33,4,29,66,5,0,70,50,185,14,171,495,2,4,14,2,1,5,53,0,7,0,0,0,7,25,100,536
NAGALAND,KIPHIRE,2009,0,0,0,0,0,0,0,0,2,0,2,4,0,0,0,0,4,0,4,8,0,0,0,0,0,0,0,0,0,0,0,0,0,0,5,11
NAGALAND,KOHIMA,2009,8,3,2,13,6,0,6,12,12,4,8,24,0,0,11,12,63,46,17,149,0,1,7,0,0,5,13,0,0,0,0,0,0,0,48,178
NAGALAND,LONGLENG,2009,1,0,0,1,0,0,0,0,0,0,0,0,0,0,0,0,3,0,3,6,1,0,0,0,0,2,3,0,0,0,0,0,0,0,12,19
NAGALAND,MOKOKCHUNG,2009,3,5,1,9,0,0,0,0,1,0,1,2,0,0,2,0,25,0,25,52,1,0,8,0,0,1,10,0,0,0,0,0,0,0,10,57
NAGALAND,MON,2009,4,2,1,7,0,0,0,0,0,0,0,0,2,0,2,4,16,2,14,40,0,0,0,1,0,2,6,0,0,0,0,0,0,3,14,51
NAGALAND,PEREN,2009,6,4,0,10,2,0,2,4,1,0,1,2,0,0,0,6,8,1,7,22,0,0,1,0,0,6,7,0,1,0,0,0,1,0,2,37
NAGALAND,PHEK,2009,2,8,0,10,0,0,0,0,0,0,0,0,1,0,0,5,7,0,7,20,0,0,1,0,0,6,7,0,1,0,0,0,1,0,11,42
NAGALAND,TUENSANG,2009,0,1,0,1,1,0,1,2,1,0,1,2,0,0,3,1,1,0,1,6,0,0,0,0,0,0,2,0,1,0,0,0,1,2,17,28
NAGALAND,WOKHA,2009,6,3,0,9,3,0,3,6,0,0,0,0,0,0,3,0,21,2,19,45,0,1,0,0,3,9,17,0,1,0,0,0,1,4,4,58
NAGALAND,ZUNHEBOTO,2009,1,1,0,2,3,0,3,6,2,2,0,4,0,0,1,4,14,4,10,33,0,0,2,0,0,2,4,0,0,0,0,0,0,0,12,42
ODISHA,ANGUL,2009,42,86,0,128,59,0,59,118,36,30,6,72,18,2,62,152,379,100,279,992,110,2,43,2,23,25,328,10,224,8,82,0,324,123,1393,2881
ODISHA,BALASORE,2009,26,50,2,78,46,0,46,92,62,55,7,124,11,4,53,183,322,97,225,895,53,37,103,5,19,1423,1640,46,124,22,244,0,436,0,570,3405
ODISHA,BARAGARH,2009,29,69,3,101,25,0,25,50,10,10,0,20,6,0,51,80,165,53,112,467,81,0,22,4,15,59,311,7,86,10,36,0,139,130,514,1402
ODISHA,BERHAMPUR,2009,18,46,0,64,18,0,18,36,20,15,5,40,10,4,52,79,138,69,69,421,35,7,44,0,9,235,389,3,130,2,12,0,147,59,151,1072
ODISHA,BHADRAK,2009,44,25,0,69,46,0,46,92,42,39,3,84,1,0,13,71,134,45,89,353,35,7,63,0,18,31,224,23,108,9,134,0,274,70,1265,2139
ODISHA,BOLANGIR,2009,44,53,0,97,46,0,46,92,33,25,8,66,7,0,37,76,145,45,100,410,109,3,34,1,0,16,259,5,147,10,97,0,259,96,1134,2093
ODISHA,BOUDH,2009,16,9,0,25,7,0,7,14,1,1,0,2,1,0,5,18,25,2,23,74,17,2,4,2,7,149,181,4,27,0,6,0,37,0,32,332
ODISHA,CUTTACK,2009,25,9,0,34,25,0,25,50,48,46,2,96,14,0,54,98,181,48,133,528,53,0,26,0,13,89,316,30,24,5,133,0,192,135,1415,2377
ODISHA,DCP BBSR,2009,30,40,1,71,32,0,32,64,27,22,5,54,12,6,96,267,996,588,408,2373,54,14,104,2,12,785,1123,17,50,9,46,0,122,152,1313,4065
ODISHA,DCP CTC,2009,21,20,5,46,14,0,14,28,22,20,2,44,15,8,59,124,597,317,280,1400,37,4,50,0,2,45,229,8,31,2,78,0,119,91,959,2192
ODISHA,DEOGARH,2009,12,9,0,21,12,0,12,24,8,8,0,16,6,0,9,25,29,10,19,98,10,2,5,0,3,201,268,2,55,2,12,0,71,47,99,548
ODISHA,DHENKANAL,2009,49,30,0,79,23,0,23,46,24,19,5,48,10,1,50,72,205,66,139,543,90,9,23,0,17,55,305,15,159,4,30,0,208,111,712,1689
ODISHA,GAJAPATI,2009,19,16,0,35,9,0,9,18,8,7,1,16,2,0,5,18,39,10,29,103,60,2,9,0,36,8,127,1,49,9,14,0,73,12,148,464
ODISHA,GANJAM,2009,73,134,0,207,34,0,34,68,28,28,0,56,4,6,73,148,141,34,107,513,84,16,19,0,29,238,386,27,249,21,21,0,318,0,440,1785
ODISHA,JAGATSINGHPUR,2009,29,12,0,41,31,0,31,62,26,18,8,52,10,1,35,78,151,50,101,426,21,4,36,1,11,127,348,19,11,0,70,0,100,148,657,1478
ODISHA,JAJPUR,2009,59,27,0,86,32,0,32,64,54,51,3,108,13,0,42,103,271,99,172,700,40,12,30,1,19,1014,1228,30,86,6,110,0,232,112,191,2252
ODISHA,JHARSUGUDA,2009,25,26,1,52,7,0,7,14,6,6,0,12,4,2,54,91,228,68,160,607,56,18,21,2,14,242,462,5,41,4,25,0,75,109,304,1285
ODISHA,KALAHANDI,2009,28,16,1,45,30,0,30,60,24,24,0,48,2,1,32,49,78,23,55,240,50,5,49,2,10,197,370,7,75,8,53,0,143,57,549,1323
ODISHA,KANDHAMAL,2009,24,20,0,44,24,0,24,48,17,15,2,34,4,0,8,62,63,4,59,200,61,5,73,0,5,170,314,6,66,2,34,0,108,0,184,828
ODISHA,KENDRAPARA,2009,27,3,0,30,28,0,28,56,36,35,1,72,12,0,33,79,100,32,68,324,20,3,15,1,11,51,185,11,5,1,17,0,34,84,781,1318
ODISHA,KEONJHAR,2009,109,101,18,228,53,0,53,106,49,33,16,98,38,2,110,84,301,114,187,836,74,28,38,0,24,67,554,20,195,16,45,0,276,323,849,2544
ODISHA,KHURDA,2009,34,16,11,61,27,0,27,54,38,35,3,76,15,0,40,81,130,47,83,396,16,5,33,1,6,7,146,11,13,3,133,1,161,78,807,1506
ODISHA,KORAPUT,2009,36,39,0,75,41,0,41,82,31,27,4,62,23,0,31,56,98,17,81,306,77,2,20,1,11,26,294,2,82,3,95,0,182,157,440,1271
ODISHA,MALKANGIR,2009,36,17,0,53,15,0,15,30,12,10,2,24,18,0,7,13,25,2,23,88,39,1,6,0,12,8,79,0,21,2,17,0,40,13,62,324
ODISHA,MAYURBHANJ,2009,96,66,0,162,80,0,80,160,64,60,4,128,20,4,40,114,197,42,155,572,11,19,20,2,15,85,344,26,214,13,152,0,405,192,832,2262
ODISHA,NAYAGARH,2009,29,12,0,41,29,0,29,58,28,22,6,56,9,0,33,47,115,27,88,319,38,1,36,0,2,415,495,11,12,3,87,0,113,3,182,1092
ODISHA,NOWRANGPUR,2009,27,28,1,56,35,0,35,70,22,21,1,44,2,0,10,46,59,12,47,176,36,8,13,0,3,15,112,1,60,13,30,0,104,37,407,853
ODISHA,NUAPADA,2009,17,5,1,23,17,0,17,34,12,10,2,24,3,0,18,22,47,9,38,137,12,2,16,0,5,152,214,1,53,3,14,0,71,27,273,700
ODISHA,PURI,2009,40,72,0,112,29,0,29,58,48,38,10,96,9,3,124,185,349,117,232,1019,106,5,61,1,22,63,349,20,22,2,71,0,115,91,1433,2756
ODISHA,RAYAGADA,2009,22,16,2,40,36,0,36,72,16,16,0,32,5,1,22,27,75,5,70,205,39,9,17,2,6,18,92,3,55,2,35,0,95,1,342,751
ODISHA,ROURKELA,2009,65,46,1,112,38,0,38,76,23,20,3,46,32,4,69,126,273,114,159,777,43,12,34,1,7,66,341,5,83,4,58,0,150,178,638,1806
ODISHA,SAMBALPUR,2009,43,48,0,91,35,0,35,70,16,12,4,32,21,9,87,147,298,92,206,860,85,6,37,0,12,283,571,0,38,6,28,0,72,148,912,2259
ODISHA,SONEPUR,2009,17,15,0,32,17,0,17,34,17,3,14,34,3,0,10,22,38,9,29,111,36,0,10,1,3,79,159,3,46,1,15,0,65,30,141,504
ODISHA,SRP(CUTTACK),2009,1,2,0,3,2,0,2,4,3,3,0,6,1,1,10,11,401,99,302,825,3,2,6,0,0,56,67,1,7,0,0,0,8,0,57,564
ODISHA,SRP(ROURKELA),2009,8,1,0,9,1,0,1,2,4,2,2,8,3,2,14,18,209,26,183,455,3,0,5,0,0,3,15,0,8,0,2,0,10,4,139,424
ODISHA,SUNDARGARH,2009,30,47,1,78,20,0,20,40,15,13,2,30,16,2,40,65,134,29,105,391,24,6,12,2,12,313,530,4,41,5,11,0,61,161,235,1196
PUNJAB,AMRITSAR,2009,54,64,3,121,15,0,15,30,46,37,9,92,1,16,12,108,430,223,207,997,0,18,261,8,3,230,652,7,15,6,85,0,113,132,643,2157
PUNJAB,AMRITSAR RURAL,2009,31,27,0,58,14,0,14,28,18,14,4,36,0,2,4,44,74,23,51,198,0,7,94,0,3,124,298,4,6,0,26,0,36,70,190,738
PUNJAB,BARNALA,2009,23,24,3,50,13,0,13,26,7,5,2,14,0,1,1,54,86,26,60,228,0,3,38,3,1,114,229,1,6,0,7,0,14,70,182,637
PUNJAB,BATALA,2009,25,20,6,51,21,0,21,42,12,10,2,24,2,2,2,79,149,41,108,383,0,3,81,0,3,193,348,4,11,0,40,0,55,68,140,861
PUNJAB,BHATINDA,2009,52,74,9,135,32,0,32,64,36,29,7,72,1,7,9,198,402,251,151,1019,0,22,263,1,9,288,589,5,16,1,43,0,65,6,713,2187
PUNJAB,FARIDKOT,2009,24,25,3,52,17,0,17,34,7,6,1,14,0,0,2,56,98,42,56,254,0,6,65,0,3,195,269,3,9,0,21,0,33,0,248,782
PUNJAB,FATEHGARH SAHIB,2009,18,13,3,34,7,0,7,14,11,4,7,22,1,4,2,51,153,73,80,364,0,11,127,1,0,161,459,3,8,3,21,0,35,159,222,979
PUNJAB,FEROZPUR,2009,67,55,5,127,43,0,43,86,39,31,8,78,1,6,5,120,282,165,117,696,0,18,130,9,12,429,748,6,13,0,32,0,51,150,483,1905
PUNJAB,G.R.P,2009,9,4,1,14,1,0,1,2,0,0,0,0,0,0,2,0,59,12,47,120,0,1,13,0,0,17,31,2,0,0,0,0,2,0,359,468
PUNJAB,GURDASPUR,2009,31,32,30,93,14,0,14,28,32,26,6,64,0,1,0,56,125,77,48,307,0,11,45,0,3,126,330,2,12,0,40,0,54,145,372,1077
PUNJAB,HOSHIARPUR,2009,39,59,7,105,37,0,37,74,31,24,7,62,3,4,8,133,187,54,133,522,2,10,117,0,12,391,759,9,12,1,57,0,79,227,360,1706
PUNJAB,JALANDHAR,2009,58,133,9,200,35,0,35,70,96,71,25,192,5,5,33,326,738,329,409,1845,0,13,326,5,21,570,1193,13,61,0,140,0,214,258,954,3799
PUNJAB,KAPURTHALA,2009,25,47,6,78,21,0,21,42,20,14,6,40,1,4,5,90,189,53,136,478,6,2,93,2,1,250,461,3,5,0,23,0,31,107,268,1168
PUNJAB,KHANNA,2009,24,22,3,49,10,0,10,20,13,5,8,26,2,4,8,53,93,46,47,253,0,0,67,0,0,134,373,3,7,0,35,0,45,172,332,982
PUNJAB,LUDHIANA,2009,68,101,13,182,39,0,39,78,95,70,25,190,3,10,16,189,635,327,308,1488,0,24,296,3,6,272,838,10,31,9,92,0,142,237,973,3122
PUNJAB,LUDHIANA RURAL,2009,24,21,1,46,13,0,13,26,26,20,6,52,1,6,4,55,145,46,99,356,0,8,47,4,0,160,320,4,3,0,37,0,44,101,331,991
PUNJAB,MANSA,2009,37,27,4,68,13,0,13,26,14,9,5,28,1,3,1,36,61,20,41,163,0,4,68,0,3,204,279,8,13,1,11,0,33,0,290,799
PUNJAB,MOGA,2009,30,38,5,73,18,0,18,36,19,12,7,38,0,1,5,101,152,48,104,411,0,20,85,0,0,281,483,2,19,1,24,0,46,97,303,1201
PUNJAB,MUKTSAR,2009,29,32,1,62,20,0,20,40,11,8,3,22,0,1,2,77,150,63,87,380,0,1,53,2,0,151,271,2,2,0,14,0,18,64,205,817
PUNJAB,PATIALA,2009,45,61,5,111,28,0,28,56,56,46,10,112,0,5,9,177,394,217,177,979,0,24,300,2,12,347,1029,12,20,0,152,0,184,344,947,2940
PUNJAB,ROPAR,2009,22,16,2,40,13,0,13,26,16,14,2,32,0,3,3,72,124,45,79,326,0,1,67,3,3,90,299,3,9,3,20,0,35,135,279,884
PUNJAB,SANGRUR,2009,34,46,3,83,25,0,25,50,26,12,14,52,4,0,8,135,255,123,132,657,0,11,124,0,2,236,547,9,6,2,60,0,77,174,609,1769
PUNJAB,SAS NGR,2009,25,26,2,53,23,0,23,46,37,27,10,74,8,4,3,176,493,356,137,1177,0,7,132,0,0,144,685,6,15,5,32,0,58,402,312,1852
PUNJAB,SBS NAGAR,2009,23,14,1,38,12,0,12,24,6,6,0,12,1,4,23,66,88,30,58,270,0,4,98,5,4,224,421,2,4,0,43,0,49,86,153,861
PUNJAB,TARN TARAN,2009,36,33,4,73,27,0,27,54,18,13,5,36,3,3,4,55,62,23,39,189,0,5,108,15,0,167,380,3,16,1,6,0,26,85,212,863
RAJASTHAN,AJMER,2009,42,44,12,98,47,0,47,94,93,69,24,186,0,2,25,209,694,381,313,1624,23,20,662,1,7,188,1382,17,64,1,546,0,628,481,3097,6275
RAJASTHAN,ALWAR,2009,103,77,0,180,101,0,101,202,184,128,56,368,2,5,50,256,1611,920,691,3535,20,18,886,0,18,2628,4045,35,139,0,516,0,690,475,2968,10092
RAJASTHAN,BANSWARA,2009,33,12,0,45,40,0,40,80,53,49,4,106,0,0,11,47,114,50,64,286,59,8,100,5,22,674,989,3,43,0,143,0,189,121,798,2286
RAJASTHAN,BARAN,2009,36,86,1,123,55,0,55,110,85,84,1,170,2,2,8,94,261,92,169,628,12,11,240,2,13,378,783,9,130,1,289,0,429,127,1534,3376
RAJASTHAN,BARMER,2009,21,29,0,50,31,0,31,62,29,29,0,58,0,0,6,89,224,66,158,543,8,8,288,1,28,519,1028,14,96,0,150,0,260,176,1393,3110
RAJASTHAN,BHARATPUR,2009,71,78,2,151,82,0,82,164,188,131,57,376,3,3,14,79,1132,580,552,2363,4,20,633,1,21,457,1400,35,39,0,437,0,511,264,4831,8394
RAJASTHAN,BHILWARA,2009,36,42,6,84,52,0,52,104,109,87,22,218,3,1,37,264,761,446,315,1827,58,38,456,0,14,92,976,7,97,0,518,0,622,318,2576,5485
RAJASTHAN,BIKANER,2009,41,77,1,119,37,0,37,74,38,36,2,76,0,0,4,114,301,88,213,720,0,5,353,1,21,429,1077,11,83,0,353,0,447,268,1746,3883
RAJASTHAN,BUNDI,2009,24,86,7,117,37,0,37,74,115,93,22,230,3,0,16,115,249,113,136,632,29,6,208,0,15,916,1329,5,138,0,270,0,413,155,1271,3665
RAJASTHAN,CHITTORGARH,2009,43,26,4,73,44,0,44,88,96,70,26,192,2,1,23,157,479,255,224,1141,49,34,309,1,24,1229,1884,7,82,0,463,0,552,238,1443,4754
RAJASTHAN,CHURU,2009,32,26,1,59,33,0,33,66,45,22,23,90,0,0,3,103,196,52,144,498,1,5,424,3,15,512,1146,11,19,0,296,0,326,186,1254,3165
RAJASTHAN,DAUSA,2009,29,30,0,59,13,0,13,26,92,62,30,184,0,0,26,93,869,583,286,1857,14,12,261,0,13,159,701,14,19,0,144,0,177,242,3062,5092
RAJASTHAN,DHOLPUR,2009,48,87,1,136,30,0,30,60,67,52,15,134,2,5,23,62,519,218,301,1130,8,6,193,0,8,1599,1902,32,19,0,180,0,231,88,1197,4174
RAJASTHAN,DUNGARPUR,2009,29,15,1,45,29,0,29,58,43,36,7,86,1,0,9,47,72,26,46,201,54,18,38,2,17,132,371,11,47,0,97,0,155,110,1123,1895
RAJASTHAN,G.R.P.,2009,9,5,0,14,1,0,1,2,2,1,1,4,2,1,2,0,543,38,505,1091,2,1,4,2,0,0,13,2,9,0,0,0,11,4,339,928
RAJASTHAN,GANGANAGAR,2009,67,66,3,136,89,0,89,178,63,56,7,126,0,0,17,181,292,101,191,782,0,23,816,7,4,955,1982,13,61,1,646,0,721,177,2076,5557
RAJASTHAN,HANUMANGARH,2009,48,72,1,121,54,0,54,108,49,43,6,98,0,0,6,77,204,66,138,491,0,19,578,1,5,446,1194,16,60,0,266,0,342,145,1674,3721
RAJASTHAN,JAIPUR EAST,2009,21,30,3,54,29,0,29,58,66,55,11,132,2,6,106,449,2612,2085,527,5787,88,40,732,3,5,4,1051,6,53,0,179,0,238,179,2149,6762
RAJASTHAN,JAIPUR NORTH,2009,17,35,0,52,23,0,23,46,76,72,4,152,1,0,44,122,866,535,331,1899,29,44,629,2,0,455,1295,9,31,0,202,0,242,136,1184,3905
RAJASTHAN,JAIPUR RURAL,2009,76,25,0,101,49,0,49,98,99,85,14,198,7,3,34,316,1196,615,581,2752,58,30,850,2,26,629,2307,14,94,3,256,0,367,712,4573,9052
RAJASTHAN,JAIPUR SOUTH,2009,14,27,1,42,17,0,17,34,73,62,11,146,0,2,86,340,1835,1244,591,4098,52,211,1166,5,8,288,1897,5,18,0,192,0,215,167,1614,6121
RAJASTHAN,JAISALMER,2009,8,3,1,12,5,0,5,10,13,9,4,26,0,0,5,68,110,33,77,293,4,4,54,0,8,169,290,5,18,0,23,0,46,51,488,1037
RAJASTHAN,JALORE,2009,21,14,1,36,19,0,19,38,34,26,8,68,1,0,8,90,195,80,115,489,20,20,174,2,18,39,404,9,39,0,142,0,190,131,1707,2684
RAJASTHAN,JHALAWAR,2009,47,50,7,104,55,0,55,110,58,45,13,116,3,3,23,110,499,248,251,1137,59,19,189,0,34,995,1450,7,215,3,379,0,604,154,1436,4345
RAJASTHAN,JHUNJHUNU,2009,40,21,0,61,41,0,41,82,60,50,10,120,0,3,16,118,398,105,293,933,44,12,441,0,18,1337,2042,13,39,0,280,0,332,190,1166,4237
RAJASTHAN,JODHPUR CITY,2009,17,56,2,75,15,0,15,30,68,55,13,136,3,0,33,202,788,608,180,1814,6,21,590,5,8,474,1234,9,40,1,242,0,292,130,995,3705
RAJASTHAN,JODHPUR RURAL,2009,23,32,0,55,27,0,27,54,40,29,11,80,3,0,12,117,220,63,157,572,3,11,199,1,19,933,1409,19,43,0,97,0,159,243,864,2906
RAJASTHAN,KARAULI,2009,33,38,0,71,46,0,46,92,84,49,35,168,0,1,16,22,522,265,257,1083,6,18,214,0,20,7,364,14,25,0,138,0,177,99,2809,4112
RAJASTHAN,KOTA CITY,2009,26,126,4,156,23,0,23,46,87,76,11,174,2,13,59,133,974,700,274,2155,2,16,431,1,5,106,683,7,51,0,376,0,434,122,1681,4245
RAJASTHAN,KOTA RURAL,2009,24,57,2,83,29,0,29,58,39,32,7,78,1,2,21,64,176,85,91,440,22,9,147,0,10,204,498,4,99,3,230,0,336,106,1105,2354
RAJASTHAN,NAGAUR,2009,42,44,4,90,53,0,53,106,89,76,13,178,0,0,14,135,363,125,238,875,0,13,396,5,13,85,755,6,117,0,302,0,425,243,2307,4231
RAJASTHAN,PALI,2009,48,37,3,88,48,0,48,96,101,92,9,202,0,0,11,168,313,113,200,805,2,28,410,3,10,47,826,8,77,4,403,0,492,326,3208,5255
RAJASTHAN,PRATAPGARH,2009,27,24,0,51,54,0,54,108,63,59,4,126,0,0,2,53,96,27,69,247,47,2,70,0,10,418,615,2,50,0,180,0,232,68,552,1718
RAJASTHAN,RAJSAMAND,2009,15,10,1,26,11,0,11,22,47,42,5,94,1,0,11,87,175,76,99,449,59,8,145,0,13,663,1036,3,46,2,205,0,256,148,807,2457
RAJASTHAN,SAWAI MADHOPUR,2009,14,29,0,43,17,0,17,34,83,66,17,166,0,0,4,83,545,381,164,1177,6,10,168,0,11,1,292,10,18,0,171,0,199,96,2140,3406
RAJASTHAN,SIKAR,2009,55,28,3,86,36,0,36,72,84,59,25,168,2,3,11,123,492,190,302,1123,37,19,552,0,20,380,1345,21,18,0,323,0,362,337,2594,5138
RAJASTHAN,SIROHI,2009,27,29,2,58,18,0,18,36,28,25,3,56,1,0,9,112,143,46,97,408,27,13,155,0,15,465,824,4,64,1,132,0,201,149,639,2033
RAJASTHAN,TONK,2009,16,29,0,45,20,0,20,40,47,42,5,94,1,0,9,122,333,141,192,798,54,11,255,0,7,1027,1531,4,26,0,252,0,282,177,1153,3543
RAJASTHAN,UDAIPUR,2009,72,71,6,149,109,0,109,218,180,156,24,360,5,1,72,273,772,316,456,1895,179,31,621,3,33,1613,2839,15,159,4,353,0,531,359,2536,7467
SIKKIM,EAST,2009,7,4,2,13,5,0,5,10,2,2,0,4,0,0,2,52,24,4,20,102,18,0,9,1,3,35,96,0,4,0,4,0,8,30,87,289
SIKKIM,NORTH,2009,2,0,0,2,0,0,0,0,0,0,0,0,0,0,0,2,1,1,0,4,5,0,0,0,2,11,23,0,0,0,0,0,0,5,10,38
SIKKIM,SOUTH,2009,5,3,1,9,8,0,8,16,2,2,0,4,0,0,2,34,29,3,26,94,13,0,3,1,2,30,61,0,5,0,1,0,6,12,83,234
SIKKIM,WEST,2009,5,0,0,5,5,0,5,10,2,2,0,4,0,0,0,5,8,0,8,21,3,4,0,0,2,15,36,0,1,0,1,0,2,12,45,108
TAMIL NADU,ARIYALUR,2009,40,22,0,62,21,0,21,42,19,15,4,38,3,0,8,30,92,53,39,225,39,1,10,0,3,193,373,3,39,1,7,0,50,127,1397,2055
TAMIL NADU,CHENNAI,2009,96,175,0,271,39,0,39,78,42,37,5,84,7,0,84,398,1716,341,1375,3921,70,46,350,42,2,735,1847,19,42,10,154,0,225,602,6276,10905
TAMIL NADU,CHENNAI RLY.,2009,1,2,0,3,0,0,0,0,0,0,0,0,0,0,29,3,192,4,188,416,11,3,5,0,0,20,43,2,5,1,0,0,8,4,212,490
TAMIL NADU,CHENNAISUBURBAN,2009,72,118,0,190,46,0,46,92,28,18,10,56,6,2,72,301,839,181,658,2059,80,4,222,9,5,640,1652,20,51,65,59,0,195,692,3946,7277
TAMIL NADU,COIMBATORE RURAL,2009,48,39,0,87,7,0,7,14,31,24,7,62,8,0,52,163,508,205,303,1239,134,8,60,2,13,428,1228,4,41,12,56,0,113,583,2470,4667
TAMIL NADU,COIMBATORE URBAN,2009,24,26,0,50,9,0,9,18,23,9,14,46,2,0,26,197,1165,608,557,2555,17,12,103,35,3,324,773,4,21,3,48,0,76,279,1997,4318
TAMIL NADU,CUDDALORE,2009,46,92,0,138,20,0,20,40,34,34,0,68,0,0,13,98,465,164,301,1041,106,0,7,13,5,605,1190,13,32,0,39,0,84,454,4580,6622
TAMIL NADU,DHARMAPURI,2009,39,30,8,77,7,0,7,14,36,30,6,72,0,0,7,34,170,73,97,381,119,1,39,8,34,971,1452,6,56,5,34,0,101,280,1991,3875
TAMIL NADU,DINDIGUL,2009,69,77,0,146,10,0,10,20,61,61,0,122,3,0,38,71,360,46,314,832,82,12,83,4,24,454,1137,1,34,1,87,0,123,478,2920,4869
TAMIL NADU,ERODE,2009,52,30,0,82,16,0,16,32,44,37,7,88,6,1,26,135,467,174,293,1102,29,8,70,31,15,516,1177,1,31,9,12,0,53,508,3663,5670
TAMIL NADU,KANCHIPURAM,2009,72,54,0,126,28,0,28,56,11,11,0,22,1,0,7,104,339,113,226,790,107,0,28,22,3,442,1326,10,12,0,22,0,44,724,3629,5615
TAMIL NADU,KANYAKUMARI,2009,40,75,0,115,11,0,11,22,31,31,0,62,2,0,113,184,402,109,293,1103,0,8,134,14,29,720,1154,9,23,45,65,0,142,249,2714,4868
TAMIL NADU,KARUR,2009,26,15,1,42,7,0,7,14,13,10,3,26,1,0,7,24,232,89,143,496,16,7,9,6,2,151,427,2,13,7,14,0,36,236,1569,2358
TAMIL NADU,KRISHNAGIRI,2009,67,27,1,95,15,0,15,30,36,31,5,72,3,10,17,75,237,127,110,579,115,2,35,1,15,481,1059,1,31,3,24,0,59,410,2908,4514
TAMIL NADU,MADURAI RURAL,2009,68,82,1,151,18,0,18,36,49,39,10,98,2,0,77,119,341,82,259,880,179,4,134,1,16,606,1391,9,75,17,82,0,183,451,2821,5152
TAMIL NADU,MADURAI URBAN,2009,38,40,0,78,3,0,3,6,25,10,15,50,6,1,34,85,530,174,356,1186,22,8,143,23,16,124,461,4,7,19,67,0,97,125,1680,3000
TAMIL NADU,NAGAPATTINAM,2009,55,54,1,110,7,0,7,14,39,36,3,78,2,1,25,65,263,76,187,619,28,5,15,1,17,365,657,5,31,7,25,0,68,226,2739,3976
TAMIL NADU,NAMAKKAL,2009,32,32,1,65,14,0,14,28,44,28,16,88,5,3,16,65,325,183,142,739,56,6,48,7,16,604,1143,1,39,17,16,0,73,406,2657,4410
TAMIL NADU,NILGIRIS,2009,15,8,0,23,3,0,3,6,7,5,2,14,0,0,5,37,74,12,62,190,16,2,12,2,0,179,262,0,11,0,4,0,15,51,670,1096
TAMIL NADU,PERAMBALUR,2009,12,15,0,27,11,0,11,22,13,11,2,26,0,0,3,16,84,18,66,187,20,0,22,0,6,90,275,4,14,3,2,0,23,137,1068,1520
TAMIL NADU,PUDUKOTTAI,2009,40,38,0,78,5,0,5,10,27,22,5,54,0,0,5,56,155,49,106,371,38,12,17,2,17,253,621,4,21,1,18,0,44,282,2057,3048
TAMIL NADU,RAMNATHAPURAM,2009,31,97,2,130,10,0,10,20,56,52,4,112,2,0,20,92,216,39,177,546,53,0,60,12,25,436,774,1,22,2,23,0,48,188,2053,3401
TAMIL NADU,SALEM RURAL,2009,48,68,1,117,32,0,32,64,91,81,10,182,2,0,20,73,215,63,152,525,194,0,33,3,29,1458,2162,3,90,0,50,0,143,445,2926,5781
TAMIL NADU,SALEM URBAN,2009,21,26,0,47,20,0,20,40,39,19,20,78,0,0,28,48,323,154,169,722,39,13,50,4,2,281,504,3,13,7,40,0,63,115,1332,2404
TAMIL NADU,SIVAGANGAI,2009,34,32,0,66,5,0,5,10,30,23,7,60,5,0,8,62,232,34,198,539,21,5,50,5,11,193,497,1,11,9,30,0,51,212,1578,2534
TAMIL NADU,THANJAVUR,2009,69,80,1,150,5,0,5,10,36,36,0,72,4,13,64,223,844,359,485,1992,72,3,42,12,28,797,1342,8,60,3,17,0,88,388,4639,7408
TAMIL NADU,THENI,2009,34,69,0,103,9,0,9,18,49,40,9,98,0,0,29,98,215,51,164,557,72,1,118,1,22,589,1025,7,50,29,66,0,152,222,3534,5214
TAMIL NADU,THIRUNELVELI RURAL,2009,95,207,2,304,44,0,44,88,66,55,11,132,4,0,94,227,520,82,438,1365,2,3,63,3,72,1017,1501,5,91,0,65,0,161,341,4819,7740
TAMIL NADU,THIRUNELVELI URBAN,2009,12,67,1,80,5,0,5,10,26,24,2,52,0,0,14,49,306,102,204,675,6,1,37,0,6,128,254,1,7,0,6,0,14,76,1063,1811
TAMIL NADU,THIRUVALLUR,2009,34,48,1,83,12,0,12,24,20,19,1,40,1,0,8,68,150,24,126,377,64,3,47,3,1,299,719,6,15,0,26,0,47,302,2959,4067
TAMIL NADU,THIRUVANNAMALAI,2009,45,83,0,128,12,0,12,24,21,19,2,42,0,0,5,76,190,42,148,461,146,1,56,2,26,539,1171,3,18,0,29,0,50,401,2414,4067
TAMIL NADU,THIRUVARUR,2009,25,43,0,68,1,0,1,2,16,15,1,32,0,0,9,62,132,49,83,335,38,1,20,4,19,358,595,0,21,0,8,0,29,155,2268,3180
TAMIL NADU,THOOTHUGUDI,2009,57,163,0,220,20,0,20,40,35,30,5,70,2,0,31,189,525,103,422,1272,5,9,96,4,25,546,976,3,3,0,35,0,41,291,3397,5436
TAMIL NADU,TIRUPPUR,2009,58,29,0,87,12,0,12,24,61,42,19,122,6,2,68,239,905,305,600,2125,76,9,79,2,7,515,1450,3,46,8,46,0,103,762,2275,5208
TAMIL NADU,TRICHY RLY.,2009,0,0,0,0,0,0,0,0,0,0,0,0,0,0,9,0,86,1,85,181,4,1,1,0,0,17,25,0,2,0,0,0,2,2,48,170
TAMIL NADU,TRICHY RURAL,2009,41,45,0,86,10,0,10,20,17,16,1,34,3,0,3,37,186,76,110,415,25,0,20,1,14,178,631,6,24,0,27,0,57,393,2881,3911
TAMIL NADU,TRICHY URBAN,2009,16,23,1,40,6,0,6,12,20,16,4,40,1,1,7,54,506,147,359,1075,16,0,57,24,2,86,313,0,11,98,24,0,133,128,2512,3593
TAMIL NADU,VELLORE,2009,81,44,2,127,18,0,18,36,46,40,6,92,3,0,14,111,448,184,264,1024,11,3,25,41,13,560,1394,10,21,1,31,0,63,741,4638,6862
TAMIL NADU,VILLUPURAM,2009,70,98,2,170,62,0,62,124,80,66,14,160,6,0,22,109,398,213,185,933,223,3,45,1,22,692,1797,8,78,31,33,0,150,811,4377,7171
TAMIL NADU,VIRUDHUNAGAR,2009,53,52,0,105,16,0,16,32,50,41,9,100,1,0,27,144,359,64,295,890,46,10,112,7,15,557,998,4,30,87,69,0,190,251,2538,4428
TRIPURA,DHALAI,2009,20,4,0,24,18,0,18,36,9,4,5,18,0,0,2,21,39,2,37,101,11,7,4,2,5,92,139,1,16,0,47,0,64,18,104,420
TRIPURA,NORTH,2009,33,16,1,50,48,0,48,96,32,23,9,64,2,0,13,44,90,2,88,239,24,15,13,10,6,211,318,6,78,0,174,0,258,39,161,1016
TRIPURA,SOUTH,2009,19,20,0,39,48,0,48,96,27,21,6,54,0,0,29,64,100,9,91,293,63,8,40,4,15,250,429,8,153,1,192,0,354,49,399,1489
TRIPURA,WEST,2009,61,19,1,81,76,0,76,152,53,44,9,106,5,0,33,102,186,26,160,512,80,22,53,4,36,494,808,14,137,4,402,0,557,119,660,2561
UTTAR PRADESH,AGRA,2009,127,156,47,330,40,0,40,80,243,185,58,486,15,0,82,181,1770,1312,458,3818,224,144,320,39,4,447,1595,83,97,85,381,0,646,417,1802,6704
UTTAR PRADESH,ALIGARH,2009,143,222,28,393,58,0,58,116,244,214,30,488,14,11,129,234,1116,517,599,2620,288,140,309,6,20,307,1393,54,109,48,294,0,505,323,1636,5733
UTTAR PRADESH,ALLAHABAD,2009,110,105,28,243,38,0,38,76,148,126,22,296,6,0,51,242,773,444,329,1845,146,111,265,26,4,406,1323,70,59,51,289,0,469,365,1882,5175
UTTAR PRADESH,AMBEDKAR NAGAR,2009,36,28,15,79,19,0,19,38,56,49,7,112,0,0,14,22,113,54,59,262,24,11,99,0,0,129,342,15,9,19,102,0,145,79,266,1056
UTTAR PRADESH,AURAIYA,2009,41,31,12,84,11,0,11,22,44,35,9,88,1,0,14,22,95,57,38,227,15,14,14,1,0,82,271,26,20,16,30,0,92,145,374,1008
UTTAR PRADESH,AZAMGARH,2009,65,33,37,135,17,0,17,34,71,64,7,142,0,0,24,70,176,91,85,446,66,31,70,3,2,274,668,31,26,31,83,0,171,222,420,1752
UTTAR PRADESH,BADAUN,2009,110,140,28,278,29,0,29,58,96,67,29,192,7,0,32,44,178,56,122,439,36,25,80,0,4,290,458,43,28,18,55,0,144,23,1282,2548
UTTAR PRADESH,BAGHPAT,2009,76,56,14,146,15,0,15,30,53,45,8,106,3,0,36,27,172,94,78,410,60,23,53,0,0,103,275,16,6,20,72,0,114,36,597,1438
UTTAR PRADESH,BAHRAICH,2009,38,28,28,94,38,0,38,76,89,86,3,178,25,0,38,76,150,47,103,439,60,52,179,5,12,202,602,32,33,27,72,0,164,92,603,1879
UTTAR PRADESH,BALLIA,2009,23,36,18,77,9,0,9,18,28,25,3,56,0,0,7,70,121,62,59,319,40,22,63,2,2,138,436,31,19,9,53,0,112,169,68,928
UTTAR PRADESH,BALRAMPUR,2009,15,13,6,34,8,0,8,16,23,23,0,46,0,0,4,15,50,28,22,119,8,13,25,0,2,35,110,10,11,6,34,0,61,27,110,415
UTTAR PRADESH,BANDA,2009,23,22,16,61,23,0,23,46,41,32,9,82,0,0,8,52,124,28,96,308,21,21,63,1,14,63,188,24,42,11,44,0,121,5,816,1434
UTTAR PRADESH,BARABANKI,2009,48,49,16,113,19,0,19,38,107,106,1,214,1,0,26,108,231,50,181,597,11,101,54,1,3,247,591,39,34,50,104,0,227,174,1439,2862
UTTAR PRADESH,BAREILLY,2009,136,175,23,334,77,0,77,154,168,153,15,336,8,1,57,129,627,308,319,1449,113,112,197,10,2,191,958,47,125,96,303,0,571,333,1798,4728
UTTAR PRADESH,BASTI,2009,24,6,5,35,12,0,12,24,22,22,0,44,0,0,9,36,76,37,39,197,24,24,30,1,2,107,313,15,3,0,12,0,30,125,374,907
UTTAR PRADESH,BIJNOR,2009,79,40,11,130,30,0,30,60,87,75,12,174,1,0,21,43,214,65,149,493,42,51,203,1,11,502,998,22,46,44,225,0,337,188,786,2647
UTTAR PRADESH,BULANDSHAHAR,2009,118,130,29,277,38,0,38,76,102,81,21,204,2,0,51,66,314,150,164,747,51,32,122,3,2,18,502,53,36,24,184,0,297,274,946,2595
UTTAR PRADESH,CHANDOLI,2009,25,18,9,52,3,0,3,6,23,18,5,46,0,0,10,32,90,40,50,222,1,33,43,1,0,129,292,13,4,4,88,0,109,85,203,814
UTTAR PRADESH,CHITRAKOOT DHAM,2009,21,6,4,31,20,0,20,40,14,10,4,28,4,0,7,31,38,8,30,118,3,9,19,0,0,11,108,9,22,1,12,0,44,66,163,460
UTTAR PRADESH,DEORIA,2009,19,20,17,56,9,0,9,18,44,38,6,88,1,0,6,47,87,49,38,228,48,16,37,4,4,117,340,30,15,12,32,0,89,114,388,1067
UTTAR PRADESH,ETAH,2009,64,96,18,178,18,0,18,36,54,45,9,108,1,0,27,41,282,135,147,633,55,19,147,7,13,240,664,42,37,13,92,0,184,183,629,2078
UTTAR PRADESH,ETAWAH,2009,45,53,11,109,5,0,5,10,75,62,13,150,3,0,24,46,262,171,91,597,6,43,90,6,4,172,503,35,42,39,112,0,228,182,1217,2472
UTTAR PRADESH,FAIZABAD,2009,30,18,12,60,22,0,22,44,74,69,5,148,1,0,17,68,226,84,142,538,35,52,103,3,10,206,584,18,27,21,38,0,104,175,631,1787
UTTAR PRADESH,FATEHGARH,2009,62,59,26,147,17,0,17,34,69,61,8,138,0,0,8,48,136,72,64,328,27,11,35,4,3,104,313,23,30,16,61,0,130,129,399,1267
UTTAR PRADESH,FATEHPUR,2009,70,28,23,121,28,0,28,56,53,44,9,106,11,0,23,43,111,50,61,299,13,45,60,4,0,188,529,38,39,13,51,0,141,219,561,1621
UTTAR PRADESH,FIROZABAD,2009,117,106,14,237,26,0,26,52,142,95,47,284,14,0,49,47,417,256,161,944,88,82,116,1,10,241,544,47,59,35,130,0,271,6,1304,3051
UTTAR PRADESH,G.R.P.,2009,18,13,4,35,1,0,1,2,3,0,3,6,5,1,33,0,1267,63,1204,2573,13,21,19,6,0,6,65,1,10,57,0,0,68,0,770,2248
UTTAR PRADESH,GAUTAMBUDH NAGAR,2009,78,95,19,192,24,0,24,48,83,60,23,166,7,0,91,138,2298,1514,784,4832,83,77,214,3,2,29,728,22,40,46,103,0,211,320,935,4707
UTTAR PRADESH,GHAZIABAD,2009,254,277,31,562,53,0,53,106,491,321,170,982,53,11,195,394,4377,3378,999,9407,349,256,535,14,7,53,1670,66,88,182,556,0,892,456,3123,11821
UTTAR PRADESH,GHAZIPUR,2009,37,35,22,94,3,0,3,6,21,16,5,42,9,0,49,35,115,46,69,323,100,19,53,5,4,102,334,29,12,22,63,0,126,51,174,960
UTTAR PRADESH,GONDA,2009,59,37,30,126,29,0,29,58,88,74,14,176,21,0,25,62,151,60,91,410,46,42,175,1,2,329,730,42,28,12,3,0,85,135,429,1746
UTTAR PRADESH,GORAKHPUR,2009,79,56,37,172,43,0,43,86,107,94,13,214,3,1,39,137,862,648,214,1904,157,92,265,7,3,338,1109,50,44,47,255,0,396,247,1037,3906
UTTAR PRADESH,HAMIRPUR,2009,30,6,17,53,16,0,16,32,18,18,0,36,2,0,1,14,40,8,32,97,5,29,35,0,5,14,140,20,21,9,22,0,72,52,116,472
UTTAR PRADESH,HARDOI,2009,76,55,36,167,29,0,29,58,91,87,4,182,3,1,18,52,231,58,173,536,34,36,85,1,5,282,679,45,61,13,73,0,192,236,1236,2699
UTTAR PRADESH,HATHRAS,2009,53,48,11,112,22,0,22,44,73,52,21,146,24,0,50,32,174,55,119,454,38,50,61,2,1,142,441,23,33,8,146,0,210,147,525,1663
UTTAR PRADESH,J.P.NAGAR,2009,47,44,9,100,26,0,26,52,43,36,7,86,1,1,21,34,146,63,83,349,35,18,87,2,0,37,248,16,21,39,69,0,145,69,382,1147
UTTAR PRADESH,JALAUN,2009,37,13,12,62,11,0,11,22,33,27,6,66,2,2,6,21,86,48,38,203,14,28,51,3,2,3,222,34,41,15,43,0,133,121,538,1116
UTTAR PRADESH,JAUNPUR,2009,46,59,34,139,18,0,18,36,90,68,22,180,1,0,29,55,172,77,95,429,67,35,174,3,2,373,847,47,30,25,136,0,238,193,541,2130
UTTAR PRADESH,JHANSI,2009,40,14,22,76,14,0,14,28,43,36,7,86,1,0,13,46,201,131,70,462,17,23,63,4,0,29,178,27,33,35,9,0,104,42,468,1144
UTTAR PRADESH,KANNAUJ,2009,41,26,12,79,8,0,8,16,56,48,8,112,2,0,9,13,78,33,45,180,20,33,44,1,2,20,248,25,28,8,85,0,146,128,539,1178
UTTAR PRADESH,KANPUR DEHAT,2009,33,34,20,87,17,0,17,34,88,82,6,176,0,0,12,22,117,45,72,268,90,40,59,0,3,264,660,22,34,16,113,0,185,204,602,1790
UTTAR PRADESH,KANPUR NAGAR,2009,143,84,45,272,40,0,40,80,282,227,55,564,16,0,114,229,1094,745,349,2547,187,223,403,34,3,446,1745,73,109,210,551,0,943,449,2077,6812
UTTAR PRADESH,KANSHIRAM NAGAR,2009,44,41,17,102,15,0,15,30,42,30,12,84,2,0,6,17,79,30,49,183,24,13,30,1,11,128,363,29,22,5,26,0,82,156,246,954
UTTAR PRADESH,KAUSHAMBI,2009,50,17,17,84,15,0,15,30,41,30,11,82,0,0,21,55,84,19,65,244,34,24,32,3,0,108,318,27,49,12,86,0,174,117,528,1320
UTTAR PRADESH,KHIRI,2009,67,52,36,155,37,0,37,74,88,83,5,176,1,0,19,42,261,120,141,584,21,20,89,0,2,291,626,40,59,36,68,0,203,203,927,2359
UTTAR PRADESH,KUSHI NAGAR,2009,24,10,18,52,9,0,9,18,20,18,2,40,0,0,2,11,41,17,24,95,21,25,67,0,2,116,379,22,7,5,21,0,55,148,475,1044
UTTAR PRADESH,LALITPUR,2009,21,6,11,38,13,0,13,26,12,9,3,24,2,0,4,13,54,14,40,127,30,9,40,2,1,8,153,8,19,12,25,0,64,63,260,613
UTTAR PRADESH,LUCKNOW,2009,114,86,26,226,56,0,56,112,323,306,17,646,15,1,101,658,2533,1301,1232,5841,244,498,915,19,2,48,2229,53,178,256,664,0,1151,503,5131,12424
UTTAR PRADESH,MAHARAJGANJ,2009,28,6,9,43,17,0,17,34,28,28,0,56,1,0,12,19,46,16,30,124,12,13,83,3,3,59,272,17,12,13,38,0,80,99,314,832
UTTAR PRADESH,MAHOBA,2009,16,6,8,30,11,0,11,22,24,22,2,48,0,0,11,34,48,19,29,141,16,19,32,1,0,27,144,17,26,6,15,0,64,49,192,558
UTTAR PRADESH,MAINPURI,2009,75,75,13,163,16,0,16,32,83,64,19,166,2,3,25,42,225,127,98,522,36,28,37,4,1,172,487,36,38,20,30,0,124,209,606,1776
UTTAR PRADESH,MATHURA,2009,87,93,19,199,20,0,20,40,76,59,17,152,4,0,36,59,587,364,223,1273,99,104,309,13,3,110,1013,25,42,42,197,0,306,375,1694,3994
UTTAR PRADESH,MAU,2009,29,46,17,92,15,0,15,30,50,46,4,100,0,0,15,34,139,43,96,327,58,29,48,2,2,115,393,10,22,31,60,0,123,139,163,1024
UTTAR PRADESH,MEERUT,2009,175,165,25,365,46,0,46,92,193,141,52,386,5,1,90,130,1218,807,411,2662,136,91,274,27,0,23,933,41,47,123,361,0,572,382,1822,5375
UTTAR PRADESH,MIRZAPUR,2009,32,6,14,52,11,0,11,22,14,12,2,28,3,1,9,34,120,39,81,287,8,33,76,1,0,105,310,19,9,4,178,0,210,87,432,1196
UTTAR PRADESH,MORADABAD,2009,133,111,28,272,69,0,69,138,197,159,38,394,6,0,52,116,662,281,381,1498,56,67,186,8,0,53,631,32,63,61,264,0,420,261,1583,4008
UTTAR PRADESH,MUZAFFARNAGAR,2009,195,186,49,430,58,0,58,116,162,138,24,324,14,4,92,74,551,285,266,1286,146,75,195,7,4,19,708,27,64,86,340,0,517,262,1507,4117
UTTAR PRADESH,PILIBHIT,2009,30,24,7,61,15,0,15,30,61,56,5,122,1,0,8,21,91,26,65,212,6,38,67,0,0,3,212,27,37,15,186,0,265,98,1099,1834
UTTAR PRADESH,PRATAPGARH,2009,42,59,20,121,22,0,22,44,84,73,11,168,1,0,17,89,165,53,112,437,91,37,72,3,12,232,565,27,35,12,99,0,173,118,726,1963
UTTAR PRADESH,RAIBAREILLY,2009,62,41,22,125,30,0,30,60,67,59,8,134,1,0,12,48,165,37,128,391,42,39,92,2,2,263,664,29,46,41,114,0,230,224,832,2174
UTTAR PRADESH,RAMPUR,2009,82,93,14,189,51,0,51,102,105,90,15,210,20,4,76,100,374,125,249,948,86,61,190,4,1,7,502,24,48,16,3,0,91,153,922,2434
UTTAR PRADESH,SAHARANPUR,2009,77,48,33,158,14,0,14,28,41,36,5,82,0,15,24,38,362,174,188,801,42,43,156,3,0,23,476,35,29,39,139,0,242,209,1051,2421
UTTAR PRADESH,SANT KABIRNAGAR,2009,11,7,7,25,13,0,13,26,29,29,0,58,0,0,15,18,83,32,51,199,10,22,45,1,0,163,308,9,9,15,2,0,35,67,438,964
UTTAR PRADESH,SHAHJAHANPUR,2009,107,123,35,265,43,0,43,86,107,105,2,214,5,0,26,49,223,61,162,526,37,40,107,1,0,158,610,54,53,16,11,0,134,267,969,2431
UTTAR PRADESH,SHRAWASTI,2009,12,6,4,22,8,0,8,16,23,23,0,46,0,0,9,21,53,5,48,136,30,16,34,0,0,146,255,9,27,4,28,0,68,29,157,616
UTTAR PRADESH,SIDHARTHNAGAR,2009,14,8,7,29,9,0,9,18,30,29,1,60,0,0,14,25,103,47,56,245,17,14,19,1,0,53,180,14,23,6,20,0,63,76,247,700
UTTAR PRADESH,SITAPUR,2009,100,65,34,199,61,0,61,122,156,144,12,312,2,1,35,102,315,66,249,770,37,54,90,3,2,213,447,75,74,47,84,0,280,48,1574,3172
UTTAR PRADESH,SONBHADRA,2009,37,10,25,72,25,0,25,50,30,25,5,60,0,0,8,25,85,40,45,203,11,34,73,1,6,83,321,11,16,20,36,0,83,113,313,962
UTTAR PRADESH,ST.RAVIDASNAGAR,2009,9,15,2,26,3,0,3,6,9,5,4,18,0,0,4,17,71,33,38,163,9,7,20,0,0,57,139,10,9,7,24,0,50,46,122,441
UTTAR PRADESH,SULTANPUR,2009,38,71,27,136,16,0,16,32,71,63,8,142,1,0,21,86,248,109,139,604,49,64,65,0,25,370,772,28,35,35,60,0,158,199,774,2283
UTTAR PRADESH,UNNAO,2009,55,52,28,135,48,0,48,96,96,85,11,192,10,0,26,50,189,59,130,464,39,47,64,1,0,179,537,40,61,14,100,0,215,207,476,1782
UTTAR PRADESH,VARANASI,2009,32,43,11,86,10,0,10,20,41,35,6,82,1,0,16,109,693,523,170,1512,56,94,219,13,6,186,820,29,12,72,107,0,220,246,1152,3148
UTTARAKHAND,ALMORA,2009,9,3,3,15,4,0,4,8,5,5,0,10,1,0,12,20,37,0,37,107,15,5,11,0,1,38,95,4,4,0,11,0,19,25,38,246
UTTARAKHAND,BAGESHWAR,2009,3,0,1,4,3,0,3,6,1,1,0,2,0,0,1,6,2,0,2,11,1,2,4,0,1,2,16,2,1,1,2,0,6,6,30,69
UTTARAKHAND,CHAMOLI,2009,3,1,1,5,1,0,1,2,0,0,0,0,0,0,0,12,21,5,16,54,9,1,8,0,0,16,35,0,2,0,2,0,4,1,34,112
UTTARAKHAND,CHAMPAWAT,2009,4,5,2,11,1,0,1,2,2,2,0,4,0,0,1,2,12,7,5,27,5,2,2,2,2,16,39,2,5,0,0,0,7,10,7,82
UTTARAKHAND,DEHRADUN,2009,24,41,11,76,30,0,30,60,76,60,16,152,16,3,51,113,476,189,287,1135,146,46,212,12,3,271,811,11,30,110,133,0,284,121,489,2425
UTTARAKHAND,HARIDWAR,2009,67,58,11,136,26,0,26,52,68,60,8,136,6,3,50,54,391,204,187,895,122,48,172,8,7,512,1050,22,30,112,107,0,271,181,213,2268
UTTARAKHAND,NAINITAL,2009,24,20,3,47,14,0,14,28,37,37,0,74,7,0,17,37,180,75,105,421,42,8,31,4,0,11,176,23,14,17,19,0,73,80,340,928
UTTARAKHAND,PAURI GARHWAL,2009,8,3,2,13,4,0,4,8,13,13,0,26,1,1,9,11,36,11,25,94,2,6,17,0,0,37,74,6,3,4,9,0,22,12,41,225
UTTARAKHAND,PITHORAGARH,2009,2,3,2,7,0,0,0,0,1,1,0,2,0,0,2,12,13,0,13,40,11,0,1,0,3,19,34,1,3,0,4,0,8,0,73,150
UTTARAKHAND,RUDRA PRAYAG,2009,0,0,0,0,2,0,2,4,2,2,0,4,0,0,0,4,5,3,2,14,4,1,3,0,0,4,24,3,0,2,4,0,9,12,13,59
UTTARAKHAND,TEHRI GARHWAL,2009,0,2,2,4,1,0,1,2,3,3,0,6,0,0,0,11,16,8,8,43,1,2,7,0,0,3,32,1,3,0,2,0,6,19,41,114
UTTARAKHAND,UDHAMSINGH NAGAR,2009,50,49,12,111,21,0,21,42,60,58,2,120,4,0,36,73,403,232,171,919,106,32,73,17,0,264,710,19,21,0,65,0,105,218,500,2023
UTTARAKHAND,UTTARKASHI,2009,1,0,1,2,4,0,4,8,7,5,2,14,0,0,0,8,9,1,8,26,2,3,3,0,0,5,13,0,3,3,3,0,9,0,49,101
WEST BENGAL,24 PARGANAS NORTH,2009,229,238,241,708,166,0,166,332,368,249,119,736,21,99,88,22,1959,491,1468,4148,778,224,257,8,25,285,1581,54,203,3,2225,0,2485,4,5549,13046
WEST BENGAL,24 PARGANAS SOUTH,2009,212,3,35,250,280,0,280,560,128,128,0,256,17,176,52,11,1982,430,1552,4220,1233,9,119,3,10,264,1661,63,120,1,2542,0,2726,23,6341,13624
WEST BENGAL,ASANSOL,2009,32,7,10,49,13,0,13,26,27,17,10,54,4,39,12,6,283,138,145,627,61,18,45,0,5,65,305,17,14,0,211,0,242,111,381,1361
WEST BENGAL,BANKURA,2009,69,28,10,107,33,0,33,66,36,31,5,72,4,18,33,6,215,46,169,491,161,12,17,1,10,166,513,28,46,1,172,0,247,146,374,1586
WEST BENGAL,BIRBHUM,2009,92,22,20,134,52,0,52,104,52,49,3,104,7,28,29,12,445,116,329,966,346,7,70,2,20,363,1007,18,60,0,298,0,376,199,560,2702
WEST BENGAL,BURDWAN,2009,129,52,66,247,55,0,55,110,135,12,123,270,11,37,37,15,744,257,487,1588,541,4,179,7,19,55,1720,30,25,9,710,0,774,915,1781,5556
WEST BENGAL,COOCHBEHAR,2009,52,140,7,199,139,0,139,278,151,139,12,302,8,2,9,4,329,72,257,681,126,34,53,3,4,120,454,13,76,0,508,0,597,114,1573,3465
WEST BENGAL,DAKSHIN DINAJPUR,2009,28,97,9,134,49,0,49,98,56,51,5,112,0,6,5,9,126,23,103,272,14,8,20,3,7,513,660,7,76,1,211,0,295,95,262,1602
WEST BENGAL,DARJEELING,2009,50,2,11,63,54,0,54,108,50,40,10,100,6,19,8,8,635,211,424,1311,68,51,22,5,7,813,1101,2,55,2,141,0,200,135,485,2629
WEST BENGAL,HOOGHLY,2009,98,37,71,206,48,0,48,96,94,79,15,188,11,56,35,16,571,135,436,1260,573,45,160,7,82,186,1235,25,24,0,629,0,678,182,1114,4064
WEST BENGAL,HOWRAH,2009,93,13,27,133,39,0,39,78,130,112,18,260,10,45,23,17,878,225,653,1851,267,27,203,2,0,53,948,21,76,0,743,0,840,396,2437,5500
WEST BENGAL,HOWRAH G.R.P.,2009,13,15,3,31,1,0,1,2,2,1,1,4,1,3,6,0,316,0,316,642,0,0,10,0,0,0,10,1,2,0,1,0,4,0,81,455
WEST BENGAL,JALPAIGURI,2009,112,100,31,243,193,0,193,386,206,177,29,412,7,4,69,52,1310,235,1075,2752,106,65,63,10,22,454,963,11,136,0,646,0,793,243,2605,6445
WEST BENGAL,KHARAGPUR G.R.P.,2009,6,1,0,7,0,0,0,0,0,0,0,0,0,1,2,0,117,0,117,237,1,1,4,0,0,1,8,0,0,0,3,0,3,1,23,161
WEST BENGAL,KOLKATA,2009,41,71,42,154,42,0,42,84,129,107,22,258,2,36,40,90,3078,433,2645,6324,253,280,1433,37,0,1866,4293,10,201,90,411,4,716,424,5035,13615
WEST BENGAL,MALDA,2009,74,152,42,268,197,0,197,394,178,132,46,356,9,17,21,5,339,149,190,730,70,1,64,35,0,525,695,10,131,0,567,0,708,0,1490,3927
WEST BENGAL,MURSHIDABAD,2009,184,607,53,844,568,0,568,1136,408,342,66,816,22,54,73,11,857,166,691,1874,745,39,220,12,49,2994,4328,51,348,1,3035,0,3435,269,1708,12308
WEST BENGAL,NADIA,2009,135,372,81,588,175,0,175,350,297,276,21,594,28,30,69,21,1288,175,1113,2724,197,37,176,9,18,1709,2341,44,118,0,1508,1,1671,195,2198,8706
WEST BENGAL,PASCHIM MIDNAPUR,2009,198,68,123,389,57,0,57,114,79,79,0,158,15,12,29,6,379,140,239,820,441,39,43,2,34,142,703,31,83,0,567,0,681,2,1367,3717
WEST BENGAL,PURAB MIDNAPUR,2009,81,6,28,115,41,0,41,82,90,74,16,180,10,8,18,9,446,141,305,937,491,1,50,0,21,0,730,40,33,0,475,0,548,167,1634,3649
WEST BENGAL,PURULIA,2009,71,0,5,76,53,0,53,106,27,0,27,54,8,10,43,1,190,35,155,442,108,4,36,0,0,0,148,9,30,0,170,0,209,0,741,1506
WEST BENGAL,SEALDAH G.R.P.,2009,15,2,1,18,1,0,1,2,6,6,0,12,1,11,15,0,221,2,219,469,21,3,13,1,0,25,63,3,7,0,5,0,15,0,22,373
WEST BENGAL,SILIGURI G.R.P.,2009,2,0,1,3,0,0,0,0,1,1,0,2,2,0,2,0,73,0,73,150,0,0,1,0,0,0,1,0,3,0,0,0,3,0,31,116
WEST BENGAL,UTTAR DINAJPUR,2009,52,86,14,152,80,0,80,160,100,85,15,200,10,13,33,8,352,89,263,768,99,9,40,6,11,597,764,18,75,0,334,0,427,2,984,2923
A & N ISLANDS,ANDAMAN,2009,15,4,3,22,18,0,18,36,16,14,2,32,0,0,11,83,134,10,124,362,11,6,19,2,12,87,139,1,29,7,21,0,58,2,440,921
A & N ISLANDS,NICOBAR,2009,0,0,1,1,0,0,0,0,0,0,0,0,0,0,0,3,0,0,0,3,0,1,1,0,0,2,4,0,1,0,0,0,1,0,11,20
CHANDIGARH,CHANDIGARH,2009,22,18,8,48,29,0,29,58,40,36,4,80,4,3,27,241,1731,1117,614,3737,66,38,193,4,4,63,375,2,26,2,51,0,81,7,976,3555
D & N HAVELI,D and N HAVELI,2009,10,5,1,16,4,0,4,8,12,9,3,24,9,0,2,43,63,21,42,180,53,17,20,1,5,23,136,0,2,1,3,0,6,17,151,442
DAMAN & DIU,DAMAN,2009,5,4,1,10,1,0,1,2,0,0,0,0,0,0,4,30,31,18,13,96,19,7,3,1,3,11,71,0,4,1,1,0,6,27,55,208
DAMAN & DIU,DIU,2009,0,0,0,0,0,0,0,0,0,0,0,0,0,0,0,3,10,9,1,23,10,1,1,2,0,3,30,0,0,0,2,0,2,13,23,68
DELHI UT,CAW,2009,0,0,0,0,0,0,0,0,0,0,0,0,0,0,0,0,0,0,0,0,0,0,0,0,0,1,1,0,1,0,192,0,193,0,0,194
DELHI UT,CENTRAL,2009,28,25,8,61,28,0,28,56,93,49,44,186,0,1,33,107,1375,789,586,2891,4,34,120,5,1,174,344,6,34,5,62,0,107,6,684,2833
DELHI UT,CRIME BRANCH,2009,1,8,0,9,2,0,2,4,0,0,0,0,0,0,1,0,4,0,4,9,0,0,39,6,0,0,45,0,0,0,0,0,0,0,30,91
DELHI UT,EAST,2009,56,50,5,111,52,0,52,104,299,187,112,598,9,2,52,196,3015,2022,993,6289,9,41,146,4,8,231,633,10,81,10,121,0,222,194,1788,6379
DELHI UT,EOW,2009,0,0,0,0,0,0,0,0,0,0,0,0,0,0,0,0,0,0,0,0,0,4,184,0,0,0,188,0,1,1,0,0,2,0,0,190
DELHI UT,GRP(RLY),2009,9,5,0,14,4,0,4,8,11,5,6,22,2,0,10,1,725,29,696,1463,0,8,7,0,0,10,25,1,0,0,1,0,2,0,70,864
DELHI UT,IGI AIRPORT,2009,1,0,1,2,0,0,0,0,2,0,2,4,1,0,1,0,66,19,47,134,0,0,437,1,0,0,447,0,2,0,0,0,2,9,48,569
DELHI UT,NEW DELHI,2009,5,3,2,10,6,0,6,12,46,17,29,92,2,0,14,45,581,197,384,1223,3,26,127,12,1,31,268,1,17,7,7,0,32,68,488,1492
DELHI UT,NORTH,2009,44,19,6,69,19,0,19,38,140,81,59,280,1,0,24,77,1107,488,619,2316,4,30,108,5,2,132,292,8,35,18,49,0,110,11,1069,2908
DELHI UT,NORTH-EAST,2009,74,56,5,135,47,0,47,94,375,246,129,750,5,0,53,117,2086,1434,652,4347,7,22,100,2,3,274,590,15,67,9,138,0,229,182,1083,4720
DELHI UT,NORTH-WEST,2009,56,48,4,108,54,0,54,108,218,137,81,436,6,12,118,233,2159,1301,858,4687,6,21,101,0,4,150,303,13,39,0,120,0,172,21,1293,4676
DELHI UT,OUTER,2009,74,44,10,128,41,0,41,82,332,204,128,664,3,1,21,217,1974,1295,679,4190,6,29,99,0,8,227,393,21,61,6,173,0,261,24,1598,4969
DELHI UT,SOUTH,2009,42,16,4,62,42,0,42,84,133,97,36,266,0,28,36,241,2506,1693,813,5317,7,28,168,3,1,110,342,10,45,23,61,0,139,25,1824,5353
DELHI UT,SOUTH-EAST,2009,48,29,5,82,59,0,59,118,318,237,81,636,1,16,62,174,2641,1684,957,5535,3,51,141,3,1,249,719,18,78,30,63,0,189,271,2006,6267
DELHI UT,SOUTH-WEST,2009,65,27,15,107,52,0,52,104,241,170,71,482,4,1,44,133,1341,851,490,2864,5,14,81,1,0,118,240,17,53,3,79,0,152,21,1295,3610
DELHI UT,STF,2009,0,4,0,4,0,0,0,0,0,0,0,0,0,0,0,0,0,0,0,0,0,1,7,4,0,0,12,0,0,0,0,0,0,0,9,25
DELHI UT,WEST,2009,49,35,19,103,63,0,63,126,328,225,103,656,2,8,46,192,2151,1422,729,4550,3,24,135,1,5,231,413,21,38,6,217,0,282,14,1523,5111
LAKSHADWEEP,LAKSHADWEEP,2009,0,1,0,1,1,0,1,2,0,0,0,0,3,0,0,1,10,5,5,24,44,0,0,0,2,14,60,0,0,0,0,0,0,0,58,134
PUDUCHERRY,KARAIKAL,2009,6,2,0,8,0,0,0,0,1,1,0,2,0,0,0,21,51,22,29,123,25,0,5,0,1,207,287,0,16,2,0,0,18,49,338,724
PUDUCHERRY,PUDUCHERRY,2009,31,23,5,59,1,0,1,2,17,12,5,34,7,5,9,50,660,480,180,1391,116,7,42,5,10,694,1058,0,37,14,10,0,61,184,1940,3867
ANDHRA PRADESH,ADILABAD,2010,98,90,9,197,48,0,48,96,55,48,7,110,5,0,15,196,302,85,217,820,65,36,162,1,26,1044,1676,18,133,155,429,0,735,342,1726,4955
ANDHRA PRADESH,ANANTAPUR,2010,137,101,7,245,20,0,20,40,81,60,21,162,18,0,21,291,730,230,500,1790,65,23,226,2,35,2066,2991,20,132,35,250,0,437,574,1020,5854
ANDHRA PRADESH,CHITTOOR,2010,100,50,1,151,44,0,44,88,85,56,29,170,8,0,12,149,484,116,368,1137,58,16,152,7,19,827,1631,32,136,121,388,0,677,552,1977,5218
ANDHRA PRADESH,CUDDAPAH,2010,99,40,5,144,39,0,39,78,63,51,12,126,2,0,9,144,488,133,355,1131,99,37,152,4,37,1385,2198,15,137,45,321,0,518,484,2089,5694
ANDHRA PRADESH,CYBERABAD,2010,187,84,10,281,95,0,95,190,150,72,78,300,14,1,63,1361,4015,1609,2406,9469,60,173,1256,18,61,3529,6177,43,157,1257,1191,0,2648,1080,1543,16348
ANDHRA PRADESH,EAST GODAVARI,2010,71,91,23,185,66,0,66,132,51,30,21,102,3,0,11,318,836,297,539,2004,29,80,271,6,24,2060,3047,20,193,188,246,0,647,577,1185,6349
ANDHRA PRADESH,GUNTAKAL RLY.,2010,8,1,0,9,0,0,0,0,4,2,2,8,0,0,2,0,221,0,221,444,0,0,3,2,1,4,13,0,2,2,0,0,4,3,34,287
ANDHRA PRADESH,GUNTUR,2010,107,107,1,215,38,0,38,76,55,39,16,110,9,0,15,222,648,172,476,1542,48,60,208,11,54,1408,2339,20,282,409,456,0,1167,550,1804,6512
ANDHRA PRADESH,GUNTUR URBAN,2010,43,26,1,70,12,0,12,24,27,5,22,54,2,0,19,123,743,220,523,1630,9,34,236,2,9,321,843,13,48,54,245,0,360,232,1009,3208
ANDHRA PRADESH,HYDERABAD CITY,2010,134,143,8,285,45,0,45,90,121,41,80,242,7,0,54,906,4916,1543,3373,10799,513,96,2021,29,15,3425,6641,44,171,60,1420,0,1695,542,2879,17549
ANDHRA PRADESH,KARIMNAGAR,2010,139,86,8,233,65,0,65,130,158,128,30,316,2,0,16,282,673,251,422,1646,158,41,489,1,56,2791,4107,39,237,241,636,0,1153,571,1631,8320
ANDHRA PRADESH,KHAMMAM,2010,93,70,4,167,62,0,62,124,71,66,5,142,2,0,11,210,511,172,339,1245,130,25,233,4,38,1994,2921,17,147,129,354,0,647,497,969,5571
ANDHRA PRADESH,KRISHNA,2010,80,79,1,160,54,0,54,108,75,67,8,150,2,1,9,195,563,107,456,1333,36,13,171,6,28,2323,3017,22,300,149,412,0,883,440,860,5819
ANDHRA PRADESH,KURNOOL,2010,156,145,6,307,49,0,49,98,85,67,18,170,5,0,20,211,491,164,327,1218,84,28,301,9,41,1500,2556,19,347,268,501,0,1135,593,2399,7258
ANDHRA PRADESH,MAHABOOBNAGAR,2010,177,58,14,249,89,0,89,178,87,78,9,174,1,0,24,253,1224,7,1217,2726,46,28,185,3,37,1903,2936,34,174,78,233,0,519,734,1322,6704
ANDHRA PRADESH,MEDAK,2010,96,59,11,166,49,0,49,98,83,68,15,166,7,0,21,325,544,168,376,1441,46,13,231,2,58,1654,2659,29,103,95,316,0,543,655,872,5269
ANDHRA PRADESH,NALGONDA,2010,118,68,5,191,68,0,68,136,81,81,0,162,4,0,36,303,595,191,404,1533,99,46,245,4,57,1420,2619,32,195,192,218,0,637,748,3202,7736
ANDHRA PRADESH,NELLORE,2010,72,86,2,160,28,0,28,56,77,74,3,154,6,0,11,237,780,299,481,1814,34,38,244,6,43,1951,2800,6,176,119,382,0,683,484,997,5779
ANDHRA PRADESH,NIZAMABAD,2010,98,45,8,151,62,0,62,124,65,50,15,130,4,0,23,329,704,205,499,1764,56,12,206,7,36,1805,2564,21,114,75,626,0,836,442,1077,5815
ANDHRA PRADESH,PRAKASHAM,2010,98,99,2,199,29,0,29,58,84,65,19,168,8,0,14,188,455,56,399,1120,23,47,188,1,32,1118,1897,13,253,32,216,0,514,488,2054,5442
ANDHRA PRADESH,RAJAHMUNDRY,2010,21,20,1,42,10,0,10,20,30,12,18,60,3,0,10,129,382,6,376,906,5,35,82,4,4,620,914,4,47,39,96,0,186,164,316,2022
ANDHRA PRADESH,RANGA REDDY,2010,33,26,5,64,19,0,19,38,21,19,2,42,0,0,4,66,120,24,96,310,20,4,59,1,17,638,906,19,39,26,75,0,159,167,317,1676
ANDHRA PRADESH,SECUNDERABAD RLY.,2010,2,0,0,2,1,0,1,2,1,1,0,2,0,0,8,0,357,0,357,722,0,0,3,4,1,8,19,0,2,2,0,0,4,3,70,462
ANDHRA PRADESH,SRIKAKULAM,2010,31,43,0,74,35,0,35,70,31,31,0,62,2,0,7,139,306,5,301,760,53,12,99,1,21,833,1336,5,93,92,233,0,423,317,2557,4910
ANDHRA PRADESH,TIRUPATHI URBAN,2010,31,35,0,66,10,0,10,20,26,15,11,52,2,0,4,119,636,221,415,1397,25,7,150,1,4,696,1120,5,38,25,85,0,153,237,471,2607
ANDHRA PRADESH,VIJAYAWADA CITY,2010,33,49,1,83,25,0,25,50,87,65,22,174,3,0,20,228,1324,539,785,2899,8,52,398,16,20,1565,2422,17,172,219,626,0,1034,363,607,5833
ANDHRA PRADESH,VIJAYAWADA RLY.,2010,3,1,0,4,1,0,1,2,0,0,0,0,1,0,10,0,360,0,360,731,1,1,4,0,0,12,23,3,6,0,4,0,13,5,37,449
ANDHRA PRADESH,VISAKHA RURAL,2010,79,26,2,107,42,0,42,84,27,12,15,54,1,0,1,110,250,15,235,612,70,10,112,4,27,1263,1833,8,92,52,222,0,374,347,567,3312
ANDHRA PRADESH,VISAKHAPATNAM,2010,24,25,4,53,53,0,53,106,34,24,10,68,8,0,40,335,1234,134,1100,2851,2,75,294,16,28,2443,3324,11,59,52,393,0,515,466,1516,7112
ANDHRA PRADESH,VIZIANAGARAM,2010,26,40,2,68,32,0,32,64,19,15,4,38,1,0,6,122,269,0,269,667,0,11,117,6,15,526,987,14,101,85,312,0,512,312,1846,3862
ANDHRA PRADESH,WARANGAL,2010,49,19,5,73,28,0,28,56,49,39,10,98,3,0,6,141,132,5,127,414,146,0,131,2,10,803,1340,7,98,10,50,0,165,248,780,2717
ANDHRA PRADESH,WARANGAL URBAN,2010,21,16,1,38,17,0,17,34,28,28,0,56,0,0,6,122,245,0,245,618,44,3,165,1,42,566,1066,12,50,25,412,0,499,245,495,2516
ANDHRA PRADESH,WEST GODAVARI,2010,74,125,8,207,127,0,127,254,142,122,20,284,1,0,22,446,1218,448,770,2905,199,74,370,5,29,2276,3576,26,400,231,732,0,1389,623,1145,8273
ARUNACHAL PRADESH,ANJAW,2010,1,0,0,1,1,0,1,2,0,0,0,0,0,0,0,3,7,0,7,17,1,0,1,0,0,5,10,0,0,0,2,0,2,3,5,29
ARUNACHAL PRADESH,CHANGLANG,2010,5,1,0,6,4,0,4,8,7,4,3,14,1,0,3,28,43,2,41,118,3,11,4,0,3,47,72,0,10,0,1,0,11,4,74,249
ARUNACHAL PRADESH,DIBANG VALLEY,2010,3,1,0,4,3,0,3,6,3,3,0,6,1,0,2,10,32,12,20,77,4,1,0,0,3,19,31,0,2,0,0,0,2,4,31,119
ARUNACHAL PRADESH,K/KUMEY,2010,8,1,0,9,0,0,0,0,1,1,0,2,1,0,0,9,8,0,8,26,0,3,2,0,1,4,12,0,0,0,0,0,0,2,14,54
ARUNACHAL PRADESH,KAMENG EAST,2010,5,1,0,6,1,0,1,2,5,3,2,10,3,0,10,12,21,1,20,67,1,0,7,0,0,36,48,0,2,0,0,0,2,4,33,141
ARUNACHAL PRADESH,KAMENG WEST,2010,6,4,1,11,0,0,0,0,4,3,1,8,1,0,4,9,9,0,9,32,0,2,3,0,0,23,55,0,5,0,0,0,5,27,33,131
ARUNACHAL PRADESH,LOHIT,2010,7,4,0,11,9,0,9,18,5,3,2,10,0,0,2,18,32,9,23,84,2,0,3,0,7,34,58,0,7,0,0,0,7,12,34,176
ARUNACHAL PRADESH,PAPUM PARE,2010,7,5,0,12,4,0,4,8,15,9,6,30,2,0,14,20,117,79,38,270,0,20,43,0,1,60,140,0,13,0,1,0,14,16,106,444
ARUNACHAL PRADESH,RURAL,2010,3,2,0,5,3,0,3,6,2,2,0,4,2,0,1,9,7,1,6,26,2,1,4,0,3,24,34,0,5,0,0,0,5,0,27,95
ARUNACHAL PRADESH,SIANG EAST,2010,5,3,1,9,8,0,8,16,7,5,2,14,2,0,6,25,73,25,48,179,6,4,4,0,1,29,54,0,8,0,0,0,8,10,48,240
ARUNACHAL PRADESH,SIANG UPPER,2010,3,0,0,3,1,0,1,2,1,1,0,2,0,0,1,9,10,3,7,30,0,2,2,0,1,10,15,0,2,0,0,0,2,0,11,53
ARUNACHAL PRADESH,SIANG WEST,2010,9,1,0,10,6,0,6,12,6,6,0,12,0,0,4,9,34,2,32,81,0,3,4,0,5,59,78,0,16,1,5,0,22,7,68,237
ARUNACHAL PRADESH,SUBANSIRI LOWER,2010,3,3,0,6,0,0,0,0,3,2,1,6,1,0,4,10,18,4,14,51,10,3,3,0,2,19,40,0,4,0,0,0,4,3,27,113
ARUNACHAL PRADESH,SUBANSIRI UPPER,2010,5,3,0,8,5,0,5,10,4,4,0,8,1,0,7,15,14,0,14,51,1,4,8,0,0,41,60,0,7,0,3,0,10,6,40,164
ARUNACHAL PRADESH,TAWANG,2010,1,0,0,1,1,0,1,2,0,0,0,0,0,0,0,5,6,0,6,17,0,2,2,0,0,6,14,0,1,0,0,0,1,4,12,40
ARUNACHAL PRADESH,TIRAP,2010,4,4,1,9,1,0,1,2,4,0,4,8,0,0,11,16,14,1,13,55,0,2,1,0,1,20,27,0,2,0,0,0,2,3,56,140
ARUNACHAL PRADESH,UPPER DIBANG VALLEY,2010,0,1,0,1,0,0,0,0,0,0,0,0,0,0,0,4,0,0,0,4,1,1,0,0,0,3,6,0,0,0,0,0,0,1,3,14
ASSAM,BARPETA,2010,52,15,0,67,109,0,109,218,177,155,22,354,10,0,22,284,183,48,135,682,196,40,54,2,11,143,591,12,65,0,197,0,274,145,1313,3030
ASSAM,BASKA,2010,58,15,0,73,23,0,23,46,48,42,6,96,2,0,6,36,58,11,47,160,8,4,14,0,2,58,110,5,14,0,24,0,43,24,216,615
ASSAM,BONGAIGAON,2010,27,15,5,47,51,0,51,102,74,65,9,148,6,0,14,119,108,28,80,355,62,27,22,3,6,146,333,14,46,0,222,0,282,67,373,1407
ASSAM,C.I.D.,2010,0,0,0,0,0,0,0,0,1,0,1,2,0,0,2,0,1,0,1,4,0,8,21,1,0,0,30,0,0,0,0,0,0,0,17,51
ASSAM,CACHAR,2010,54,6,0,60,73,0,73,146,173,153,20,346,17,1,21,213,553,99,454,1358,221,80,95,5,27,118,659,15,10,0,504,0,529,113,2206,4505
ASSAM,CHIRANG,2010,21,2,0,23,28,0,28,56,45,42,3,90,8,0,7,27,55,8,47,152,14,0,12,0,13,39,109,2,3,0,55,0,60,31,250,612
ASSAM,DARRANG,2010,27,7,2,36,97,0,97,194,139,123,16,278,7,0,10,108,166,19,147,457,20,80,57,2,3,384,771,4,225,0,378,0,607,225,657,2598
ASSAM,DHEMAJI,2010,20,14,0,34,75,0,75,150,78,76,2,156,3,1,13,32,123,49,74,295,10,0,6,0,10,144,231,5,40,0,122,0,167,61,334,1091
ASSAM,DHUBRI,2010,45,18,3,66,181,2,179,362,241,224,17,482,15,1,37,153,277,22,255,760,398,71,151,11,43,545,1321,16,250,7,719,0,992,102,1005,4289
ASSAM,DIBRUGARH,2010,85,0,5,90,54,0,54,108,136,31,105,272,4,0,15,110,482,86,396,1093,26,50,28,0,1,37,369,6,51,0,152,0,209,227,937,2406
ASSAM,G.R.P.,2010,3,0,0,3,0,0,0,0,7,7,0,14,9,0,4,3,154,1,153,324,4,0,1,0,3,16,24,0,0,0,1,0,1,0,86,291
ASSAM,GOALPARA,2010,31,0,0,31,119,0,119,238,121,117,4,242,11,0,4,102,155,53,102,427,221,0,47,0,4,62,349,4,10,0,263,0,277,15,1121,2290
ASSAM,GOLAGHAT,2010,52,21,0,73,40,0,40,80,86,84,2,172,10,1,25,84,188,39,149,496,6,28,43,2,14,227,481,9,33,0,148,0,190,161,325,1503
ASSAM,GUWAHATI CITY,2010,52,38,4,94,70,0,70,140,386,322,64,772,15,4,172,716,2036,967,1069,4979,78,158,240,22,37,644,1392,12,119,0,218,0,349,213,3985,9219
ASSAM,HAILAKANDI,2010,22,3,0,25,72,0,72,144,74,54,20,148,7,0,6,86,120,7,113,339,124,22,22,5,23,32,260,3,16,0,129,0,148,32,660,1458
ASSAM,JORHAT,2010,50,6,1,57,51,0,51,102,68,51,17,136,4,0,17,130,284,70,214,719,19,23,51,1,12,318,574,0,60,0,163,0,223,150,355,1763
ASSAM,KAMRUP,2010,38,21,0,59,51,0,51,102,120,111,9,240,8,1,19,103,254,70,184,639,89,31,38,0,12,289,568,5,69,0,159,0,233,109,925,2341
ASSAM,KARBI ANGLONG,2010,33,15,2,50,19,0,19,38,45,27,18,90,3,0,8,28,113,24,89,265,19,11,5,1,14,98,203,0,7,0,29,0,36,55,145,650
ASSAM,KARIMGANJ,2010,38,6,0,44,36,0,36,72,54,47,7,108,19,0,7,76,120,24,96,342,40,11,10,2,15,86,192,10,7,0,141,0,158,28,676,1382
ASSAM,KOKRAJHAR,2010,43,28,0,71,30,0,30,60,78,58,20,156,6,0,10,33,174,46,128,397,127,11,22,0,16,30,249,1,3,0,86,0,90,43,275,1016
ASSAM,LAKHIMPUR,2010,45,17,3,65,39,0,39,78,128,109,19,256,3,0,12,103,141,33,108,400,14,20,57,0,10,387,656,0,60,0,229,0,289,168,440,1876
ASSAM,MORIGAON,2010,15,10,6,31,74,0,74,148,93,88,5,186,4,0,3,78,90,13,77,265,90,6,42,2,6,254,431,3,63,0,110,0,176,31,340,1320
ASSAM,N.C.HILLS,2010,17,8,5,30,3,0,3,6,19,8,11,38,1,0,2,11,43,3,40,100,4,2,6,0,11,24,52,2,0,4,2,0,8,5,22,191
ASSAM,NAGAON,2010,83,67,5,155,148,3,145,296,302,293,9,604,33,3,114,271,387,72,315,1195,269,160,97,4,52,608,1437,15,18,9,769,0,811,247,2038,5699
ASSAM,NALBARI,2010,24,17,0,41,24,0,24,48,56,51,5,112,15,0,20,77,157,50,107,426,13,16,53,0,15,316,444,0,75,0,51,0,126,31,414,1374
ASSAM,R.P.O.,2010,6,0,0,6,7,0,7,14,2,2,0,4,2,0,0,0,13,0,13,28,13,2,3,0,0,0,18,0,0,0,0,0,0,0,69,117
ASSAM,SIBSAGAR,2010,60,24,4,88,75,0,75,150,142,127,15,284,1,0,17,117,450,134,316,1035,27,24,64,2,24,200,386,2,85,0,101,0,188,45,821,2285
ASSAM,SONITPUR,2010,81,10,0,91,80,0,80,160,191,169,22,382,7,0,22,175,338,63,275,880,34,44,81,0,21,210,743,13,30,0,294,0,337,353,1145,3129
ASSAM,TINSUKIA,2010,96,17,1,114,55,0,55,110,112,107,5,224,9,0,43,132,562,71,491,1308,15,62,25,2,16,183,414,16,25,0,100,0,141,111,713,2295
ASSAM,UDALGURI,2010,45,31,0,76,37,0,37,74,54,24,30,108,9,0,10,51,75,14,61,220,22,1,4,1,16,146,245,1,16,0,44,0,61,55,247,865
BIHAR,ARARIA,2010,53,42,15,110,42,0,42,84,84,63,21,168,21,4,58,42,246,26,220,617,209,65,47,1,11,92,489,26,2,0,26,0,54,64,1271,2421
BIHAR,ARWAL,2010,23,42,3,68,3,0,3,6,13,11,2,26,6,0,4,24,84,6,78,202,26,2,5,0,5,45,104,15,4,0,5,0,24,21,440,770
BIHAR,AURANGABAD,2010,97,10,2,109,12,0,12,24,58,55,3,116,18,0,23,104,338,33,305,821,283,5,77,2,15,480,974,24,3,0,97,0,124,112,1255,3015
BIHAR,BAGAHA,2010,41,61,4,106,10,0,10,20,66,51,15,132,3,0,5,39,115,3,112,277,101,43,24,2,10,240,499,10,29,0,21,0,60,79,640,1543
BIHAR,BANKA,2010,71,44,6,121,13,0,13,26,53,47,6,106,10,0,20,77,132,10,122,371,118,6,6,0,33,386,549,24,3,0,23,0,50,0,791,1816
BIHAR,BEGUSARAI,2010,126,156,2,284,20,0,20,40,92,45,47,184,9,0,51,65,334,15,319,793,322,45,62,0,18,601,1529,42,10,0,41,0,93,481,1548,4025
BIHAR,BETTIAH,2010,63,3,4,70,18,0,18,36,111,88,23,222,5,0,19,77,358,15,343,817,304,95,92,4,11,622,1293,33,6,0,51,0,90,165,1714,3755
BIHAR,BHABHUA,2010,65,54,0,119,6,0,6,12,39,35,4,78,11,0,29,51,212,31,181,515,155,16,28,0,8,215,449,27,0,0,16,0,43,27,924,1883
BIHAR,BHAGALPUR,2010,73,135,4,212,22,0,22,44,86,80,6,172,3,0,27,127,533,229,304,1223,197,30,91,1,34,476,950,20,12,0,42,0,74,121,1186,3220
BIHAR,BHOJPUR,2010,111,36,0,147,15,0,15,30,72,55,17,144,25,0,62,85,458,125,333,1088,234,20,97,0,14,215,895,50,3,0,181,0,234,315,1976,3969
BIHAR,BUXAR,2010,57,98,1,156,12,0,12,24,55,40,15,110,21,2,44,75,300,77,223,742,204,3,35,1,2,465,788,17,15,1,40,0,73,78,654,2180
BIHAR,DARBHANGA,2010,59,167,23,249,18,0,18,36,97,87,10,194,13,2,19,75,399,171,228,907,319,59,286,0,24,120,898,23,68,0,151,2,244,90,2294,4308
BIHAR,GAYA,2010,139,35,12,186,22,0,22,44,109,82,27,218,48,4,103,138,701,214,487,1695,319,21,117,1,21,1,739,42,3,0,97,0,142,259,2514,4706
BIHAR,GOPALGANJ,2010,76,53,3,132,18,0,18,36,109,85,24,218,6,1,22,68,205,31,174,507,189,19,118,0,13,855,1278,48,0,0,125,0,173,84,767,2779
BIHAR,JAMALPUR RLY.,2010,3,1,1,5,0,0,0,0,7,3,4,14,11,2,7,1,148,18,130,317,6,0,4,0,0,0,10,0,3,0,0,0,3,0,52,246
BIHAR,JAMUI,2010,81,143,19,243,20,0,20,40,57,29,28,114,20,0,42,46,150,25,125,408,139,8,32,0,21,634,927,17,33,0,48,0,98,93,277,1880
BIHAR,JEHANABAD,2010,43,13,3,59,8,0,8,16,42,11,31,84,13,3,13,63,246,62,184,584,149,20,54,2,10,152,446,33,10,0,30,0,73,59,866,1832
BIHAR,KATIHAR,2010,90,47,2,139,55,0,55,110,119,87,32,238,6,0,20,63,200,46,154,489,207,18,71,0,10,343,776,20,6,0,55,3,84,127,1026,2488
BIHAR,KATIHAR RLY.,2010,14,1,0,15,1,0,1,2,8,2,6,16,3,1,5,9,223,10,213,464,9,1,4,0,1,45,62,0,4,0,2,0,6,2,86,419
BIHAR,KHAGARIA,2010,63,104,7,174,5,0,5,10,36,28,8,72,9,0,15,20,123,20,103,290,164,6,22,1,11,578,921,22,14,0,20,0,56,139,501,1860
BIHAR,KISHANGANJ,2010,36,41,7,84,24,0,24,48,50,38,12,100,4,0,10,53,131,43,88,329,108,15,26,2,16,161,358,4,0,0,41,0,45,30,475,1234
BIHAR,LAKHISARAI,2010,43,45,0,88,10,0,10,20,40,15,25,80,16,0,20,51,111,15,96,309,125,25,26,0,8,466,707,14,4,0,30,0,48,57,225,1316
BIHAR,MADHEPURA,2010,54,81,1,136,11,0,11,22,61,52,9,122,4,1,48,23,146,30,116,368,194,19,18,0,4,85,429,13,9,0,25,0,47,109,971,1877
BIHAR,MADHUBANI,2010,73,10,0,83,30,0,30,60,141,131,10,282,20,0,31,65,458,165,293,1032,340,0,26,1,0,1053,1522,31,6,0,90,1,128,102,1841,4319
BIHAR,MOTIHARI,2010,169,417,66,652,25,0,25,50,173,130,43,346,23,0,76,119,527,128,399,1272,450,64,93,4,36,1181,1828,32,0,0,46,0,78,0,2045,5546
BIHAR,MUNGER,2010,82,98,1,181,11,0,11,22,80,68,12,160,26,1,39,54,217,52,165,554,165,29,52,1,14,212,541,14,3,0,43,0,60,68,842,2052
BIHAR,MUZAFFARPUR,2010,148,11,12,171,52,0,52,104,229,187,42,458,44,4,63,192,962,407,555,2227,419,41,122,0,31,38,1255,64,7,0,56,0,127,604,3442,6541
BIHAR,MUZAFFARPUR RLY.,2010,15,19,0,34,1,0,1,2,7,2,5,14,7,1,6,9,304,39,265,631,6,0,9,2,0,60,77,0,0,0,0,0,0,0,78,524
BIHAR,NALANDA,2010,117,75,19,211,26,0,26,52,93,74,19,186,6,0,36,98,318,18,300,776,178,48,87,6,14,533,1097,62,30,0,60,0,152,231,2374,4411
BIHAR,NAUGACHIA,2010,39,31,5,75,8,0,8,16,36,21,15,72,2,1,11,13,52,7,45,131,126,21,36,0,4,175,417,12,23,0,47,0,82,55,519,1216
BIHAR,NAWADAH,2010,73,17,2,92,11,0,11,22,65,45,20,130,6,1,18,50,168,27,141,411,112,22,37,3,11,458,769,23,3,0,37,2,65,126,1041,2286
BIHAR,PATNA,2010,304,20,5,329,50,0,50,100,283,148,135,566,42,0,184,594,2627,1308,1319,6074,516,11,591,12,2,34,1569,95,12,3,316,0,426,403,7932,14036
BIHAR,PATNA RLY.,2010,10,8,2,20,1,0,1,2,10,5,5,20,5,3,16,4,726,39,687,1480,24,2,25,0,0,0,51,6,17,0,2,0,25,0,320,1181
BIHAR,PURNEA,2010,80,130,11,221,40,0,40,80,106,88,18,212,11,2,23,68,172,9,163,448,145,71,119,0,35,220,728,16,22,1,60,0,99,138,1489,2959
BIHAR,ROHTAS,2010,132,82,45,259,27,0,27,54,115,95,20,230,43,1,73,134,589,99,490,1429,228,31,19,0,3,328,960,45,49,11,31,0,136,351,2151,4488
BIHAR,SAHARSA,2010,39,102,0,141,7,0,7,14,51,17,34,102,6,0,35,45,108,12,96,302,251,35,59,0,14,197,617,9,39,0,22,0,70,61,715,1795
BIHAR,SAMASTIPUR,2010,119,215,12,346,36,0,36,72,189,9,180,378,10,1,54,107,369,103,266,910,317,26,52,1,36,260,867,62,7,0,42,0,111,175,1973,4063
BIHAR,SARAN,2010,112,90,16,218,23,0,23,46,136,107,29,272,19,2,56,112,488,66,422,1165,344,40,96,0,40,1461,2296,78,24,0,103,0,205,315,495,4050
BIHAR,SHEIKHPURA,2010,22,2,0,24,2,0,2,4,22,13,9,44,3,0,12,18,82,2,80,197,69,5,33,0,10,183,330,5,0,0,10,0,15,30,415,923
BIHAR,SHEOHAR,2010,21,3,0,24,3,0,3,6,17,12,5,34,15,0,7,19,60,7,53,161,41,3,12,0,4,60,120,2,2,0,8,0,12,0,269,546
BIHAR,SITAMARHI,2010,68,30,3,101,9,0,9,18,60,40,20,120,28,4,29,105,465,228,237,1096,189,6,10,0,22,50,366,28,18,0,25,0,71,89,2538,3776
BIHAR,SIWAN,2010,78,69,0,147,19,0,19,38,133,105,28,266,20,2,37,66,305,22,283,735,251,12,88,0,41,1250,1760,63,10,0,41,0,114,118,503,3106
BIHAR,SUPAUL,2010,52,29,12,93,19,0,19,38,67,38,29,134,8,0,15,38,136,28,108,333,206,27,51,3,21,88,438,12,6,0,8,0,26,42,881,1721
BIHAR,VAISHALI,2010,128,45,14,187,30,0,30,60,197,145,52,394,15,3,51,151,518,236,282,1256,351,36,66,2,22,210,882,74,15,0,57,0,146,195,2192,4372
CHHATTISGARH,BALRAMPUR,2010,30,20,1,51,61,0,61,122,12,0,12,24,3,1,14,37,28,0,28,111,29,1,6,0,5,58,148,1,71,29,0,0,101,49,430,886
CHHATTISGARH,BILASPUR,2010,106,49,1,156,69,0,69,138,38,26,12,76,5,1,61,525,799,223,576,2190,224,22,75,5,53,1923,2547,20,167,18,130,0,335,245,2063,6599
CHHATTISGARH,BIZAPUR,2010,73,102,1,176,3,0,3,6,10,3,7,20,20,1,3,6,11,4,7,52,14,0,1,1,7,18,49,0,0,0,6,0,6,8,110,395
CHHATTISGARH,DANTEWARA,2010,63,83,0,146,9,0,9,18,8,6,2,16,12,0,9,32,37,12,25,127,34,2,3,1,24,36,145,2,8,0,5,0,15,45,279,692
CHHATTISGARH,DHAMTARI,2010,18,5,0,23,40,0,40,80,10,5,5,20,5,0,7,103,150,48,102,415,25,3,25,0,3,71,218,2,55,6,18,0,81,91,745,1382
CHHATTISGARH,DURG,2010,85,58,3,146,106,0,106,212,39,35,4,78,1,5,83,634,954,389,565,2631,101,21,195,8,31,345,1134,14,269,36,118,0,437,433,6024,9563
CHHATTISGARH,GRP RAIPUR,2010,1,3,0,4,1,0,1,2,2,2,0,4,0,0,7,4,329,13,316,669,1,0,1,0,0,6,9,0,3,0,1,0,4,1,47,407
CHHATTISGARH,JAGDALPUR,2010,66,48,0,114,48,0,48,96,17,15,2,34,11,0,20,101,138,89,49,408,30,9,14,4,6,599,833,4,33,4,23,0,64,171,811,2157
CHHATTISGARH,JANJGIR,2010,47,21,3,71,39,0,39,78,9,8,1,18,3,0,30,197,288,91,197,806,117,13,40,4,28,901,1252,14,90,6,100,0,210,149,797,2896
CHHATTISGARH,JASHPUR,2010,62,15,1,78,69,0,69,138,24,21,3,48,3,4,21,73,71,15,56,243,26,3,9,3,6,85,226,0,53,4,26,0,83,94,588,1240
CHHATTISGARH,KABIRDHAM,2010,22,8,3,33,19,0,19,38,8,7,1,16,0,0,5,75,67,21,46,214,33,2,12,1,5,513,636,2,85,7,18,0,112,70,423,1378
CHHATTISGARH,KANKER,2010,42,51,0,93,18,0,18,36,11,5,6,22,15,1,12,46,53,21,32,180,28,1,14,0,8,19,134,2,27,2,8,0,39,64,554,976
CHHATTISGARH,KORBA,2010,41,12,2,55,32,0,32,64,7,6,1,14,4,1,30,160,217,94,123,629,55,10,30,1,3,788,1038,10,80,4,40,0,134,151,922,2600
CHHATTISGARH,KORIYA,2010,32,13,1,46,58,0,58,116,21,21,0,42,5,0,9,172,124,30,94,434,25,2,21,0,6,621,735,3,98,9,48,0,158,60,489,1817
CHHATTISGARH,MAHASAMUND,2010,34,15,0,49,26,0,26,52,7,6,1,14,2,0,14,116,165,36,129,462,12,2,26,2,9,175,365,7,65,5,13,0,90,139,790,1624
CHHATTISGARH,NARAYANPUR,2010,18,41,0,59,3,0,3,6,9,2,7,18,8,0,1,7,8,5,3,32,0,0,1,0,3,18,26,0,5,0,2,0,7,4,59,187
CHHATTISGARH,RAIGARH,2010,67,37,4,108,52,0,52,104,19,19,0,38,13,0,52,264,328,166,162,985,93,22,71,4,23,684,1080,10,89,7,45,0,151,183,1063,3130
CHHATTISGARH,RAIPUR,2010,102,86,4,192,136,0,136,272,49,39,10,98,7,1,108,750,1554,722,832,3974,164,65,188,15,59,2720,3767,7,268,33,125,2,435,556,3361,10360
CHHATTISGARH,RAJNANDGAON,2010,47,39,1,87,43,0,43,86,18,15,3,36,1,0,16,177,194,55,139,582,28,6,32,8,16,104,341,9,72,5,41,0,127,147,1845,2849
CHHATTISGARH,SARGUJA,2010,51,38,3,92,103,0,103,206,25,25,0,50,2,0,38,144,206,89,117,596,30,9,27,1,13,69,277,3,99,1,40,0,143,128,1188,2218
CHHATTISGARH,SURAJPUR,2010,58,12,2,72,77,0,77,154,16,13,3,32,2,0,12,88,84,16,68,270,23,3,22,1,11,435,614,5,69,6,54,0,134,119,503,1602
GOA,NORTH GOA,2010,25,12,2,39,12,0,12,24,10,7,3,20,0,0,28,209,598,195,403,1433,40,30,80,17,13,117,444,1,24,10,9,0,44,147,542,1926
GOA,SOUTH GOA,2010,10,15,1,26,24,0,24,48,15,11,4,30,2,0,11,159,436,164,272,1044,24,27,37,16,10,60,283,0,12,6,8,0,26,109,385,1367
GUJARAT,AHMEDABAD COMMR.,2010,82,66,4,152,49,0,49,98,207,177,30,414,26,2,805,799,4659,3101,1558,10950,171,263,212,17,4,1365,2235,12,73,9,1230,0,1324,203,11184,21442
GUJARAT,AHMEDABAD RURAL,2010,31,17,3,51,8,0,8,16,44,41,3,88,7,0,23,102,303,133,170,738,63,80,10,3,7,264,815,0,14,0,113,0,127,388,1893,3373
GUJARAT,AHWA-DANG,2010,11,1,0,12,1,0,1,2,0,0,0,0,0,0,0,2,6,0,6,14,0,1,0,0,1,11,33,0,0,0,2,0,2,20,98,154
GUJARAT,AMRELI,2010,19,5,3,27,10,0,10,20,65,61,4,130,1,0,18,108,188,83,105,503,46,44,10,8,6,216,468,0,25,9,162,0,196,138,1086,2167
GUJARAT,ANAND,2010,24,8,3,35,15,0,15,30,45,39,6,90,7,0,13,101,440,238,202,1001,42,60,21,4,16,328,737,0,27,3,190,0,220,266,1851,3464
GUJARAT,BHARUCH,2010,37,15,0,52,9,0,9,18,27,23,4,54,8,0,13,119,318,131,187,776,45,65,13,8,19,297,765,0,18,4,2,0,24,318,1537,2872
GUJARAT,BHAVNAGAR,2010,50,29,2,81,8,0,8,16,62,58,4,124,1,2,22,176,513,237,276,1227,92,28,45,19,15,507,706,0,32,42,177,0,251,0,2311,4133
GUJARAT,CID CRIME,2010,3,0,0,3,1,0,1,2,0,0,0,0,0,0,0,0,1,0,1,2,0,7,14,0,0,0,21,0,0,0,0,0,0,0,1,27
GUJARAT,DAHOD,2010,39,16,8,63,3,0,3,6,54,51,3,108,17,0,44,58,182,106,76,483,54,4,7,2,12,292,561,0,15,0,7,0,22,190,828,1832
GUJARAT,GANDHINAGAR,2010,16,9,1,26,13,0,13,26,29,27,2,58,6,1,12,118,524,251,273,1185,38,5,42,10,5,203,510,1,11,4,152,0,168,207,4348,5755
GUJARAT,HIMATNAGAR,2010,28,17,2,47,18,0,18,36,52,50,2,104,5,0,10,104,212,98,114,543,39,34,28,13,4,168,560,0,26,2,240,0,268,274,2437,3713
GUJARAT,JAMNAGAR,2010,44,26,0,70,14,0,14,28,32,25,7,64,2,1,23,159,359,168,191,903,88,29,34,6,7,343,508,0,27,2,232,0,261,1,2543,3972
GUJARAT,JUNAGADH,2010,48,19,0,67,19,0,19,38,68,63,5,136,3,0,36,185,553,306,247,1330,93,42,44,12,21,482,902,0,37,8,443,0,488,208,2369,4690
GUJARAT,KHEDA NORTH,2010,35,10,0,45,16,0,16,32,63,59,4,126,9,0,13,70,258,106,152,608,58,23,28,9,8,277,678,0,28,0,200,0,228,275,3897,5277
GUJARAT,KUTCH,2010,37,17,0,54,8,0,8,16,36,31,5,72,11,1,16,130,404,199,205,966,63,42,26,14,10,360,528,0,18,1,227,0,246,13,2824,4258
GUJARAT,MEHSANA,2010,22,15,3,40,8,0,8,16,66,58,8,132,9,1,25,150,641,231,410,1467,67,38,23,17,6,1089,1465,0,27,0,241,0,268,225,1929,4602
GUJARAT,NARMADA,2010,17,2,1,20,7,0,7,14,4,4,0,8,0,0,3,8,34,21,13,79,12,17,8,2,2,112,237,0,8,0,5,0,13,84,515,841
GUJARAT,NAVSARI,2010,22,2,0,24,6,0,6,12,19,15,4,38,1,0,6,43,92,41,51,234,25,20,6,6,1,64,122,0,5,1,34,0,40,0,725,1078
GUJARAT,PALANPUR,2010,40,23,1,64,38,0,38,76,110,108,2,220,11,0,58,208,563,300,263,1403,73,37,35,8,22,551,974,1,59,5,293,0,358,248,2344,4728
GUJARAT,PANCHMAHAL,2010,47,10,2,59,13,0,13,26,58,58,0,116,2,0,16,93,184,94,90,479,48,49,14,1,17,290,760,0,31,0,188,0,219,341,2316,3720
GUJARAT,PATAN,2010,11,9,0,20,11,0,11,22,38,37,1,76,5,0,16,77,270,112,158,638,28,25,17,11,4,312,559,0,32,1,101,0,134,162,1308,2438
GUJARAT,PORBANDAR,2010,9,7,0,16,2,0,2,4,12,9,3,24,0,0,2,26,49,16,33,126,9,9,16,2,3,83,160,1,4,3,69,0,77,38,531,875
GUJARAT,RAJKOT COMMR.,2010,38,22,1,61,12,0,12,24,39,32,7,78,9,0,34,243,1039,798,241,2364,64,52,26,9,17,393,678,0,14,7,294,0,315,117,1594,4024
GUJARAT,RAJKOT RURAL,2010,41,23,1,65,24,0,24,48,69,60,9,138,6,1,12,90,287,181,106,683,47,31,10,9,10,207,631,1,22,5,253,0,281,317,2275,3741
GUJARAT,SURAT COMMR.,2010,87,19,1,107,23,0,23,46,82,63,19,164,12,7,80,273,1712,1247,465,3796,87,34,126,36,7,556,1210,3,24,1,268,0,296,364,3624,7426
GUJARAT,SURAT RURAL,2010,41,8,0,49,6,0,6,12,25,23,2,50,2,0,8,50,187,132,55,434,20,26,20,6,6,76,540,0,4,0,28,0,32,386,799,1698
GUJARAT,SURENDRANAGAR,2010,24,12,2,38,29,0,29,58,29,27,2,58,3,1,15,76,203,95,108,501,56,37,11,4,6,410,759,0,36,2,113,0,151,235,1567,2871
GUJARAT,TAPI,2010,19,2,1,22,3,0,3,6,1,1,0,2,0,0,3,16,59,44,15,137,3,5,1,3,1,151,276,0,7,0,17,0,24,112,263,667
GUJARAT,VADODARA COMMR.,2010,23,25,1,49,7,0,7,14,36,30,6,72,9,0,19,319,1529,1044,485,3405,89,35,115,3,4,276,702,0,18,0,216,0,234,180,2448,5352
GUJARAT,VADODARA RURAL,2010,66,16,4,86,16,0,16,32,55,50,5,110,8,0,14,71,212,102,110,517,37,35,10,7,18,266,702,0,18,0,85,0,103,329,1396,2663
GUJARAT,VALSAD,2010,29,10,0,39,11,0,11,22,14,8,6,28,3,1,12,87,284,161,123,671,49,27,21,4,1,111,477,0,4,0,15,0,19,264,874,1821
GUJARAT,W.RLY,2010,8,2,0,10,0,0,0,0,6,2,4,12,3,0,13,10,529,41,488,1084,17,10,9,2,0,71,113,0,4,1,3,0,8,4,73,765
HARYANA,AMBALA,2010,35,30,1,66,30,0,30,60,33,23,10,66,4,10,18,288,652,424,228,1624,3,25,133,2,10,198,375,9,20,14,220,0,263,4,1109,2848
HARYANA,BHIWANI,2010,61,38,1,100,30,0,30,60,52,36,16,104,7,2,43,264,539,347,192,1394,171,16,89,1,17,214,517,22,45,15,64,0,146,9,1171,2871
HARYANA,FARIDABAD,2010,70,49,5,124,51,0,51,102,102,86,16,204,9,70,20,277,1672,1352,320,3720,178,174,154,0,5,191,926,23,27,78,224,0,352,224,1317,4920
HARYANA,FATEHABAD,2010,27,33,2,62,21,0,21,42,33,31,2,66,1,9,9,119,241,168,73,620,14,7,37,3,5,119,191,5,13,9,79,0,106,6,593,1385
HARYANA,GRP,2010,22,4,0,26,1,0,1,2,3,2,1,6,2,0,18,1,473,109,364,967,23,5,7,3,0,9,64,5,8,144,0,0,157,17,454,1199
HARYANA,GURGAON,2010,84,59,3,146,45,0,45,90,58,42,16,116,5,28,119,492,3124,2480,644,6892,96,99,254,2,2,146,632,22,30,38,86,0,176,33,1911,6736
HARYANA,HISSAR,2010,91,74,1,166,25,0,25,50,84,65,19,168,5,8,51,320,829,532,297,2042,78,16,179,5,43,316,648,13,24,17,261,0,315,11,1370,3821
HARYANA,JHAJJAR,2010,51,50,5,106,36,0,36,72,42,30,12,84,7,6,37,185,527,276,251,1289,69,25,47,0,10,110,471,12,27,30,117,0,186,210,534,2137
HARYANA,JIND,2010,53,40,4,97,29,0,29,58,35,26,9,70,0,3,43,248,560,366,194,1414,116,65,49,1,14,148,400,17,27,20,88,0,152,7,868,2435
HARYANA,KAITHAL,2010,30,24,2,56,28,0,28,56,27,20,7,54,6,5,19,160,304,202,102,798,0,59,19,1,9,204,298,11,15,0,112,0,138,6,627,1668
HARYANA,KARNAL,2010,49,50,2,101,52,0,52,104,33,20,13,66,5,13,24,269,836,529,307,1983,53,25,135,1,7,285,762,21,29,22,231,0,303,256,1049,3447
HARYANA,KURUKSHETRA,2010,34,21,2,57,36,0,36,72,34,26,8,68,2,3,22,237,727,484,243,1718,0,78,31,5,14,175,307,13,9,24,79,0,125,4,986,2536
HARYANA,MAHENDRAGARH,2010,31,19,3,53,28,0,28,56,40,36,4,80,9,0,27,121,339,154,185,835,112,24,23,0,16,133,312,7,25,0,86,0,118,4,788,1835
HARYANA,MEWAT,2010,26,36,3,65,28,0,28,56,36,19,17,72,13,20,17,63,407,269,138,927,130,18,59,1,1,80,292,5,12,5,150,0,172,3,796,1909
HARYANA,PALWAL,2010,34,44,6,84,41,0,41,82,41,27,14,82,11,11,26,66,617,441,176,1348,150,37,36,0,7,158,394,14,30,0,89,0,133,6,882,2306
HARYANA,PANCHKULA,2010,20,6,1,27,10,0,10,20,16,12,4,32,4,2,7,147,323,202,121,806,2,115,84,1,2,28,239,1,10,1,98,0,110,7,443,1328
HARYANA,PANIPAT,2010,32,31,10,73,55,0,55,110,65,49,16,130,7,12,41,176,849,639,210,1934,88,27,50,0,5,152,597,13,22,30,175,0,240,275,694,2809
HARYANA,REWARI,2010,29,29,0,58,25,0,25,50,33,24,9,66,25,2,63,171,543,409,134,1347,40,34,8,0,6,167,263,14,16,27,71,0,128,8,1040,2351
HARYANA,ROHTAK,2010,72,53,6,131,51,0,51,102,32,19,13,64,7,27,34,276,855,616,239,2054,59,28,76,1,8,173,539,17,26,57,87,0,187,194,938,3077
HARYANA,SIRSA,2010,45,33,1,79,39,0,39,78,47,30,17,94,3,2,14,190,387,272,115,983,28,13,28,1,19,329,418,8,9,0,125,0,142,0,686,2007
HARYANA,SONIPAT,2010,81,66,3,150,27,0,27,54,75,56,19,150,9,10,62,215,984,668,316,2264,3,20,104,1,14,222,669,26,32,36,123,0,217,305,1057,3475
HARYANA,YAMUNANAGAR,2010,28,47,2,77,32,0,32,64,42,35,7,84,6,5,20,160,478,360,118,1147,1,9,60,0,7,176,259,6,20,13,155,0,194,6,747,2020
HIMACHAL PRADESH,BADDIPOLICEDIST,2010,9,6,0,15,5,0,5,10,9,6,3,18,0,0,1,19,50,24,26,120,17,3,6,0,1,124,214,0,6,1,4,0,11,63,44,368
HIMACHAL PRADESH,BILASPUR,2010,9,10,2,21,15,0,15,30,8,6,2,16,0,0,1,28,69,30,39,167,32,4,14,0,8,46,129,0,37,6,32,0,75,25,792,1138
HIMACHAL PRADESH,CHAMBA,2010,5,4,1,10,13,0,13,26,22,21,1,44,0,0,0,77,48,24,24,173,26,1,5,0,6,72,168,1,29,1,5,0,36,58,289,663
HIMACHAL PRADESH,CID,2010,0,0,0,0,0,0,0,0,0,0,0,0,0,0,0,0,0,0,0,0,0,0,0,0,0,0,0,0,0,0,0,0,0,0,5,5
HIMACHAL PRADESH,G.R.P.,2010,1,0,0,1,0,0,0,0,0,0,0,0,0,0,0,0,3,0,3,6,0,0,1,0,0,1,2,0,0,0,0,0,0,0,11,17
HIMACHAL PRADESH,HAMIRPUR,2010,11,4,3,18,11,0,11,22,19,16,3,38,0,0,0,46,37,11,26,120,34,6,29,0,12,222,328,0,27,23,17,0,67,25,489,1015
HIMACHAL PRADESH,KANGRA,2010,27,12,2,41,22,0,22,44,38,33,5,76,1,0,1,143,139,49,90,423,101,16,81,2,26,240,477,0,60,8,53,0,121,11,1433,2416
HIMACHAL PRADESH,KINNAUR,2010,4,0,0,4,2,0,2,4,2,2,0,4,0,0,0,19,3,1,2,25,33,1,3,0,1,8,78,0,2,0,4,0,6,32,83,197
HIMACHAL PRADESH,KULLU,2010,11,5,0,16,17,0,17,34,9,5,4,18,0,0,0,39,42,7,35,123,39,1,15,0,2,44,140,0,23,1,9,0,33,39,512,808
HIMACHAL PRADESH,LAHAUL-SPITI,2010,0,1,0,1,0,0,0,0,0,0,0,0,0,0,0,0,5,0,5,10,1,1,0,0,0,1,13,0,1,0,3,0,4,10,44,67
HIMACHAL PRADESH,MANDI,2010,11,11,0,22,19,0,19,38,19,15,4,38,0,0,2,88,79,26,53,248,88,11,52,0,22,164,387,0,71,13,45,0,129,50,1043,1788
HIMACHAL PRADESH,SHIMLA,2010,20,6,1,27,21,0,21,42,23,22,1,46,0,0,1,121,163,66,97,448,92,24,31,2,30,47,346,0,27,4,29,0,60,120,1028,1790
HIMACHAL PRADESH,SIRMAUR,2010,10,5,1,16,15,0,15,30,14,12,2,28,1,0,1,39,59,30,29,159,67,10,34,0,7,48,235,0,36,5,17,0,58,69,406,844
HIMACHAL PRADESH,SOLAN,2010,5,6,1,12,11,0,11,22,13,11,2,26,0,0,0,82,74,39,35,230,42,9,9,0,4,250,355,0,12,1,20,0,33,41,313,893
HIMACHAL PRADESH,UNA,2010,9,4,1,14,9,0,9,18,18,13,5,36,0,0,4,42,67,27,40,180,43,23,38,0,8,107,286,1,19,15,37,0,72,67,528,1040
JAMMU & KASHMIR,ANANTNAG,2010,7,15,0,22,7,0,7,14,75,71,4,150,0,0,4,99,140,37,103,383,223,10,19,5,18,1,307,0,112,24,3,0,139,31,506,1299
JAMMU & KASHMIR,AWANTIPORA,2010,2,2,0,4,2,0,2,4,17,17,0,34,0,0,5,19,34,8,26,92,79,0,5,1,2,0,114,0,19,3,0,0,22,27,263,480
JAMMU & KASHMIR,BANDIPORA,2010,14,13,0,27,4,0,4,8,45,42,3,90,0,0,3,33,53,7,46,142,106,0,5,0,5,0,116,0,66,9,0,0,75,0,204,560
JAMMU & KASHMIR,BARAMULLA,2010,10,10,2,22,7,0,7,14,57,55,2,114,0,0,1,81,71,12,59,224,176,11,12,0,27,0,226,0,68,12,1,0,81,0,429,975
JAMMU & KASHMIR,BUDGAM,2010,2,25,4,31,7,0,7,14,67,67,0,134,0,0,10,91,278,27,251,657,201,5,18,0,17,1,259,0,93,34,0,0,127,17,482,1352
JAMMU & KASHMIR,CRIME JAMMU,2010,0,0,0,0,0,0,0,0,0,0,0,0,0,0,0,0,0,0,0,0,0,0,19,0,0,0,19,0,0,0,0,0,0,0,1,20
JAMMU & KASHMIR,CRIME KASHMIR,2010,0,0,0,0,0,0,0,0,0,0,0,0,0,0,0,0,0,0,0,0,0,3,29,0,0,0,32,0,0,0,0,0,0,0,0,32
JAMMU & KASHMIR,DODA,2010,5,32,0,37,21,0,21,42,59,57,2,118,0,0,1,49,46,2,44,142,14,4,11,0,14,15,62,0,27,6,21,0,54,4,541,870
JAMMU & KASHMIR,GANDERBAL,2010,4,3,0,7,1,0,1,2,15,15,0,30,0,0,0,15,32,7,25,79,66,6,8,1,3,2,163,0,44,0,1,0,45,77,87,365
JAMMU & KASHMIR,HANDWARA,2010,10,36,0,46,1,0,1,2,36,35,1,72,1,0,0,19,47,2,45,114,25,4,10,0,2,1,42,0,47,7,1,0,55,0,173,420
JAMMU & KASHMIR,JAMMU,2010,23,86,5,114,36,0,36,72,81,78,3,162,0,0,1,216,494,315,179,1205,69,42,105,0,16,34,450,6,36,42,70,0,154,184,2430,3976
JAMMU & KASHMIR,KARGIL,2010,1,0,0,1,0,0,0,0,1,1,0,2,0,0,0,11,11,3,8,33,8,2,1,0,2,0,19,0,0,0,0,0,0,6,93,136
JAMMU & KASHMIR,KATHUA,2010,11,20,2,33,17,0,17,34,19,17,2,38,0,0,1,49,68,23,45,186,40,5,17,0,13,17,96,2,26,4,5,0,37,4,741,1061
JAMMU & KASHMIR,KISHTWAR,2010,9,24,0,33,3,0,3,6,26,23,3,52,1,0,0,20,20,1,19,61,0,2,7,1,0,1,14,0,5,0,5,0,10,3,211,338
JAMMU & KASHMIR,KULGAM,2010,6,15,0,21,4,0,4,8,45,40,5,90,0,0,10,58,61,19,42,190,115,13,6,1,11,41,213,0,60,5,1,0,66,26,234,712
JAMMU & KASHMIR,KUPWARA,2010,7,25,1,33,3,0,3,6,33,30,3,66,0,0,0,53,53,6,47,159,107,1,10,1,4,4,131,0,21,4,1,0,26,4,195,527
JAMMU & KASHMIR,LEH,2010,1,1,0,2,2,0,2,4,4,3,1,8,0,0,0,10,5,0,5,20,8,1,3,0,0,3,15,0,3,0,0,0,3,0,117,158
JAMMU & KASHMIR,POONCH,2010,12,37,1,50,20,0,20,40,39,34,5,78,0,0,0,23,31,3,28,85,132,4,8,0,0,54,202,0,30,10,16,0,56,4,529,950
JAMMU & KASHMIR,PULWAMA,2010,4,10,2,16,8,0,8,16,33,31,2,66,1,0,4,37,80,10,70,202,172,3,7,3,8,55,250,0,11,13,0,0,24,2,164,617
JAMMU & KASHMIR,RAILWAYS,2010,0,0,0,0,0,0,0,0,1,0,1,2,0,0,0,1,12,1,11,25,16,1,0,0,0,0,17,0,0,0,0,0,0,0,5,36
JAMMU & KASHMIR,RAILWAYS,2010,1,0,1,2,1,0,1,2,0,0,0,0,0,0,0,0,8,1,7,16,0,0,0,0,0,0,0,0,0,0,0,0,0,0,10,21
JAMMU & KASHMIR,RAJOURI,2010,15,36,6,57,36,0,36,72,47,42,5,94,2,0,0,44,52,20,32,150,33,10,15,0,22,30,148,0,26,4,44,0,74,38,1000,1460
JAMMU & KASHMIR,RAMBAN,2010,3,9,0,12,6,0,6,12,17,17,0,34,0,0,0,24,37,20,17,98,17,3,10,1,1,2,36,0,11,2,0,0,13,2,491,636
JAMMU & KASHMIR,REASI,2010,5,15,1,21,8,0,8,16,12,12,0,24,0,0,1,29,41,4,37,112,1,1,9,0,4,2,20,0,13,1,0,0,14,3,399,545
JAMMU & KASHMIR,SAMBA,2010,9,13,1,23,5,0,5,10,4,4,0,8,0,0,0,30,42,9,33,114,27,0,7,1,2,2,39,1,7,1,6,0,15,0,502,660
JAMMU & KASHMIR,SHOPIAN,2010,4,22,0,26,9,0,9,18,47,45,2,94,0,0,3,38,116,21,95,273,72,1,11,2,13,0,108,0,96,5,1,0,102,9,172,621
JAMMU & KASHMIR,SOPORE,2010,30,67,0,97,9,0,9,18,38,34,4,76,0,0,3,63,145,8,137,356,122,2,1,0,18,1,144,0,59,13,3,0,75,0,160,734
JAMMU & KASHMIR,SRINAGAR,2010,15,186,0,201,13,0,13,26,68,60,8,136,1,0,12,247,497,388,109,1254,313,14,63,2,20,8,473,0,130,58,17,0,205,53,913,2630
JAMMU & KASHMIR,UDHAMPUR,2010,7,9,0,16,15,0,15,30,10,10,0,20,0,0,2,47,36,13,23,121,27,2,6,0,2,4,41,0,28,5,15,0,48,0,817,1032
JHARKHAND,BOKARO,2010,70,7,0,77,28,0,28,56,64,64,0,128,13,0,30,74,654,137,517,1425,128,79,82,0,0,0,289,26,2,0,70,0,98,0,1481,2808
JHARKHAND,CHAIBASA,2010,119,47,0,166,48,0,48,96,24,24,0,48,12,0,33,14,142,62,80,343,13,3,28,0,2,7,79,1,7,0,7,0,15,26,383,916
JHARKHAND,CHATRA,2010,31,36,1,68,11,0,11,22,26,21,5,52,9,0,22,20,76,15,61,203,82,6,15,0,6,60,253,18,3,0,9,0,30,84,408,923
JHARKHAND,DEOGHAR,2010,58,17,3,78,33,0,33,66,28,17,11,56,16,5,20,126,293,97,196,753,158,23,22,2,6,331,561,19,7,2,21,0,49,19,493,1702
JHARKHAND,DHANBAD,2010,58,31,10,99,32,0,32,64,95,83,12,190,52,3,47,205,897,394,503,2101,209,28,59,3,6,132,440,31,30,2,34,0,97,3,1868,3835
JHARKHAND,DHANBAD RLY.,2010,5,0,0,5,1,0,1,2,4,3,1,8,8,0,7,2,185,29,156,387,8,0,6,3,0,0,17,1,11,0,0,0,12,0,95,336
JHARKHAND,DUMKA,2010,57,16,4,77,52,0,52,104,38,27,11,76,4,0,8,58,253,42,211,576,62,17,11,0,7,358,551,6,8,0,46,0,60,96,403,1504
JHARKHAND,GARHWA,2010,61,91,0,152,21,0,21,42,27,23,4,54,8,0,40,44,69,13,56,230,163,3,36,0,18,256,534,10,11,0,38,0,59,58,349,1303
JHARKHAND,GIRIDIH,2010,59,55,0,114,37,0,37,74,58,18,40,116,33,0,30,73,293,63,230,722,316,8,42,0,12,135,583,39,9,4,63,0,115,70,1244,2580
JHARKHAND,GODDA,2010,57,104,3,164,26,0,26,52,42,25,17,84,4,3,16,45,146,19,127,360,131,19,28,0,11,299,530,7,25,0,11,0,43,42,445,1464
JHARKHAND,GUMLA,2010,153,66,11,230,57,0,57,114,44,41,3,88,6,2,31,11,76,33,43,202,30,17,22,0,12,80,259,2,8,0,7,1,18,98,211,945
JHARKHAND,HAZARIBAGH,2010,69,50,5,124,30,0,30,60,53,50,3,106,17,2,41,68,214,97,117,556,232,20,58,2,9,476,808,27,18,0,42,0,87,11,794,2238
JHARKHAND,JAMSHEDPUR,2010,113,36,15,164,38,0,38,76,89,58,31,178,14,1,36,171,947,494,453,2116,160,50,102,0,18,749,1254,15,9,3,55,0,82,175,778,3574
JHARKHAND,JAMSHEDPUR RLY.,2010,8,0,1,9,0,0,0,0,4,1,3,8,1,0,8,1,165,13,152,340,0,0,3,0,0,15,19,0,1,0,0,0,1,1,40,248
JHARKHAND,JAMTARA,2010,25,54,1,80,9,0,9,18,9,7,2,18,8,0,10,17,59,29,30,153,49,5,9,0,3,0,66,2,9,0,0,0,11,0,256,525
JHARKHAND,KHUNTI,2010,71,7,2,80,2,0,2,4,7,2,5,14,6,0,13,6,43,9,34,111,4,20,8,0,0,7,92,0,2,0,4,4,10,53,47,306
JHARKHAND,KODERMA,2010,29,44,1,74,15,0,15,30,23,13,10,46,7,0,8,21,85,25,60,206,60,19,52,0,3,144,356,8,6,0,21,0,35,78,303,927
JHARKHAND,LATEHAR,2010,43,32,0,75,16,0,16,32,25,14,11,50,11,0,12,17,70,17,53,180,27,3,15,0,9,35,134,3,0,0,8,0,11,45,84,455
JHARKHAND,LOHARDAGGA,2010,35,0,1,36,39,0,39,78,24,0,24,48,6,0,13,19,46,4,42,130,19,20,30,0,4,63,179,0,0,0,25,0,25,43,126,513
JHARKHAND,PAKUR,2010,32,4,6,42,45,0,45,90,17,15,2,34,2,1,8,15,79,4,75,184,77,8,8,0,6,34,171,1,11,0,31,0,43,38,308,731
JHARKHAND,PALAMU,2010,89,151,0,240,27,0,27,54,63,15,48,126,25,0,49,68,173,42,131,488,193,37,62,0,29,290,692,23,21,0,22,0,66,81,698,2101
JHARKHAND,RAMGARH,2010,40,10,3,53,13,0,13,26,23,16,7,46,9,0,15,27,105,69,36,261,54,19,43,1,5,138,354,5,10,2,39,1,57,94,276,932
JHARKHAND,RANCHI,2010,183,55,8,246,92,0,92,184,128,113,15,256,34,1,160,174,1683,884,799,3735,198,65,168,4,10,490,1425,22,14,3,53,2,94,490,1825,5862
JHARKHAND,SAHEBGANJ,2010,71,51,3,125,51,0,51,102,33,29,4,66,4,1,11,24,102,17,85,244,57,18,25,1,1,127,245,4,12,0,25,0,41,16,270,907
JHARKHAND,SARAIKELA,2010,65,49,4,118,32,0,32,64,16,12,4,32,15,0,24,45,198,90,108,480,13,12,51,0,2,0,169,6,8,0,17,0,31,91,238,886
JHARKHAND,SIMDEGA,2010,88,15,0,103,18,0,18,36,14,5,9,28,11,0,17,12,37,11,26,114,4,6,3,0,6,45,97,0,3,0,2,0,5,33,54,368
KARNATAKA,BAGALKOT,2010,51,28,0,79,9,0,9,18,11,6,5,22,0,0,24,92,149,71,78,414,164,8,46,1,4,244,467,5,67,0,59,0,131,0,1227,2189
KARNATAKA,BANGALORE COMMR.,2010,266,445,5,716,65,0,65,130,513,29,484,1026,66,246,641,1335,10568,6407,4161,23424,349,139,3073,72,7,3153,6897,52,308,50,398,0,808,104,10333,32188
KARNATAKA,BANGALORE RURAL,2010,100,50,1,151,16,0,16,32,30,18,12,60,15,2,81,261,686,388,298,1731,240,16,83,0,0,510,849,8,48,0,55,0,111,0,2410,4612
KARNATAKA,BELGAUM,2010,124,106,2,232,42,0,42,84,62,44,18,124,14,2,61,239,567,320,247,1450,572,26,243,9,12,1053,1954,10,222,8,273,0,513,39,3777,7463
KARNATAKA,BELLARY,2010,58,40,0,98,12,0,12,24,20,15,5,40,8,1,28,150,270,179,91,727,228,9,77,5,16,440,791,13,80,0,99,0,192,16,1844,3414
KARNATAKA,BIDAR,2010,41,39,1,81,8,0,8,16,26,19,7,52,5,0,17,114,149,54,95,434,165,16,48,2,15,882,1136,6,26,1,88,0,121,8,1942,3599
KARNATAKA,BIJAPUR,2010,59,49,1,109,13,0,13,26,43,27,16,86,4,2,23,126,135,71,64,425,294,16,100,2,3,551,966,5,58,0,160,0,223,0,1615,3259
KARNATAKA,CBPURA,2010,39,41,11,91,9,0,9,18,30,18,12,60,3,1,29,109,257,98,159,656,248,14,56,1,0,355,674,5,34,0,41,0,80,0,1050,2333
KARNATAKA,CHAMARAJNAGAR,2010,31,18,0,49,12,0,12,24,6,5,1,12,1,0,7,72,134,46,88,348,124,2,19,1,0,488,634,3,53,0,52,0,108,0,914,1937
KARNATAKA,CHICKMAGALUR,2010,26,32,2,60,19,0,19,38,28,21,7,56,7,1,26,122,179,70,109,514,152,6,46,5,6,846,1065,11,63,3,90,0,167,4,1491,3165
KARNATAKA,CHITRADURGA,2010,40,34,3,77,26,0,26,52,39,38,1,78,4,0,40,101,275,123,152,695,388,7,63,4,17,951,1430,7,158,0,99,0,264,0,2496,4752
KARNATAKA,DAKSHIN KANNADA,2010,43,47,1,91,16,0,16,32,16,9,7,32,8,0,40,218,391,184,207,1048,194,9,151,19,15,412,817,1,67,2,62,0,132,17,2467,4196
KARNATAKA,DAVANAGERE,2010,29,25,6,60,16,0,16,32,20,20,0,40,5,0,27,127,270,140,130,699,270,13,59,3,0,393,738,9,91,1,120,0,221,0,1575,3059
KARNATAKA,DHARWAD COMMR.,2010,17,16,0,33,1,0,1,2,20,13,7,40,4,1,62,128,348,199,149,891,86,15,154,3,9,159,431,0,16,3,45,0,64,5,1129,2221
KARNATAKA,DHARWAD RURAL,2010,28,33,1,62,8,0,8,16,14,11,3,28,0,0,11,40,56,11,45,163,128,6,13,0,3,207,357,0,44,0,23,0,67,0,872,1487
KARNATAKA,GADAG,2010,27,11,0,38,6,0,6,12,8,0,8,16,1,1,6,46,62,24,38,178,96,3,19,0,1,140,386,1,35,0,53,0,89,127,464,1107
KARNATAKA,GULBARGA,2010,89,103,3,195,34,0,34,68,75,56,19,150,26,17,87,216,349,159,190,1044,456,19,81,2,31,927,1536,6,56,0,152,0,214,20,2050,4799
KARNATAKA,HASSAN,2010,61,83,4,148,23,0,23,46,34,25,9,68,13,1,81,267,374,183,191,1110,322,10,123,3,0,1432,1890,14,134,0,180,0,328,0,3045,6204
KARNATAKA,HAVERI,2010,28,23,4,55,6,0,6,12,23,0,23,46,3,0,10,64,126,57,69,329,220,10,46,0,0,303,579,2,65,0,65,0,132,0,1247,2245
KARNATAKA,K.G.F.,2010,16,12,0,28,7,0,7,14,16,14,2,32,0,1,10,57,88,37,51,244,55,0,17,1,0,283,407,8,20,0,26,0,54,51,323,991
KARNATAKA,KODAGU,2010,37,30,0,67,20,0,20,40,15,7,8,30,3,0,20,116,113,27,86,365,44,4,31,1,3,769,857,1,57,0,61,0,119,5,869,2199
KARNATAKA,KOLAR,2010,40,54,2,96,12,0,12,24,18,5,13,36,2,2,18,73,212,129,83,519,196,17,20,1,0,261,495,4,29,0,12,0,45,0,939,1912
KARNATAKA,KOPPAL,2010,28,27,14,69,10,0,10,20,21,0,21,42,6,0,9,92,117,60,57,341,153,6,37,0,0,193,389,2,29,0,46,0,77,0,1161,1951
KARNATAKA,MANDYA,2010,83,62,1,146,30,0,30,60,47,35,12,94,9,2,56,303,564,256,308,1498,384,16,111,3,44,1407,1965,10,117,0,185,0,312,0,3192,6626
KARNATAKA,MYSORE COMMR.,2010,30,51,0,81,7,0,7,14,24,18,6,48,6,6,199,203,855,564,291,2124,95,10,276,9,0,238,628,4,22,0,59,0,85,0,1313,3407
KARNATAKA,MYSORE RURAL,2010,80,72,0,152,43,0,43,86,37,25,12,74,8,1,34,294,338,117,221,1013,303,12,47,1,0,1029,1392,13,93,0,161,0,267,0,1898,4464
KARNATAKA,RAICHUR,2010,49,47,3,99,31,0,31,62,38,32,6,76,1,0,12,80,149,65,84,391,291,10,107,0,3,597,1024,3,105,0,195,0,303,16,1612,3349
KARNATAKA,RAILWAYS,2010,14,0,0,14,1,0,1,2,2,0,2,4,0,3,29,2,436,10,426,906,5,0,6,5,0,18,49,1,0,0,0,0,1,15,43,580
KARNATAKA,RAMANAGAR,2010,89,72,0,161,14,0,14,28,38,24,14,76,10,4,70,244,512,233,279,1352,275,8,57,11,28,531,910,22,53,0,76,0,151,0,2326,4440
KARNATAKA,SHIMOGA,2010,34,58,2,94,17,0,17,34,31,24,7,62,15,1,44,231,403,232,171,1097,495,6,144,2,21,1268,1946,4,113,8,277,0,402,10,2655,5839
KARNATAKA,TUMKUR,2010,88,57,4,149,25,0,25,50,29,14,15,58,15,3,87,255,652,217,435,1664,278,11,85,5,34,773,1202,14,107,0,78,0,199,16,2485,5101
KARNATAKA,UDUPI,2010,15,17,1,33,12,0,12,24,7,3,4,14,5,2,40,139,142,51,91,470,134,5,54,16,2,315,539,1,31,1,38,0,71,13,1709,2699
KARNATAKA,UTTAR KANNADA,2010,22,17,22,61,11,0,11,22,13,11,2,26,2,0,17,84,100,33,67,303,104,15,27,2,7,366,521,0,78,3,66,0,147,0,2037,2993
KARNATAKA,YADGIRI,2010,23,51,0,74,5,0,5,10,20,0,20,40,3,0,3,59,67,25,42,199,202,0,24,3,5,341,580,3,65,3,47,0,118,5,613,1542
KERALA,ALAPUZHA,2010,27,27,10,64,40,0,40,80,21,20,1,42,6,0,43,171,287,116,171,794,443,15,228,0,18,1234,1940,0,176,45,259,0,480,2,4790,7842
KERALA,ERNAKULAM COMMR.,2010,4,11,3,18,20,0,20,40,8,5,3,16,2,15,34,79,233,99,134,596,244,15,313,2,2,282,861,2,67,23,146,0,238,3,24227,25735
KERALA,ERNAKULAM RURAL,2010,25,17,11,53,42,0,42,84,14,11,3,28,3,2,56,130,301,73,228,793,323,10,168,5,13,886,1405,1,146,44,203,0,394,0,9825,12225
KERALA,IDUKKI,2010,15,37,2,54,33,0,33,66,7,4,3,14,1,0,11,111,145,27,118,413,307,12,173,5,11,1319,1827,0,177,13,208,0,398,0,6033,8620
KERALA,KANNUR,2010,26,19,6,51,23,0,23,46,11,6,5,22,12,2,61,148,156,63,93,535,935,20,117,1,58,1237,2372,0,131,9,300,0,440,4,2574,5850
KERALA,KASARGOD,2010,8,9,1,18,23,0,23,46,9,1,8,18,1,1,22,106,108,50,58,346,428,30,118,0,34,807,1421,1,93,28,194,0,316,4,1213,3238
KERALA,KOLLAM,2010,40,30,8,78,55,0,55,110,36,32,4,72,6,26,37,271,400,127,273,1140,894,25,207,2,23,2142,3297,4,364,10,581,0,959,4,6714,11879
KERALA,KOTTAYAM,2010,17,23,8,48,46,0,46,92,11,7,4,22,2,5,32,165,246,65,181,696,423,27,306,1,10,1708,2475,0,236,66,257,0,559,0,4562,8151
KERALA,KOZHIKODE COMMR.,2010,7,3,0,10,16,0,16,32,11,7,4,22,2,22,73,175,363,183,180,998,265,32,130,3,16,500,946,1,70,70,164,0,305,0,2015,3938
KERALA,KOZHIKODE RURAL,2010,16,31,1,48,35,0,35,70,17,14,3,34,9,6,16,141,119,48,71,410,838,8,147,1,64,1096,2157,1,146,12,321,0,480,3,4330,7358
KERALA,MALAPPURAM,2010,14,34,5,53,49,0,49,98,21,13,8,42,8,12,41,217,306,137,169,890,705,24,286,11,14,855,1901,0,156,29,658,0,843,6,5745,9196
KERALA,PALAKKAD,2010,42,24,4,70,49,0,49,98,11,9,2,22,2,2,13,177,186,57,129,566,523,41,205,9,24,1138,1943,4,96,11,352,0,463,3,7533,10449
KERALA,PATHANAMTHITTA,2010,19,13,0,32,29,0,29,58,11,10,1,22,1,8,24,101,180,50,130,494,328,12,105,0,10,905,1360,2,132,51,124,0,309,0,2916,4971
KERALA,RAILWAYS,2010,1,0,0,1,0,0,0,0,1,0,1,2,0,15,9,2,223,0,223,472,6,0,1,0,0,41,48,0,12,4,0,0,16,0,18,333
KERALA,THRISSUR,2010,30,37,13,80,49,0,49,98,16,9,7,32,6,27,43,145,296,104,192,813,791,13,298,1,34,931,2077,1,205,39,400,0,645,9,8036,11420
KERALA,TRIVANDRUM COMMR.,2010,15,16,3,34,27,0,27,54,22,14,8,44,4,41,76,221,424,159,265,1190,477,28,409,8,9,829,1762,3,194,41,135,0,373,2,2668,5652
KERALA,TRIVANDRUM RURAL,2010,42,26,11,79,68,0,68,136,31,21,10,62,8,35,42,246,342,115,227,1015,610,26,280,5,27,1923,2874,1,476,28,367,0,872,3,4099,8696
KERALA,WAYANADU,2010,15,4,0,19,30,0,30,60,3,1,2,6,1,2,3,76,65,13,52,212,184,5,90,0,7,699,989,1,59,14,128,0,202,4,1370,2760
MADHYA PRADESH,ALIRAJPUR,2010,54,56,0,110,27,0,27,54,7,7,0,14,1,0,8,33,69,32,37,180,16,0,2,0,11,285,390,1,23,0,10,0,34,76,651,1330
MADHYA PRADESH,ANUPPUR,2010,36,7,0,43,35,0,35,70,6,5,1,12,1,0,14,76,92,47,45,275,26,1,19,0,2,255,321,12,74,4,54,0,144,18,633,1365
MADHYA PRADESH,ASHOK NAGAR,2010,29,29,4,62,45,0,45,90,9,9,0,18,2,0,15,99,110,43,67,336,25,4,23,1,2,942,1070,8,103,10,59,0,180,73,1057,2649
MADHYA PRADESH,BALAGHAT,2010,39,17,3,59,52,0,52,104,7,6,1,14,2,0,18,99,88,33,55,295,51,7,26,0,15,384,582,4,97,14,40,0,155,99,1575,2637
MADHYA PRADESH,BARWANI,2010,51,21,3,75,32,0,32,64,4,4,0,8,2,0,7,55,161,57,104,386,19,2,15,0,7,258,448,6,56,8,6,0,76,147,1053,1913
MADHYA PRADESH,BETUL,2010,58,27,0,85,144,0,144,288,25,22,3,50,0,0,16,108,189,75,114,502,3,0,14,0,11,346,526,24,152,9,42,0,227,152,1857,3177
MADHYA PRADESH,BHIND,2010,78,78,4,160,30,0,30,60,11,8,3,22,1,8,54,94,178,99,79,513,58,7,20,0,6,1172,1408,40,60,2,42,0,144,145,1123,3211
MADHYA PRADESH,BHOPAL,2010,71,73,5,149,106,0,106,212,66,59,7,132,8,2,207,883,2488,1578,910,6076,104,9,186,3,14,1495,2102,31,28,186,205,1,451,291,7249,13711
MADHYA PRADESH,BHOPAL RLY.,2010,1,2,0,3,2,0,2,4,1,1,0,2,3,0,8,4,883,16,867,1781,6,0,3,1,0,3,14,4,10,3,0,0,17,1,203,1138
MADHYA PRADESH,BURHANPUR,2010,16,5,0,21,22,0,22,44,2,2,0,4,0,0,6,40,106,37,69,258,27,4,13,0,3,67,169,11,57,11,18,0,97,55,800,1263
MADHYA PRADESH,CHHATARPUR,2010,69,71,4,144,55,0,55,110,26,24,2,52,1,4,64,310,243,127,116,865,83,6,37,1,19,705,980,24,184,11,55,0,274,129,2591,4692
MADHYA PRADESH,CHHINDWARA,2010,86,27,3,116,102,0,102,204,17,14,3,34,1,2,22,191,279,111,168,774,81,9,51,0,10,1331,1701,8,235,38,105,0,386,219,2373,5190
MADHYA PRADESH,DAMOH,2010,49,65,0,114,41,0,41,82,22,19,3,44,2,1,30,153,156,80,76,498,23,4,28,1,11,1382,1529,25,203,0,84,0,312,80,1039,3399
MADHYA PRADESH,DATIYA,2010,61,59,0,120,27,0,27,54,11,10,1,22,1,4,52,92,126,41,85,401,36,5,16,0,12,377,541,8,75,0,27,0,110,95,1446,2530
MADHYA PRADESH,DEWAS,2010,47,67,0,114,89,0,89,178,28,26,2,56,1,3,35,176,678,310,368,1571,68,11,40,0,31,434,784,10,192,41,131,0,374,200,3410,5692
MADHYA PRADESH,DHAR,2010,71,66,2,139,89,0,89,178,42,41,1,84,6,2,34,191,473,222,251,1179,93,34,20,0,33,543,1065,54,176,22,82,0,334,342,3362,5737
MADHYA PRADESH,DINDORI,2010,20,2,3,25,31,0,31,62,2,1,1,4,0,0,4,27,30,8,22,91,8,3,17,0,2,143,223,4,89,5,17,0,115,50,537,994
MADHYA PRADESH,GUNA,2010,37,34,0,71,56,0,56,112,12,11,1,24,4,4,33,136,217,115,102,611,84,3,23,1,15,1051,1337,13,150,9,47,1,220,160,1369,3459
MADHYA PRADESH,GWALIOR,2010,99,176,26,301,71,0,71,142,102,82,20,204,10,7,190,1105,2044,1466,578,5400,173,35,156,1,23,1195,1848,52,180,18,248,0,498,265,5161,11337
MADHYA PRADESH,HARDA,2010,25,17,0,42,40,0,40,80,9,9,0,18,0,0,3,84,113,62,51,313,17,0,13,0,4,596,662,3,54,5,17,0,79,32,330,1362
MADHYA PRADESH,HOSHANGABAD,2010,52,39,3,94,73,0,73,146,38,35,3,76,4,0,46,216,368,199,169,1002,49,9,50,0,16,524,648,20,140,48,111,0,319,0,2478,4284
MADHYA PRADESH,INDORE,2010,108,149,4,261,104,0,104,208,56,45,11,112,6,14,238,836,3843,2843,1000,8780,108,51,174,16,41,3468,4284,38,338,67,352,2,797,426,8034,18473
MADHYA PRADESH,INDORE RLY.,2010,1,1,1,3,0,0,0,0,1,1,0,2,0,0,5,3,164,0,164,336,1,0,1,0,0,2,4,0,2,1,0,0,3,0,92,275
MADHYA PRADESH,JABALPUR,2010,81,95,0,176,130,0,130,260,34,32,2,68,2,10,73,349,766,513,253,1966,83,5,89,0,8,1432,1810,56,189,60,185,1,491,193,6132,9973
MADHYA PRADESH,JABALPUR RLY.,2010,0,2,0,2,5,0,5,10,1,1,0,2,0,1,4,4,395,7,388,799,2,1,0,0,0,6,9,0,1,1,0,0,2,0,73,496
MADHYA PRADESH,JHABUA,2010,26,26,0,52,35,0,35,70,14,12,2,28,1,3,25,74,124,83,41,351,22,7,2,0,20,823,961,1,45,0,5,0,51,87,599,1939
MADHYA PRADESH,KATNI,2010,37,34,4,75,69,0,69,138,16,10,6,32,0,0,14,148,170,98,72,502,26,0,39,0,11,1023,1228,13,144,18,77,0,252,129,1248,3220
MADHYA PRADESH,KHANDWA,2010,38,33,1,72,46,0,46,92,15,13,2,30,0,2,11,186,213,92,121,625,38,3,14,0,15,60,233,9,154,21,39,0,223,103,2110,3111
MADHYA PRADESH,KHARGON,2010,49,40,5,94,71,0,71,142,14,14,0,28,0,1,11,133,389,100,289,923,31,3,21,0,7,272,488,31,162,28,35,0,256,154,2664,4121
MADHYA PRADESH,MANDLA,2010,33,13,5,51,56,0,56,112,7,7,0,14,0,0,3,70,39,6,33,151,17,3,21,0,8,317,468,5,68,6,17,0,96,102,1034,1824
MADHYA PRADESH,MANDSAUR,2010,25,31,0,56,58,0,58,116,24,19,5,48,3,0,32,113,275,132,143,698,32,28,30,1,11,129,369,4,108,14,59,0,185,138,2088,3203
MADHYA PRADESH,MORENA,2010,57,94,2,153,40,0,40,80,20,17,3,40,9,12,27,140,344,209,135,876,128,2,31,0,7,1879,2275,32,80,0,75,0,187,228,1705,4912
MADHYA PRADESH,NARSINGHPUR,2010,45,36,6,87,65,0,65,130,6,5,1,12,1,1,18,117,140,67,73,417,60,4,16,1,14,1328,1542,21,135,12,63,0,231,119,927,3135
MADHYA PRADESH,NEEMUCH,2010,20,18,0,38,12,0,12,24,14,11,3,28,0,0,22,153,206,99,107,587,47,56,22,1,11,326,543,3,48,7,47,0,105,80,953,2046
MADHYA PRADESH,PANNA,2010,25,21,3,49,47,0,47,94,11,5,6,22,2,2,27,142,115,23,92,403,3,4,34,0,6,316,429,16,87,0,47,0,150,66,1103,2077
MADHYA PRADESH,RAISEN,2010,54,44,0,98,86,0,86,172,34,32,2,68,2,1,15,97,260,102,158,635,56,1,4,0,5,1839,2065,16,210,0,65,0,291,160,1512,4461
MADHYA PRADESH,RAJGARH,2010,36,28,2,66,73,0,73,146,34,27,7,68,2,0,37,146,277,130,147,739,68,8,19,0,51,398,725,14,179,27,30,0,250,181,2820,4430
MADHYA PRADESH,RATLAM,2010,53,49,1,103,88,0,88,176,24,23,1,48,1,2,30,121,345,132,213,844,64,39,51,0,26,1182,1560,16,145,32,94,0,287,198,1684,4245
MADHYA PRADESH,REWA,2010,51,44,0,95,81,0,81,162,45,43,2,90,3,2,50,347,452,200,252,1306,56,21,38,1,27,763,1102,37,140,1,124,0,302,196,3083,5562
MADHYA PRADESH,SAGAR,2010,90,123,1,214,120,0,120,240,67,63,4,134,2,4,54,382,533,279,254,1508,108,14,43,2,28,2721,3138,35,385,16,133,0,569,222,3435,8518
MADHYA PRADESH,SATNA,2010,73,49,4,126,89,0,89,178,27,20,7,54,4,2,45,321,420,244,176,1212,42,16,27,0,17,984,1413,26,199,18,119,0,362,327,2564,5373
MADHYA PRADESH,SEONI,2010,39,20,4,63,71,0,71,142,21,16,5,42,1,0,14,135,147,56,91,444,37,8,51,0,5,311,546,18,92,23,38,0,171,134,1737,2906
MADHYA PRADESH,SHAHDOL,2010,34,17,0,51,61,0,61,122,16,16,0,32,1,0,21,173,161,63,98,517,20,7,24,0,12,235,298,12,123,6,63,0,204,0,1951,2937
MADHYA PRADESH,SHAJAPUR,2010,38,34,1,73,56,0,56,112,19,16,3,38,7,0,27,153,390,145,245,967,46,18,11,0,18,983,1215,11,117,19,33,0,180,139,1105,3225
MADHYA PRADESH,SHEOPUR,2010,17,13,0,30,11,0,11,22,10,4,6,20,2,0,7,40,49,10,39,147,56,0,9,0,2,319,416,3,35,0,23,0,61,30,588,1214
MADHYA PRADESH,SHIVPURI,2010,56,30,8,94,73,0,73,146,28,22,6,56,8,8,39,114,215,94,121,599,69,3,23,0,20,1180,1482,7,131,9,32,0,179,187,2117,4357
MADHYA PRADESH,SIDHI,2010,32,20,0,52,44,0,44,88,29,28,1,58,0,0,18,170,133,27,106,454,19,5,15,0,20,337,476,26,104,3,36,0,169,80,1512,2603
MADHYA PRADESH,SIHORE,2010,45,48,1,94,70,0,70,140,32,26,6,64,1,2,16,129,282,126,156,712,40,6,38,1,23,380,670,10,135,15,89,0,249,182,2441,3986
MADHYA PRADESH,SINGRAULI,2010,32,20,4,56,46,0,46,92,24,24,0,48,0,0,12,120,148,50,98,428,25,4,12,0,6,323,504,15,119,2,85,0,221,134,1025,2156
MADHYA PRADESH,TIKAMGARH,2010,34,25,2,61,78,0,78,156,19,16,3,38,1,5,25,131,172,59,113,506,45,3,27,0,12,937,1142,15,143,4,59,0,221,118,1863,3718
MADHYA PRADESH,UJJAIN,2010,77,120,1,198,77,0,77,154,54,48,6,108,1,0,92,409,967,449,518,2436,129,22,61,1,33,574,980,20,179,42,193,0,434,160,5496,8708
MADHYA PRADESH,UMARIYA,2010,14,4,0,18,23,0,23,46,2,1,1,4,0,0,8,47,40,13,27,135,13,0,11,0,9,81,114,3,72,0,25,0,100,0,886,1238
MADHYA PRADESH,VIDISHA,2010,54,58,3,115,81,0,81,162,22,18,4,44,0,1,33,222,312,144,168,880,65,12,49,0,28,777,1067,17,239,22,114,0,392,136,2512,4757
MAHARASHTRA,AHMEDNAGAR,2010,122,75,1,198,57,0,57,114,58,45,13,116,58,8,155,579,1517,536,981,3834,570,47,254,9,46,718,2347,10,115,1,604,0,730,703,1508,7215
MAHARASHTRA,AKOLA,2010,46,66,3,115,25,0,25,50,25,23,2,50,11,2,83,283,1053,183,870,2485,172,25,113,5,45,815,1326,12,100,55,149,0,316,151,1233,4472
MAHARASHTRA,AMRAVATI COMMR.,2010,11,30,4,45,20,0,20,40,31,28,3,62,3,8,54,232,988,238,750,2273,55,31,63,6,16,456,695,3,52,12,96,0,163,68,840,3079
MAHARASHTRA,AMRAVATI RURAL,2010,64,37,1,102,40,0,40,80,31,29,2,62,10,2,25,248,850,110,740,1985,118,15,55,2,68,1046,1513,2,179,38,135,0,354,209,1399,4574
MAHARASHTRA,AURANGABAD COMMR.,2010,38,86,1,125,23,0,23,46,40,30,10,80,22,3,122,347,1012,474,538,2518,138,26,207,1,15,467,1016,10,52,39,157,0,258,162,985,3953
MAHARASHTRA,AURANGABAD RURAL,2010,49,33,4,86,16,0,16,32,16,12,4,32,17,4,30,225,532,166,366,1340,240,13,81,1,30,607,1280,21,56,14,303,0,394,308,623,3223
MAHARASHTRA,BEED,2010,86,74,6,166,28,0,28,56,44,29,15,88,37,5,71,298,523,181,342,1457,297,19,95,4,39,879,1623,11,87,11,360,0,469,290,785,4049
MAHARASHTRA,BHANDARA,2010,24,7,4,35,24,0,24,48,15,13,2,30,0,1,17,208,448,88,360,1122,49,20,28,9,18,309,584,3,42,12,61,0,118,151,792,2242
MAHARASHTRA,BULDHANA,2010,59,48,4,111,29,0,29,58,21,18,3,42,8,3,36,174,642,183,459,1505,255,26,77,8,70,751,1477,34,131,40,185,0,390,290,1081,3972
MAHARASHTRA,CHANDRAPUR,2010,56,29,3,88,43,0,43,86,21,16,5,42,3,2,24,264,661,141,520,1615,104,22,76,3,45,639,1169,7,117,116,147,0,387,280,1344,4006
MAHARASHTRA,DHULE,2010,48,54,1,103,18,0,18,36,12,12,0,24,24,2,42,197,398,138,260,1061,198,25,77,3,16,400,1033,6,28,9,234,0,277,314,868,2974
MAHARASHTRA,GADCHIROLI,2010,58,30,1,89,16,0,16,32,11,9,2,22,6,1,11,93,124,34,90,359,21,5,14,0,46,202,385,0,28,0,20,0,48,97,298,1082
MAHARASHTRA,GONDIA,2010,29,15,4,48,28,0,28,56,18,15,3,36,3,0,20,191,323,76,247,860,48,16,35,5,22,361,615,3,80,27,41,0,151,128,585,1982
MAHARASHTRA,HINGOLI,2010,38,36,0,74,14,0,14,28,6,4,2,12,9,1,40,93,180,58,122,503,142,3,60,3,30,417,751,1,33,7,115,0,156,96,541,1865
MAHARASHTRA,JALGAON,2010,94,71,4,169,49,0,49,98,41,32,9,82,41,0,62,281,879,238,641,2142,320,101,198,17,40,838,1971,11,143,41,425,0,620,457,1295,5408
MAHARASHTRA,JALNA,2010,51,43,3,97,11,0,11,22,13,11,2,26,16,3,71,213,419,140,279,1141,219,9,103,1,20,582,1091,40,81,10,315,0,446,157,580,2960
MAHARASHTRA,KOLHAPUR,2010,52,30,1,83,27,0,27,54,22,13,9,44,13,2,45,229,700,334,366,1689,218,67,267,5,16,462,1418,18,71,12,96,0,197,383,991,3727
MAHARASHTRA,LATUR,2010,65,41,0,106,28,0,28,56,31,31,0,62,20,4,57,226,444,187,257,1195,242,14,87,6,33,703,1317,3,85,3,229,0,320,232,960,3513
MAHARASHTRA,MUMBAI COMMR.,2010,228,170,7,405,194,0,194,388,194,146,48,388,35,42,410,3059,13195,4167,9028,29936,391,482,2211,76,22,4487,8359,21,475,138,312,0,946,690,7093,33932
MAHARASHTRA,MUMBAI RLY.,2010,6,7,2,15,2,0,2,4,4,3,1,8,4,0,55,2,2037,1,2036,4135,8,7,42,1,0,46,110,0,15,9,0,0,24,6,69,2322
MAHARASHTRA,NAGPUR COMMR.,2010,88,69,5,162,58,0,58,116,57,34,23,114,13,13,259,599,1732,852,880,4348,183,72,264,24,20,842,1737,8,87,48,175,0,318,332,2780,7728
MAHARASHTRA,NAGPUR RLY.,2010,10,3,0,13,1,0,1,2,3,2,1,6,7,2,43,2,942,19,923,1938,10,6,3,5,1,25,51,0,8,2,0,0,10,1,61,1135
MAHARASHTRA,NAGPUR RURAL,2010,86,29,3,118,39,0,39,78,30,26,4,60,11,4,57,236,734,187,547,1776,94,11,41,1,50,596,1257,8,78,19,56,0,161,464,1275,3922
MAHARASHTRA,NANDED,2010,82,67,3,152,36,0,36,72,52,43,9,104,25,2,99,416,516,168,348,1574,309,22,178,5,50,1181,2021,68,85,5,315,0,473,276,1520,5312
MAHARASHTRA,NANDURBAR,2010,43,14,3,60,20,0,20,40,14,12,2,28,12,0,7,82,161,57,104,423,123,7,41,5,9,283,614,2,32,12,88,0,134,146,438,1542
MAHARASHTRA,NASIK COMMR.,2010,37,32,1,70,30,0,30,60,27,19,8,54,24,13,117,528,1882,963,919,4446,146,52,187,23,17,268,910,2,46,18,124,0,190,217,693,4484
MAHARASHTRA,NASIK RURAL,2010,91,49,3,143,53,0,53,106,28,19,9,56,41,9,45,226,697,240,457,1715,368,70,126,8,14,729,1992,6,79,27,344,0,456,677,1321,5011
MAHARASHTRA,NAVI MUMBAI,2010,57,27,3,87,27,0,27,54,23,11,12,46,9,13,136,700,2040,1004,1036,4938,135,72,452,5,6,462,1564,3,36,38,89,0,166,432,1108,5873
MAHARASHTRA,OSMANABAD,2010,44,31,1,76,28,0,28,56,29,23,6,58,20,2,33,167,348,92,256,918,167,31,176,0,25,535,1197,2,74,11,161,0,248,263,683,2831
MAHARASHTRA,PARBHANI,2010,41,49,4,94,20,0,20,40,36,21,15,72,11,4,60,318,416,139,277,1225,183,15,84,1,34,1068,1523,5,54,6,209,0,274,138,287,3043
MAHARASHTRA,PUNE COMMR.,2010,129,94,6,229,91,0,91,182,129,94,35,258,30,31,452,1250,4674,2948,1726,11111,393,72,663,37,17,1169,2971,4,78,91,214,0,387,620,3358,13602
MAHARASHTRA,PUNE RLY.,2010,0,1,0,1,0,0,0,0,2,1,1,4,7,2,7,0,375,2,373,766,2,3,3,0,0,6,14,0,1,0,0,0,1,0,30,439
MAHARASHTRA,PUNE RURAL,2010,141,81,15,237,72,0,72,144,48,33,15,96,42,30,145,642,1615,790,825,4089,437,111,255,14,29,836,2778,15,136,30,200,0,381,1096,1751,7741
MAHARASHTRA,RAIGAD,2010,44,22,5,71,15,0,15,30,11,7,4,22,11,6,17,127,284,78,206,729,86,21,113,6,11,222,810,0,39,10,49,0,98,351,556,2006
MAHARASHTRA,RATNAGIRI,2010,23,10,1,34,28,0,28,56,9,7,2,18,5,0,16,148,227,35,192,623,123,26,74,4,13,171,580,0,37,12,33,0,82,169,475,1604
MAHARASHTRA,SANGLI,2010,61,33,5,99,49,0,49,98,26,10,16,52,8,1,35,239,484,180,304,1251,155,20,196,5,29,449,1174,18,67,10,84,0,179,320,628,2922
MAHARASHTRA,SATARA,2010,43,59,2,104,27,0,27,54,42,29,13,84,28,3,76,412,869,330,539,2257,247,102,177,6,21,472,1534,0,82,19,170,0,271,509,983,4349
MAHARASHTRA,SINDHUDURG,2010,14,7,1,22,9,0,9,18,5,4,1,10,0,0,6,95,138,25,113,377,39,13,47,3,14,118,314,0,10,12,11,0,33,80,193,815
MAHARASHTRA,SOLAPUR COMMR.,2010,20,16,4,40,12,0,12,24,14,10,4,28,11,1,47,143,377,194,183,956,65,16,78,4,4,155,428,2,22,2,78,0,104,106,446,1623
MAHARASHTRA,SOLAPUR RURAL,2010,75,40,6,121,63,0,63,126,37,34,3,74,38,9,79,370,658,245,413,1812,330,15,164,6,44,741,1815,5,97,35,205,0,342,515,1219,4751
MAHARASHTRA,THANE COMMR.,2010,107,72,3,182,93,0,93,186,93,61,32,186,32,20,172,1080,3173,1493,1680,7650,285,133,794,34,22,1322,2933,9,152,32,365,0,558,343,1607,9943
MAHARASHTRA,THANE RURAL,2010,135,46,12,193,47,0,47,94,44,20,24,88,34,24,231,757,1242,560,682,3530,373,40,299,11,29,817,2252,6,95,42,120,0,263,683,1126,6213
MAHARASHTRA,WARDHA,2010,41,29,5,75,44,0,44,88,26,22,4,52,9,0,46,237,781,119,662,1854,115,19,43,8,62,744,1196,2,119,57,93,0,271,205,1197,3882
MAHARASHTRA,WASHIM,2010,40,21,2,63,12,0,12,24,17,14,3,34,6,2,28,121,377,102,275,911,100,9,33,4,31,385,682,5,56,10,102,0,173,120,589,2070
MAHARASHTRA,YAVATMAL,2010,68,43,5,116,33,0,33,66,52,49,3,104,4,1,78,280,898,181,717,2159,139,17,50,5,40,915,1439,7,121,38,165,0,331,273,1545,4777
MANIPUR,BISHNUPUR,2010,14,28,0,42,6,0,6,12,20,12,8,40,0,12,1,9,28,8,20,78,6,1,9,0,10,39,65,0,7,0,4,0,11,0,126,320
MANIPUR,CHANDEL,2010,3,5,0,8,0,0,0,0,1,0,1,2,0,15,0,1,1,1,0,18,1,0,0,0,10,4,15,0,0,0,0,0,0,0,18,59
MANIPUR,CHURACHANDPUR,2010,12,3,0,15,1,0,1,2,4,0,4,8,0,8,0,3,12,6,6,35,5,0,2,0,2,3,12,0,0,0,0,0,0,0,35,90
MANIPUR,CID,2010,0,0,0,0,0,0,0,0,0,0,0,0,0,0,0,0,0,0,0,0,0,0,2,0,0,0,2,0,0,0,0,0,0,0,0,2
MANIPUR,IMPHAL EAST,2010,19,51,0,70,6,0,6,12,43,23,20,86,0,67,0,8,64,36,28,203,8,2,6,2,10,46,74,0,4,0,3,0,7,0,137,476
MANIPUR,IMPHAL WEST,2010,18,114,0,132,10,0,10,20,71,45,26,142,0,42,0,28,232,178,54,534,25,11,30,3,7,71,148,0,12,0,3,0,15,1,389,1067
MANIPUR,SENAPATI,2010,5,8,0,13,1,0,1,2,22,2,20,44,0,23,0,4,28,5,23,83,6,2,2,0,17,2,29,0,0,0,0,0,0,0,57,177
MANIPUR,TAMENGLONG,2010,0,1,0,1,0,0,0,0,1,0,1,2,0,6,0,0,6,0,6,18,3,0,0,0,9,2,14,0,0,0,0,0,0,0,19,47
MANIPUR,THOUBAL,2010,18,43,1,62,9,0,9,18,37,25,12,74,0,13,0,13,43,20,23,112,10,8,8,2,4,57,89,0,8,0,8,0,16,0,132,414
MANIPUR,UKHRUL,2010,3,5,0,8,1,0,1,2,0,0,0,0,0,10,1,0,3,0,3,17,1,0,0,0,17,3,21,0,0,0,0,0,0,0,19,63
MEGHALAYA,GARO HILLS EAST,2010,11,8,0,19,5,0,5,10,5,3,2,10,13,1,6,14,33,9,24,100,0,1,1,0,8,4,14,0,3,0,0,0,3,0,38,151
MEGHALAYA,GARO HILLS SOUTH,2010,8,3,0,11,4,0,4,8,5,3,2,10,2,0,1,4,8,0,8,23,0,0,1,0,2,3,6,0,0,0,1,0,1,0,17,59
MEGHALAYA,GARO HILLS WEST,2010,20,11,2,33,15,0,15,30,24,20,4,48,5,0,6,25,186,53,133,408,6,4,25,2,4,34,81,0,18,0,5,0,23,6,158,556
MEGHALAYA,JAINTIA HILLS,2010,48,5,0,53,33,0,33,66,8,3,5,16,4,0,8,14,71,14,57,168,0,8,17,1,4,46,95,0,1,0,0,0,1,19,96,383
MEGHALAYA,KHASI HILLS EAST,2010,24,17,2,43,41,0,41,82,16,2,14,32,4,0,32,94,272,57,215,674,0,22,41,1,16,28,136,0,10,0,17,0,27,28,184,849
MEGHALAYA,KHASI HILLS WEST,2010,11,13,4,28,28,0,28,56,6,4,2,12,8,0,7,15,41,10,31,112,0,1,4,0,8,13,26,0,10,0,0,0,10,0,74,243
MEGHALAYA,RI-BHOI,2010,12,3,0,15,23,0,23,46,7,2,5,14,6,0,7,0,53,9,44,119,1,1,9,0,10,26,47,0,6,0,1,0,7,0,99,264
MIZORAM,AIZAWL,2010,23,10,4,37,34,0,34,68,3,0,3,6,1,0,7,227,453,56,397,1141,0,12,47,7,3,46,141,0,42,0,2,0,44,26,163,1110
MIZORAM,CHAMPHAI,2010,5,4,1,10,20,0,20,40,0,0,0,0,0,0,0,45,89,2,87,223,0,1,3,0,1,10,15,0,5,0,0,0,5,0,26,210
MIZORAM,KOLASIB,2010,5,2,0,7,8,0,8,16,2,0,2,4,0,0,0,32,65,7,58,162,0,4,4,1,3,13,30,0,3,0,0,0,3,5,35,182
MIZORAM,LAWNGTLAI,2010,7,1,0,8,6,0,6,12,1,0,1,2,0,0,3,23,45,0,45,116,0,3,13,1,0,3,32,0,2,0,0,0,2,12,36,156
MIZORAM,LUNGLEI,2010,3,4,2,9,9,0,9,18,0,0,0,0,0,0,4,60,106,1,105,276,0,2,4,1,2,11,20,0,10,0,0,0,10,0,26,244
MIZORAM,MAMIT,2010,3,4,0,7,6,0,6,12,1,0,1,2,2,0,2,23,17,0,17,61,0,0,2,0,4,17,24,0,6,0,0,0,6,1,19,107
MIZORAM,SAIHA,2010,2,1,0,3,3,0,3,6,2,0,2,4,0,0,0,10,26,1,25,62,0,3,4,2,0,11,20,0,1,0,0,0,1,0,23,88
MIZORAM,SERCHHIP,2010,0,1,0,1,6,0,6,12,0,0,0,0,0,0,0,5,22,2,20,49,0,0,2,0,2,5,9,0,6,0,1,0,7,0,27,77
NAGALAND,DIMAPUR,2010,20,6,3,29,4,0,4,8,41,5,36,82,2,0,15,29,212,15,197,470,1,10,14,2,0,11,55,0,8,2,1,0,11,17,113,511
NAGALAND,KIPHIRE,2010,2,2,0,4,0,0,0,0,0,0,0,0,0,0,5,0,5,0,5,15,0,0,1,0,0,0,1,0,0,0,0,0,0,0,11,26
NAGALAND,KOHIMA,2010,7,6,6,19,3,0,3,6,6,0,6,12,0,0,10,9,78,54,24,175,0,2,11,0,0,4,19,0,1,0,0,0,1,2,44,189
NAGALAND,LONGLENG,2010,0,2,0,2,0,0,0,0,0,0,0,0,0,0,0,0,1,0,1,2,0,0,0,0,0,0,0,0,0,0,0,0,0,0,9,12
NAGALAND,MOKOKCHUNG,2010,2,4,1,7,2,0,2,4,1,0,1,2,0,0,10,3,19,3,16,51,0,0,5,0,0,7,14,0,1,0,0,0,1,2,25,82
NAGALAND,MON,2010,0,0,0,0,0,0,0,0,0,0,0,0,0,0,3,0,10,0,10,23,0,0,0,0,0,0,0,0,0,0,0,0,0,0,0,13
NAGALAND,PEREN,2010,1,1,0,2,0,0,0,0,0,0,0,0,0,0,1,1,9,0,9,20,0,0,1,0,0,4,5,0,0,1,0,0,1,0,1,20
NAGALAND,PHEK,2010,4,1,1,6,1,0,1,2,1,0,1,2,0,0,3,4,10,2,8,27,0,1,1,1,1,6,10,0,1,0,0,0,1,0,9,45
NAGALAND,TUENSANG,2010,1,2,1,4,1,0,1,2,0,0,0,0,0,0,1,1,12,0,12,26,0,0,2,0,0,0,3,0,2,0,0,0,2,1,12,36
NAGALAND,WOKHA,2010,4,6,0,10,2,0,2,4,1,1,0,2,1,0,5,1,18,0,18,43,1,0,2,0,0,2,5,0,0,0,0,0,0,0,4,47
NAGALAND,ZUNHEBOTO,2010,4,5,1,10,3,0,3,6,0,0,0,0,0,0,10,14,23,6,17,70,0,0,2,0,0,2,4,0,0,0,0,0,0,0,14,78
ODISHA,ANGUL,2010,61,59,0,120,39,0,39,78,42,42,0,84,22,0,73,143,307,70,237,852,104,1,65,0,13,28,356,13,253,5,68,0,339,145,1460,2901
ODISHA,BALASORE,2010,53,40,0,93,48,0,48,96,75,68,7,150,13,4,46,166,321,98,223,871,40,35,96,3,28,1363,1570,40,188,29,211,0,468,5,526,3330
ODISHA,BARAGARH,2010,36,89,2,127,36,0,36,72,27,23,4,54,12,0,51,74,190,73,117,517,123,8,21,5,13,57,412,9,69,23,171,0,272,185,426,1627
ODISHA,BERHAMPUR,2010,20,83,0,103,11,0,11,22,16,9,7,32,10,14,59,73,178,84,94,512,45,8,40,0,11,244,450,4,125,11,12,0,152,102,185,1251
ODISHA,BHADRAK,2010,32,37,0,69,33,0,33,66,52,50,2,104,1,0,20,48,134,34,100,337,33,10,38,2,19,29,214,18,99,12,151,0,280,83,1154,2005
ODISHA,BOLANGIR,2010,34,119,0,153,48,0,48,96,19,16,3,38,8,0,36,110,152,57,95,458,95,32,42,3,17,12,279,4,188,9,112,0,313,78,903,2021
ODISHA,BOUDH,2010,11,14,0,25,7,0,7,14,7,7,0,14,2,0,7,17,19,3,16,64,19,3,3,0,8,60,109,2,35,2,21,0,60,16,107,360
ODISHA,CUTTACK,2010,30,14,0,44,26,0,26,52,26,25,1,52,12,0,47,100,180,44,136,519,30,1,27,0,16,233,413,22,26,1,107,0,156,106,1336,2340
ODISHA,DCP BBSR,2010,44,56,2,102,43,0,43,86,41,29,12,82,7,14,55,271,1146,698,448,2639,56,8,90,2,10,712,1054,18,45,8,41,0,112,176,1251,4096
ODISHA,DCP CTC,2010,19,12,6,37,17,0,17,34,31,27,4,62,3,12,64,116,517,276,241,1229,26,2,44,0,5,26,201,4,18,3,84,0,109,98,1119,2226
ODISHA,DEOGARH,2010,18,12,0,30,11,0,11,22,4,4,0,8,5,4,6,10,23,5,18,71,7,5,12,0,2,182,242,0,57,3,17,0,77,34,121,533
ODISHA,DHENKANAL,2010,39,67,0,106,19,0,19,38,36,34,2,72,13,0,54,96,227,25,202,617,117,11,35,1,20,28,332,7,252,8,25,0,292,120,611,1786
ODISHA,GAJAPATI,2010,12,12,0,24,6,0,6,12,17,17,0,34,1,0,2,10,23,5,18,59,52,1,13,0,21,28,133,0,37,2,16,0,55,18,117,388
ODISHA,GANJAM,2010,87,198,0,285,48,0,48,96,47,42,5,94,22,17,66,109,151,45,106,516,96,17,38,0,29,197,442,25,296,19,0,0,340,65,355,1882
ODISHA,JAGATSINGHPUR,2010,31,12,0,43,24,0,24,48,39,37,2,78,8,0,46,72,192,67,125,510,26,11,37,0,14,115,428,15,10,1,76,0,102,225,663,1617
ODISHA,JAJPUR,2010,45,32,0,77,30,0,30,60,38,32,6,76,15,0,48,117,287,102,185,754,42,15,39,0,14,934,1281,30,64,8,80,0,182,237,91,2166
ODISHA,JHARSUGUDA,2010,22,32,0,54,10,0,10,20,4,3,1,8,4,3,54,119,272,99,173,724,54,24,13,0,10,251,468,4,47,6,27,0,84,116,253,1325
ODISHA,KALAHANDI,2010,33,21,0,54,60,0,60,120,35,35,0,70,6,0,39,56,82,21,61,265,67,12,76,2,11,351,581,16,118,12,91,0,237,62,414,1564
ODISHA,KANDHAMAL,2010,29,13,0,42,27,0,27,54,30,26,4,60,2,1,17,37,53,9,44,163,13,9,34,0,9,201,267,3,84,3,26,0,116,1,150,742
ODISHA,KENDRAPARA,2010,50,38,3,91,38,0,38,76,36,33,3,72,10,8,46,99,135,45,90,433,29,0,20,1,18,53,198,39,8,0,22,0,69,77,662,1392
ODISHA,KEONJHAR,2010,85,62,13,160,45,0,45,90,37,32,5,74,31,6,86,81,333,87,246,870,72,21,31,4,21,158,638,18,107,8,85,0,218,331,731,2366
ODISHA,KHURDA,2010,16,18,0,34,41,0,41,82,39,31,8,78,11,2,49,64,137,54,83,400,19,1,23,0,7,0,113,8,19,2,109,0,138,63,893,1521
ODISHA,KORAPUT,2010,26,44,4,74,41,0,41,82,23,19,4,46,17,0,29,60,70,12,58,246,83,0,15,0,13,15,251,0,122,11,42,0,175,125,562,1302
ODISHA,MALKANGIR,2010,36,35,0,71,14,0,14,28,10,8,2,20,8,0,5,16,30,3,27,89,59,8,4,0,19,4,116,0,22,5,13,0,40,22,48,358
ODISHA,MAYURBHANJ,2010,88,62,0,150,76,0,76,152,73,72,1,146,10,2,25,123,252,56,196,664,26,18,36,1,18,92,281,27,189,10,146,0,372,90,859,2223
ODISHA,NAYAGARH,2010,39,8,0,47,20,0,20,40,24,20,4,48,2,0,35,60,217,42,175,531,46,8,26,0,5,388,542,16,12,2,14,0,44,69,252,1243
ODISHA,NOWRANGPUR,2010,28,12,0,40,48,0,48,96,33,33,0,66,3,0,11,54,68,9,59,204,42,5,16,0,1,174,263,2,93,10,39,0,144,25,311,975
ODISHA,NUAPADA,2010,12,9,0,21,13,0,13,26,11,10,1,22,2,0,11,31,64,32,32,172,23,7,14,0,10,30,117,0,44,3,9,0,56,33,385,711
ODISHA,PURI,2010,52,85,0,137,22,0,22,44,47,40,7,94,11,18,143,157,302,108,194,933,94,5,61,0,15,53,344,26,16,0,86,0,128,116,1429,2738
ODISHA,RAYAGADA,2010,33,15,0,48,28,0,28,56,33,30,3,66,7,0,23,36,76,13,63,218,39,11,18,3,4,43,166,7,79,4,27,0,117,48,295,829
ODISHA,ROURKELA,2010,72,37,0,109,26,0,26,52,19,19,0,38,31,5,49,82,243,108,135,653,46,3,27,0,8,218,501,3,71,6,64,0,144,199,407,1616
ODISHA,SAMBALPUR,2010,45,40,0,85,27,0,27,54,17,14,3,34,20,3,96,150,323,93,230,915,84,13,31,1,6,275,602,2,34,3,52,0,91,192,857,2271
ODISHA,SONEPUR,2010,8,21,0,29,17,0,17,34,5,5,0,10,5,0,14,28,52,15,37,151,32,0,12,0,8,176,230,3,43,2,12,5,65,2,133,578
ODISHA,SRP(CUTTACK),2010,3,1,0,4,0,0,0,0,2,2,0,4,1,1,10,6,398,54,344,814,1,0,3,0,0,36,41,0,8,0,0,0,8,1,59,530
ODISHA,SRP(ROURKELA),2010,5,3,0,8,2,0,2,4,2,2,0,4,1,1,17,13,278,51,227,588,1,0,0,0,0,0,2,1,8,0,1,0,10,1,134,468
ODISHA,SUNDARGARH,2010,54,24,1,79,24,0,24,48,19,16,3,38,10,2,52,51,140,30,110,395,38,9,8,1,7,415,662,2,19,1,10,0,32,184,107,1178
PUNJAB,AMRITSAR RURAL,2010,43,37,5,85,16,0,16,32,29,25,4,58,1,6,6,87,86,21,65,272,0,5,142,10,6,208,500,2,13,1,53,0,69,129,309,1194
PUNJAB,BARNALA,2010,19,35,4,58,12,0,12,24,9,2,7,18,0,1,3,41,86,33,53,217,0,6,46,1,3,96,230,1,7,0,15,0,23,78,276,739
PUNJAB,BATALA,2010,20,23,2,45,26,0,26,52,26,23,3,52,1,1,3,73,129,53,76,336,0,5,70,0,6,158,320,4,16,0,31,0,51,81,234,909
PUNJAB,BHATINDA,2010,58,65,3,126,29,0,29,58,40,30,10,80,2,5,6,205,344,197,147,906,0,5,195,0,7,242,452,3,36,1,31,0,71,3,592,1872
PUNJAB,CP AMRITSAR,2010,53,71,7,131,24,0,24,48,51,43,8,102,3,18,9,83,257,104,153,627,0,16,275,14,4,152,531,10,10,4,87,0,111,70,615,1833
PUNJAB,CP JALANDHAR,2010,29,51,8,88,22,0,22,44,57,40,17,114,5,10,19,176,495,243,252,1200,0,10,271,5,6,205,598,5,27,4,82,0,118,101,538,2126
PUNJAB,CP LUDHIANA,2010,90,92,14,196,55,0,55,110,152,108,44,304,8,5,31,229,888,484,404,2049,0,39,417,5,6,248,978,9,29,11,119,0,168,263,1212,3922
PUNJAB,FARIDKOT,2010,21,26,1,48,10,0,10,20,7,5,2,14,1,4,0,79,112,55,57,308,0,4,62,0,2,210,278,3,2,0,32,0,37,0,271,847
PUNJAB,FATEHGARH SAHIB,2010,16,7,2,25,11,0,11,22,16,11,5,32,0,4,7,52,116,51,65,295,0,1,102,0,0,174,431,1,6,2,19,0,28,154,249,939
PUNJAB,FEROZPUR,2010,59,54,3,116,39,0,39,78,35,28,7,70,2,3,6,123,214,85,129,562,0,17,213,7,7,366,751,10,9,0,52,0,71,141,482,1842
PUNJAB,G.R.P,2010,9,2,3,14,0,0,0,0,2,0,2,4,1,0,0,0,47,9,38,95,0,1,3,0,0,7,11,1,0,0,0,0,1,0,314,390
PUNJAB,GURDASPUR,2010,22,30,13,65,30,0,30,60,41,28,13,82,1,2,2,63,98,36,62,264,0,14,67,1,1,130,353,11,19,2,42,0,74,140,488,1217
PUNJAB,HOSHIARPUR,2010,51,53,2,106,26,0,26,52,38,36,2,76,3,5,18,154,190,51,139,560,0,5,157,4,8,309,693,5,17,1,74,0,97,210,358,1688
PUNJAB,JALANDHAR RURAL,2010,46,73,6,125,39,0,39,78,33,26,7,66,9,11,39,165,244,74,170,712,0,6,121,2,13,323,628,4,24,4,62,0,94,163,422,1809
PUNJAB,KAPURTHALA,2010,27,54,3,84,12,0,12,24,25,22,3,50,1,12,21,72,150,49,101,406,0,4,114,2,7,244,471,2,14,0,31,0,47,100,264,1159
PUNJAB,KHANNA,2010,21,14,3,38,7,0,7,14,15,10,5,30,1,6,10,57,118,50,68,310,0,10,134,1,0,139,420,4,5,0,43,0,52,136,311,1035
PUNJAB,LUDHIANA RURAL,2010,20,26,6,52,11,0,11,22,11,6,5,22,0,5,2,43,99,52,47,248,0,2,115,1,0,76,296,0,4,2,36,0,42,102,275,836
PUNJAB,MANSA,2010,35,40,1,76,22,0,22,44,13,9,4,26,0,3,2,64,64,22,42,197,0,9,92,2,1,129,233,7,2,1,23,0,33,0,284,794
PUNJAB,MOGA,2010,34,47,5,86,18,0,18,36,22,13,9,44,5,4,4,125,212,95,117,562,0,18,105,3,5,235,439,3,10,0,22,0,35,73,277,1227
PUNJAB,MUKTSAR,2010,27,26,3,56,12,0,12,24,15,10,5,30,3,3,2,90,157,60,97,412,0,7,59,0,2,163,308,3,5,1,23,0,32,77,216,894
PUNJAB,PATIALA,2010,52,42,6,100,26,0,26,52,37,31,6,74,10,16,8,162,396,205,191,988,0,11,252,2,4,320,947,9,35,1,139,0,184,358,1115,3001
PUNJAB,ROPAR,2010,27,17,2,46,14,0,14,28,18,14,4,36,0,0,2,73,152,48,104,379,0,7,88,1,3,110,362,2,14,2,20,0,38,153,394,1099
PUNJAB,SANGRUR,2010,45,47,8,100,31,0,31,62,19,7,12,38,5,7,2,164,252,130,122,682,0,15,130,5,8,201,544,8,18,0,51,0,77,185,752,1953
PUNJAB,SAS NGR,2010,19,22,3,44,17,0,17,34,35,23,12,70,0,3,7,148,346,195,151,850,0,22,144,0,0,142,772,3,18,0,42,0,63,464,312,1747
PUNJAB,SBS NAGAR,2010,22,17,4,43,17,0,17,34,16,8,8,32,2,3,26,68,101,42,59,301,0,1,54,1,2,139,280,6,5,1,18,0,30,83,132,718
PUNJAB,TARN TARAN,2010,42,23,3,68,20,0,20,40,27,18,9,54,1,6,6,65,93,23,70,264,0,3,99,8,0,147,343,5,4,0,16,0,25,86,204,858
RAJASTHAN,AJMER,2010,46,43,15,104,47,0,47,94,105,86,19,210,2,0,14,159,656,420,236,1487,27,17,874,3,9,123,1580,12,81,0,615,0,708,527,2737,6112
RAJASTHAN,ALWAR,2010,62,51,6,119,105,0,105,210,164,138,26,328,3,23,38,236,2128,1540,588,4556,14,18,912,3,23,2598,4026,42,122,0,588,0,752,458,2292,9886
RAJASTHAN,BANSWARA,2010,34,15,0,49,61,0,61,122,57,53,4,114,2,0,7,44,120,57,63,293,58,11,95,0,22,593,906,8,47,1,151,0,207,127,788,2241
RAJASTHAN,BARAN,2010,31,51,8,90,48,0,48,96,72,72,0,144,1,1,6,74,217,86,131,516,5,19,225,0,6,335,708,9,129,2,267,0,407,118,1424,3048
RAJASTHAN,BARMER,2010,26,27,1,54,34,0,34,68,33,33,0,66,0,0,4,91,309,118,191,713,2,7,266,0,14,435,908,18,71,0,194,0,283,184,1432,3148
RAJASTHAN,BHARATPUR,2010,83,86,1,170,83,0,83,166,203,152,51,406,0,1,34,60,1449,946,503,2993,2,13,626,1,14,232,1147,33,38,0,437,0,508,259,4770,8425
RAJASTHAN,BHILWARA,2010,32,29,2,63,48,0,48,96,143,130,13,286,0,1,34,222,781,462,319,1819,54,13,548,1,25,69,1040,3,74,1,593,0,671,330,2265,5268
RAJASTHAN,BIKANER,2010,39,65,7,111,41,0,41,82,43,34,9,86,0,0,5,124,344,155,189,817,0,8,426,3,13,389,1076,18,58,0,354,0,430,237,1509,3683
RAJASTHAN,BUNDI,2010,23,50,6,79,31,0,31,62,93,80,13,186,0,0,15,91,240,137,103,586,10,10,197,0,5,764,1143,3,113,0,285,0,401,157,1193,3286
RAJASTHAN,CHITTORGARH,2010,29,43,2,74,42,0,42,84,111,96,15,222,2,8,40,179,515,242,273,1259,42,59,320,0,19,980,1655,6,76,0,516,0,598,235,1531,4755
RAJASTHAN,CHURU,2010,39,35,0,74,49,0,49,98,39,17,22,78,0,1,4,88,223,59,164,539,0,12,427,2,8,473,1088,22,10,0,301,0,333,166,1254,3153
RAJASTHAN,DAUSA,2010,41,31,3,75,24,0,24,48,97,69,28,194,1,3,14,80,894,552,342,1886,28,14,268,1,13,134,726,18,18,0,162,0,198,268,3024,5136
RAJASTHAN,DHOLPUR,2010,51,69,0,120,22,0,22,44,77,53,24,154,5,0,30,50,590,285,305,1265,4,15,157,1,10,1637,1931,28,18,0,186,0,232,107,1254,4311
RAJASTHAN,DUNGARPUR,2010,18,16,0,34,26,0,26,52,52,50,2,104,1,0,17,39,88,34,54,233,75,24,58,0,22,134,440,5,56,0,100,0,161,127,1017,1875
RAJASTHAN,G.R.P. AJMER,2010,6,3,0,9,0,0,0,0,1,0,1,2,1,0,5,2,386,23,363,780,2,0,3,0,0,0,6,3,1,0,0,0,4,1,203,617
RAJASTHAN,G.R.P. JODHPUR,2010,2,1,0,3,2,0,2,4,0,0,0,0,0,0,2,0,91,13,78,184,3,0,0,0,0,1,4,0,1,2,0,0,3,0,44,149
RAJASTHAN,GANGANAGAR,2010,60,59,2,121,72,0,72,144,102,94,8,204,0,1,10,149,361,149,212,882,1,33,842,2,7,734,1812,18,74,2,659,0,753,193,1860,5241
RAJASTHAN,HANUMANGARH,2010,53,66,1,120,56,0,56,112,50,44,6,100,0,0,10,65,188,79,109,451,0,13,621,1,10,312,1085,15,98,0,427,0,540,128,1649,3763
RAJASTHAN,JAIPUR EAST,2010,25,19,6,50,28,0,28,56,79,66,13,158,3,2,113,354,2463,1942,521,5398,86,36,873,4,1,21,1216,10,42,0,231,0,283,195,2082,6673
RAJASTHAN,JAIPUR NORTH,2010,22,25,0,47,25,0,25,50,67,67,0,134,1,3,33,116,814,521,293,1781,23,28,793,1,2,317,1293,13,40,0,234,0,287,129,1235,3921
RAJASTHAN,JAIPUR RURAL,2010,61,34,4,99,27,0,27,54,109,90,19,218,6,1,23,263,970,522,448,2233,50,20,805,1,13,496,1989,13,63,1,253,0,330,604,4290,8107
RAJASTHAN,JAIPUR SOUTH,2010,18,24,1,43,18,0,18,36,61,47,14,122,0,5,107,304,1548,1099,449,3512,29,206,1480,2,2,259,2153,7,33,0,255,0,295,175,1589,6123
RAJASTHAN,JAISALMER,2010,7,2,0,9,3,0,3,6,11,7,4,22,0,0,3,77,135,43,92,350,15,5,77,0,6,162,324,5,25,0,29,0,59,59,503,1124
RAJASTHAN,JALORE,2010,21,10,0,31,13,0,13,26,38,29,9,76,0,0,4,74,185,85,100,448,13,15,136,0,5,14,310,14,36,0,122,0,172,127,1679,2506
RAJASTHAN,JHALAWAR,2010,44,67,5,116,62,0,62,124,62,48,14,124,0,8,25,91,442,223,219,1008,28,16,158,1,42,942,1299,6,187,4,303,0,500,112,1376,3981
RAJASTHAN,JHUNJHUNU,2010,49,38,2,89,49,0,49,98,63,50,13,126,0,0,10,102,320,111,209,752,19,13,437,1,9,891,1563,15,45,0,251,0,311,193,1154,3661
RAJASTHAN,JODHPUR CITY,2010,27,54,3,84,27,0,27,54,53,43,10,106,0,0,9,119,727,566,161,1582,1,16,519,2,3,472,1146,13,31,3,247,0,294,133,1149,3608
RAJASTHAN,JODHPUR RURAL,2010,33,23,0,56,17,0,17,34,49,39,10,98,1,0,7,126,266,113,153,666,4,13,208,0,11,954,1469,11,29,0,132,0,172,279,824,2987
RAJASTHAN,KARAULI,2010,35,49,2,86,42,0,42,84,91,72,19,182,2,0,28,34,705,390,315,1474,8,7,237,0,14,2,370,12,24,0,157,0,193,102,2910,4461
RAJASTHAN,KOTA CITY,2010,35,114,4,153,33,0,33,66,80,74,6,160,0,22,49,104,805,561,244,1785,2,15,493,1,4,146,778,2,50,0,369,0,421,117,1633,4078
RAJASTHAN,KOTA RURAL,2010,18,26,1,45,36,0,36,72,41,35,6,82,0,1,6,46,164,78,86,381,2,17,172,0,6,185,515,2,67,0,199,0,268,133,1078,2200
RAJASTHAN,NAGAUR,2010,54,31,1,86,60,0,60,120,69,57,12,138,0,0,12,158,453,227,226,1076,0,12,451,0,14,53,809,22,86,0,348,0,456,279,2108,4211
RAJASTHAN,PALI,2010,41,34,3,78,53,0,53,106,102,98,4,204,0,0,14,153,363,155,208,893,3,14,393,0,8,45,786,9,75,0,442,0,526,323,3086,5161
RAJASTHAN,PRATAPGARH,2010,35,27,0,62,56,0,56,112,67,56,11,134,1,0,13,50,87,39,48,238,47,3,88,0,19,533,757,7,69,0,173,0,249,67,627,1969
RAJASTHAN,RAJSAMAND,2010,14,13,2,29,14,0,14,28,31,25,6,62,1,0,15,78,178,91,87,450,19,10,216,1,8,578,990,4,41,0,233,0,278,158,766,2380
RAJASTHAN,SAWAI MADHOPUR,2010,23,27,3,53,16,0,16,32,86,65,21,172,1,0,13,90,456,305,151,1016,7,2,209,0,8,0,333,0,26,0,179,0,205,107,2257,3510
RAJASTHAN,SIKAR,2010,58,35,0,93,52,0,52,104,114,86,28,228,0,0,12,173,478,193,285,1141,29,16,660,1,24,250,1309,12,11,0,313,0,336,329,2462,5029
RAJASTHAN,SIROHI,2010,28,37,7,72,20,0,20,40,34,27,7,68,0,0,5,82,136,45,91,359,22,6,180,0,7,403,778,6,63,0,175,0,244,160,539,1910
RAJASTHAN,TONK,2010,21,21,1,43,18,0,18,36,50,44,6,100,0,1,2,64,255,147,108,577,37,11,299,1,0,737,1249,4,19,1,338,0,362,164,1114,3158
RAJASTHAN,UDAIPUR,2010,77,107,5,189,111,0,111,222,186,151,35,372,3,2,80,303,794,432,362,1976,215,22,835,2,52,1844,3381,14,192,6,327,0,539,411,2514,8102
SIKKIM,EAST,2010,6,3,1,10,5,0,5,10,4,4,0,8,0,0,5,40,33,7,26,111,1,1,11,3,2,24,63,0,1,0,0,0,1,21,67,228
SIKKIM,NORTH,2010,2,0,0,2,0,0,0,0,0,0,0,0,0,0,0,1,3,0,3,7,1,0,1,0,0,5,13,0,0,0,0,0,0,6,29,48
SIKKIM,SOUTH,2010,7,3,1,11,9,0,9,18,1,1,0,2,0,0,2,25,14,1,13,55,1,0,5,0,4,36,56,0,5,0,2,0,7,10,33,158
SIKKIM,WEST,2010,2,0,0,2,4,0,4,8,1,1,0,2,1,0,0,6,3,0,3,13,1,0,3,0,1,8,23,1,5,0,1,0,7,10,71,118
TAMIL NADU,ARIYALUR,2010,27,38,0,65,20,0,20,40,26,24,2,52,0,0,9,46,76,31,45,207,19,0,6,0,1,213,348,1,64,4,10,0,79,109,1308,1977
TAMIL NADU,CHENNAI,2010,103,158,2,263,47,0,47,94,47,30,17,94,2,2,74,383,1540,234,1306,3541,60,21,524,72,1,773,2055,16,45,23,125,0,209,604,6247,10869
TAMIL NADU,CHENNAI RLY.,2010,0,7,0,7,0,0,0,0,0,0,0,0,1,0,58,0,232,4,228,523,14,2,10,0,0,45,78,2,2,0,0,0,4,7,267,647
TAMIL NADU,CHENNAISUBURBAN,2010,86,137,1,224,29,0,29,58,30,16,14,60,1,1,102,374,750,139,611,1978,85,7,236,6,10,797,1961,18,61,87,57,0,223,820,4975,8670
TAMIL NADU,COIMBATORE RURAL,2010,41,50,0,91,13,0,13,26,62,53,9,124,11,0,78,188,425,171,254,1127,83,0,51,1,13,440,1231,1,39,0,40,0,80,643,2627,4806
TAMIL NADU,COIMBATORE URBAN,2010,22,27,0,49,15,0,15,30,22,10,12,44,1,0,25,142,1084,497,587,2336,23,9,148,30,8,357,899,1,35,1,45,0,82,324,1861,4180
TAMIL NADU,CUDDALORE,2010,58,115,0,173,27,0,27,54,39,39,0,78,1,0,16,68,241,53,188,567,149,1,42,0,21,593,1253,8,8,8,38,0,62,447,4299,6179
TAMIL NADU,DHARMAPURI,2010,59,27,4,90,15,0,15,30,47,41,6,94,2,0,25,65,161,78,83,414,107,4,24,5,32,975,1426,6,42,3,49,0,100,279,1830,3761
TAMIL NADU,DINDIGUL,2010,57,91,0,148,9,0,9,18,43,43,0,86,4,0,29,80,410,1,409,933,81,4,128,1,23,520,1295,1,43,0,107,0,151,538,3130,5299
TAMIL NADU,ERODE,2010,57,32,1,90,15,0,15,30,64,39,25,128,3,1,73,136,461,234,227,1135,39,12,77,5,5,581,1214,2,43,2,26,0,73,495,4572,6702
TAMIL NADU,KANCHIPURAM,2010,57,53,0,110,17,0,17,34,9,9,0,18,2,0,21,74,285,62,223,667,102,0,67,15,6,411,1380,1,23,2,13,0,39,779,3820,5757
TAMIL NADU,KANYAKUMARI,2010,42,100,1,143,12,0,12,24,57,55,2,114,3,0,90,216,318,124,194,945,0,3,124,4,25,756,1172,2,10,102,93,0,207,260,2534,4752
TAMIL NADU,KARUR,2010,19,51,0,70,10,0,10,20,54,52,2,108,1,0,34,54,241,59,182,571,23,9,19,4,3,272,590,4,28,7,10,0,49,260,1871,2974
TAMIL NADU,KRISHNAGIRI,2010,58,24,0,82,20,0,20,40,64,53,11,128,0,2,14,116,221,132,89,574,120,1,71,13,20,639,1327,5,27,0,42,0,74,463,2660,4580
TAMIL NADU,MADURAI RURAL,2010,59,78,1,138,17,0,17,34,58,41,17,116,2,0,95,160,348,107,241,953,168,14,123,2,17,586,1460,14,62,6,77,0,159,550,2911,5348
TAMIL NADU,MADURAI URBAN,2010,34,50,0,84,3,0,3,6,15,9,6,30,0,0,77,65,500,269,231,1142,17,8,124,31,0,130,430,11,12,20,69,0,112,120,1386,2672
TAMIL NADU,NAGAPATTINAM,2010,50,55,0,105,9,0,9,18,38,31,7,76,0,0,18,64,173,62,111,428,39,0,23,2,30,439,756,1,57,7,3,0,68,223,2796,4027
TAMIL NADU,NAMAKKAL,2010,50,21,0,71,10,0,10,20,48,42,6,96,6,1,14,70,255,119,136,601,70,4,80,2,20,637,1267,2,52,10,12,0,76,454,2872,4690
TAMIL NADU,NILGIRIS,2010,11,16,0,27,7,0,7,14,8,6,2,16,0,0,9,81,61,15,46,212,18,5,18,2,6,202,295,0,10,12,2,0,24,44,808,1320
TAMIL NADU,PERAMBALUR,2010,13,30,1,44,5,0,5,10,10,9,1,20,2,0,25,29,93,46,47,242,7,0,48,9,1,88,284,0,16,12,3,0,31,131,1013,1536
TAMIL NADU,PUDUKOTTAI,2010,45,101,2,148,7,0,7,14,54,48,6,108,3,0,55,93,250,75,175,651,45,21,48,0,24,390,813,5,42,2,14,0,63,285,3322,4808
TAMIL NADU,RAMNATHAPURAM,2010,33,49,2,84,16,0,16,32,61,50,11,122,1,0,26,83,181,45,136,472,96,0,57,5,20,514,905,1,14,4,17,0,36,213,2069,3462
TAMIL NADU,SALEM RURAL,2010,81,62,6,149,53,0,53,106,140,137,3,280,9,0,42,110,221,63,158,603,281,1,42,2,48,2665,3580,4,165,0,62,0,231,541,4099,8634
TAMIL NADU,SALEM URBAN,2010,27,18,0,45,21,0,21,42,44,38,6,88,1,0,70,35,321,150,171,748,32,6,41,1,5,554,777,3,25,23,46,0,97,138,1807,3218
TAMIL NADU,SIVAGANGAI,2010,38,27,1,66,1,0,1,2,32,30,2,64,3,1,21,89,198,63,135,510,21,1,50,0,15,160,479,4,16,1,35,0,56,232,1665,2611
TAMIL NADU,THANJAVUR,2010,82,124,1,207,7,0,7,14,42,42,0,84,4,2,141,298,870,455,415,2185,104,2,43,7,18,744,1380,3,75,0,9,0,87,462,3908,6946
TAMIL NADU,THENI,2010,42,122,0,164,18,0,18,36,93,80,13,186,0,0,53,134,321,91,230,829,69,2,239,1,27,712,1303,5,61,65,125,0,256,253,3042,5384
TAMIL NADU,THIRUNELVELI RURAL,2010,83,215,3,301,48,0,48,96,65,58,7,130,2,0,77,195,445,92,353,1164,4,4,129,7,52,1012,1617,3,88,0,52,0,143,409,4884,7777
TAMIL NADU,THIRUNELVELI URBAN,2010,12,78,0,90,16,0,16,32,11,9,2,22,1,0,26,69,269,83,186,634,0,0,40,1,5,194,327,0,5,0,4,0,9,87,812,1630
TAMIL NADU,THIRUVALLUR,2010,43,51,1,95,18,0,18,36,17,13,4,34,2,0,6,74,143,29,114,368,68,3,53,5,2,360,827,6,10,1,19,0,36,336,2269,3487
TAMIL NADU,THIRUVANNAMALAI,2010,43,89,0,132,15,0,15,30,55,39,16,110,3,0,7,68,263,139,124,604,195,0,53,5,20,599,1225,0,8,0,30,0,38,353,2756,4562
TAMIL NADU,THIRUVARUR,2010,29,30,2,61,12,0,12,24,22,18,4,44,1,0,20,96,189,77,112,495,53,0,23,1,27,518,779,0,20,0,13,0,33,157,2763,3976
TAMIL NADU,THOOTHUGUDI,2010,84,168,1,253,32,0,32,64,32,25,7,64,1,0,63,202,336,98,238,938,0,11,79,1,35,574,1047,3,4,0,57,0,64,347,2924,4954
TAMIL NADU,TIRUPPUR,2010,60,42,0,102,10,0,10,20,52,44,8,104,7,0,126,195,800,382,418,1928,39,8,55,4,6,432,1292,6,24,0,46,0,76,748,2578,5238
TAMIL NADU,TRICHY RLY.,2010,0,1,0,1,0,0,0,0,0,0,0,0,0,0,16,0,74,0,74,164,0,0,0,0,0,17,22,1,0,0,0,0,1,5,81,195
TAMIL NADU,TRICHY RURAL,2010,58,55,0,113,8,0,8,16,24,24,0,48,1,0,45,84,185,66,119,500,46,0,42,1,17,209,804,5,26,0,36,0,67,489,3194,4525
TAMIL NADU,TRICHY URBAN,2010,15,31,0,46,4,0,4,8,27,15,12,54,0,2,12,56,433,159,274,936,12,0,100,5,0,144,418,6,10,92,33,0,141,157,2602,3741
TAMIL NADU,VELLORE,2010,82,56,2,140,30,0,30,60,68,56,12,136,1,0,33,208,656,346,310,1554,5,8,42,31,12,758,1608,8,28,1,65,0,102,752,5403,8249
TAMIL NADU,VILLUPURAM,2010,63,84,0,147,50,0,50,100,82,78,4,164,0,0,19,95,287,146,141,688,302,4,75,26,34,753,2015,4,80,43,26,0,153,821,3842,6690
TAMIL NADU,VIRUDHUNAGAR,2010,52,78,0,130,20,0,20,40,58,58,0,116,3,0,73,120,266,49,217,728,68,2,105,5,27,546,1062,2,25,100,60,0,187,309,2926,4845
TRIPURA,DHALAI,2010,19,4,1,24,33,0,33,66,14,6,8,28,2,0,5,40,39,2,37,125,14,3,10,0,7,112,165,3,26,1,65,0,95,19,124,541
TRIPURA,G.R.P.,2010,0,0,0,0,0,0,0,0,0,0,0,0,0,0,0,1,3,0,3,7,0,0,0,0,0,1,1,0,1,0,0,0,1,0,0,6
TRIPURA,NORTH,2010,23,9,1,33,51,0,51,102,25,22,3,50,6,0,11,34,78,11,67,207,13,10,21,0,15,241,336,2,70,0,186,0,258,36,138,970
TRIPURA,SOUTH,2010,25,25,0,50,36,0,36,72,27,21,6,54,1,1,20,45,118,7,111,303,69,13,31,1,11,332,527,10,165,3,255,0,433,70,430,1688
TRIPURA,WEST,2010,83,25,6,114,118,0,118,236,48,42,6,96,7,1,29,101,219,44,175,576,67,27,60,5,18,450,739,10,114,5,431,0,560,112,664,2600
UTTAR PRADESH,AGRA,2010,117,127,51,295,26,0,26,52,252,212,40,504,5,1,56,166,1840,1437,403,3908,235,150,358,58,6,458,1784,80,91,0,355,0,526,519,1968,6919
UTTAR PRADESH,ALIGARH,2010,130,167,37,334,63,0,63,126,274,237,37,548,25,1,87,248,1068,563,505,2497,280,128,385,7,22,295,1432,69,164,0,318,0,551,315,1553,5636
UTTAR PRADESH,ALLAHABAD,2010,133,92,30,255,33,0,33,66,136,116,20,272,6,0,55,252,899,606,293,2111,155,82,225,36,4,352,1254,84,55,0,177,0,316,400,1749,4955
UTTAR PRADESH,AMBEDKAR NAGAR,2010,37,25,13,75,20,0,20,40,57,56,1,114,1,0,14,28,130,68,62,303,18,30,92,0,0,160,346,18,14,0,98,0,130,46,367,1168
UTTAR PRADESH,AURAIYA,2010,28,23,6,57,11,0,11,22,50,40,10,100,1,0,10,12,95,51,44,213,16,15,25,0,2,73,275,17,19,0,36,0,72,144,417,1000
UTTAR PRADESH,AZAMGARH,2010,68,41,27,136,23,0,23,46,78,65,13,156,2,1,47,57,201,108,93,509,62,44,73,5,2,233,623,23,17,0,70,0,110,204,486,1764
UTTAR PRADESH,BADAUN,2010,84,100,41,225,22,0,22,44,81,69,12,162,1,0,31,29,155,62,93,371,18,17,85,0,0,246,553,48,49,0,41,0,138,187,968,2203
UTTAR PRADESH,BAGHPAT,2010,52,50,10,112,14,0,14,28,46,41,5,92,1,0,32,37,153,76,77,376,57,21,50,0,3,144,389,14,13,0,87,0,114,114,322,1220
UTTAR PRADESH,BAHRAICH,2010,58,46,24,128,25,0,25,50,132,127,5,264,12,0,25,98,192,71,121,519,66,44,171,2,11,150,538,42,40,1,83,0,166,94,865,2181
UTTAR PRADESH,BALLIA,2010,21,32,21,74,4,0,4,8,32,28,4,64,1,0,10,36,93,52,41,233,22,31,59,0,2,123,344,30,14,0,24,0,68,107,162,824
UTTAR PRADESH,BALRAMPUR,2010,21,11,4,36,11,0,11,22,29,27,2,58,1,0,3,12,32,17,15,80,8,15,63,1,1,45,153,5,7,0,16,0,28,20,133,438
UTTAR PRADESH,BANDA,2010,37,20,19,76,22,0,22,44,42,34,8,84,0,0,5,55,104,36,68,268,14,23,28,1,16,50,243,20,39,0,37,0,96,111,495,1138
UTTAR PRADESH,BARABANKI,2010,47,31,12,90,22,0,22,44,90,90,0,180,1,1,14,70,183,54,129,452,6,104,57,1,1,263,673,20,34,0,97,0,151,241,943,2238
UTTAR PRADESH,BAREILLY,2010,115,142,22,279,44,0,44,88,182,163,19,364,0,0,44,100,535,282,253,1214,118,117,219,6,0,153,918,55,97,0,214,0,366,305,1809,4277
UTTAR PRADESH,BASTI,2010,24,11,8,43,8,0,8,16,30,30,0,60,0,0,15,17,54,27,27,140,18,7,17,2,0,71,208,14,7,0,17,0,38,93,393,806
UTTAR PRADESH,BIJNOR,2010,87,53,19,159,40,0,40,80,117,100,17,234,4,1,50,54,309,128,181,727,46,44,239,5,8,488,1044,27,56,0,254,0,337,214,745,2860
UTTAR PRADESH,BULANDSHAHAR,2010,119,139,25,283,24,0,24,48,148,127,21,296,5,4,65,56,399,192,207,928,83,42,157,3,1,14,643,40,60,0,327,0,427,343,1002,3056
UTTAR PRADESH,CHANDOLI,2010,25,17,9,51,3,0,3,6,20,12,8,40,0,0,8,21,52,26,26,133,1,25,65,2,0,113,261,15,6,0,67,0,88,55,330,834
UTTAR PRADESH,CHITRAKOOT DHAM,2010,20,3,7,30,15,0,15,30,17,13,4,34,0,0,5,25,61,21,40,152,3,10,20,0,2,15,97,15,23,0,16,0,54,47,153,457
UTTAR PRADESH,CSM NAGAR,2010,30,28,15,73,30,0,30,60,79,75,4,158,0,0,11,43,86,32,54,226,48,19,34,1,0,182,337,13,17,0,9,0,39,53,604,1302
UTTAR PRADESH,DEORIA,2010,34,8,10,52,4,0,4,8,23,18,5,46,0,0,6,36,55,33,22,152,28,2,20,3,0,105,275,21,4,0,9,0,34,117,325,810
UTTAR PRADESH,ETAH,2010,63,86,15,164,11,0,11,22,63,60,3,126,1,0,22,27,222,128,94,494,80,25,99,5,3,281,666,30,45,0,72,0,147,173,689,2012
UTTAR PRADESH,ETAWAH,2010,44,28,9,81,4,0,4,8,52,44,8,104,0,0,17,36,183,133,50,419,2,29,80,2,9,131,433,29,19,0,81,0,129,180,983,1918
UTTAR PRADESH,FAIZABAD,2010,38,16,13,67,16,0,16,32,71,69,2,142,0,0,10,61,227,101,126,525,35,49,88,5,11,203,581,18,27,0,16,0,61,190,676,1770
UTTAR PRADESH,FATEHGARH,2010,47,45,20,112,11,0,11,22,56,55,1,112,0,0,8,27,104,68,36,243,16,21,36,1,0,65,156,24,26,0,30,0,80,17,349,903
UTTAR PRADESH,FATEHPUR,2010,75,44,23,142,33,0,33,66,71,57,14,142,13,0,32,32,115,58,57,307,26,51,135,0,1,247,672,42,53,2,83,0,180,212,653,1943
UTTAR PRADESH,FIROZABAD,2010,109,68,27,204,18,0,18,36,99,78,21,198,9,0,28,39,293,198,95,662,60,32,98,0,0,247,717,54,33,0,83,0,170,280,964,2541
UTTAR PRADESH,G.R.P.,2010,24,25,6,55,1,0,1,2,15,6,9,30,19,2,99,3,2412,70,2342,4947,33,15,53,3,0,9,116,3,20,0,0,0,23,3,1188,3933
UTTAR PRADESH,GAUTAMBUDH NAGAR,2010,100,105,19,224,39,0,39,78,107,77,30,214,18,1,237,166,2844,2045,799,6110,113,102,362,3,1,25,818,19,41,0,132,0,192,212,1445,6091
UTTAR PRADESH,GHAZIABAD,2010,216,220,35,471,44,0,44,88,366,285,81,732,32,2,174,303,3993,3190,803,8497,195,201,521,9,6,45,2143,69,77,0,536,0,682,1166,2007,10217
UTTAR PRADESH,GHAZIPUR,2010,45,33,27,105,5,0,5,10,19,15,4,38,8,0,36,27,88,43,45,247,48,22,53,3,0,92,270,32,12,0,41,0,85,52,163,806
UTTAR PRADESH,GONDA,2010,51,31,29,111,9,0,9,18,77,67,10,154,9,0,21,73,167,72,95,437,46,56,280,3,0,326,801,47,30,0,6,0,83,90,703,2054
UTTAR PRADESH,GORAKHPUR,2010,105,82,22,209,45,0,45,90,229,199,30,458,4,0,83,250,1126,746,380,2589,239,141,335,20,1,342,1412,61,69,0,266,0,396,334,1492,5246
UTTAR PRADESH,HAMIRPUR,2010,22,12,19,53,6,0,6,12,15,13,2,30,0,0,3,16,67,16,51,153,4,24,25,0,1,19,156,15,25,0,22,0,62,83,140,518
UTTAR PRADESH,HARDOI,2010,68,30,21,119,20,0,20,40,74,73,1,148,0,0,6,29,139,45,94,313,16,22,66,0,2,271,631,24,50,0,55,0,129,254,1145,2292
UTTAR PRADESH,HATHRAS,2010,62,55,9,126,24,0,24,48,79,60,19,158,28,0,47,43,180,88,92,478,59,36,71,2,2,105,449,30,45,0,107,0,182,174,433,1591
UTTAR PRADESH,J.P.NAGAR,2010,57,42,14,113,24,0,24,48,57,52,5,114,9,3,38,43,132,70,62,357,43,15,73,0,0,36,320,21,25,0,69,0,115,153,507,1361
UTTAR PRADESH,JALAUN,2010,35,13,18,66,5,0,5,10,31,28,3,62,0,0,7,12,79,36,43,177,3,9,44,1,2,5,170,23,28,0,32,0,83,106,446,899
UTTAR PRADESH,JAUNPUR,2010,40,55,16,111,12,0,12,24,65,60,5,130,2,1,22,50,123,56,67,321,58,16,87,3,1,325,668,39,32,0,57,0,128,178,597,1779
UTTAR PRADESH,JHANSI,2010,46,29,21,96,9,0,9,18,38,32,6,76,1,1,8,41,127,83,44,305,26,28,54,6,0,19,176,32,43,1,7,0,83,43,533,1113
UTTAR PRADESH,KANNAUJ,2010,39,24,19,82,7,0,7,14,46,43,3,92,3,0,5,14,52,24,28,126,10,15,25,1,0,17,268,22,23,0,39,0,84,200,386,947
UTTAR PRADESH,KANPUR NAGAR,2010,150,109,41,300,42,0,42,84,316,263,53,632,10,1,81,267,1181,858,323,2721,176,215,461,53,0,407,1883,92,118,7,447,0,664,571,2147,6892
UTTAR PRADESH,KANSHIRAM NAGAR,2010,39,49,10,98,10,0,10,20,46,35,11,92,0,0,6,27,78,39,39,189,23,16,29,1,9,90,235,26,23,0,28,0,77,67,260,837
UTTAR PRADESH,KAUSHAMBI,2010,38,16,14,68,12,0,12,24,40,29,11,80,2,0,11,45,61,17,44,180,26,25,34,1,0,69,362,22,33,0,59,0,114,207,473,1188
UTTAR PRADESH,KHIRI,2010,74,71,30,175,26,0,26,52,89,80,9,178,0,3,24,21,227,115,112,502,29,42,58,2,2,311,639,37,37,0,33,0,107,195,985,2296
UTTAR PRADESH,KUSHI NAGAR,2010,39,12,16,67,11,1,10,22,27,25,2,54,0,0,3,17,54,28,26,128,34,29,75,2,1,126,440,25,13,0,12,0,50,173,523,1192
UTTAR PRADESH,LALITPUR,2010,11,3,11,25,7,0,7,14,12,9,3,24,1,0,11,17,43,19,24,115,14,15,21,2,3,10,126,8,17,0,17,0,42,61,332,616
UTTAR PRADESH,LUCKNOW,2010,114,89,32,235,75,0,75,150,328,320,8,656,15,6,105,491,2832,1757,1075,6281,213,460,849,55,1,46,2105,66,155,0,745,0,966,481,5296,12454
UTTAR PRADESH,MAHARAJGANJ,2010,26,4,14,44,16,0,16,32,45,45,0,90,1,0,9,18,30,11,19,88,15,16,80,1,0,56,365,14,11,0,50,0,75,197,401,1004
UTTAR PRADESH,MAHOBA,2010,24,13,11,48,9,0,9,18,22,15,7,44,4,0,4,30,50,28,22,138,19,11,11,0,0,8,106,14,28,0,18,0,60,57,253,586
UTTAR PRADESH,MAINPURI,2010,68,79,18,165,15,0,15,30,79,66,13,158,1,0,13,37,129,65,64,309,50,23,48,1,0,203,553,28,37,0,16,0,81,228,571,1644
UTTAR PRADESH,MATHURA,2010,75,98,23,196,24,0,24,48,87,79,8,174,5,0,35,55,650,436,214,1395,102,99,250,9,7,149,1078,29,49,0,219,0,297,462,1880,4307
UTTAR PRADESH,MAU,2010,26,53,14,93,10,0,10,20,48,41,7,96,0,0,15,58,108,50,58,289,72,17,41,2,0,106,328,17,30,0,49,0,96,90,319,1075
UTTAR PRADESH,MEERUT,2010,164,207,18,389,64,0,64,128,195,147,48,390,11,2,252,217,1909,1343,566,4300,211,120,356,21,0,23,1142,43,91,0,344,0,478,411,2133,6792
UTTAR PRADESH,MIRZAPUR,2010,17,3,15,35,2,0,2,4,4,3,1,8,1,0,4,20,79,31,48,183,2,41,82,0,0,98,226,25,4,0,137,0,166,3,673,1210
UTTAR PRADESH,MORADABAD,2010,176,149,26,351,66,0,66,132,204,184,20,408,14,2,97,133,849,505,344,1944,52,66,202,11,0,58,730,41,76,0,268,0,385,341,1551,4382
UTTAR PRADESH,MUZAFFARNAGAR,2010,168,220,38,426,34,0,34,68,233,174,59,466,17,1,91,83,588,305,283,1368,186,90,346,5,0,16,967,40,52,0,341,0,433,324,1977,4850
UTTAR PRADESH,PILIBHIT,2010,34,15,9,58,16,0,16,32,57,54,3,114,2,0,6,9,99,35,64,215,5,44,135,2,0,2,299,30,25,0,113,0,168,111,1275,1989
UTTAR PRADESH,PRATAPGARH,2010,39,47,14,100,23,0,23,46,69,64,5,138,3,0,11,53,144,73,71,355,82,32,61,1,7,227,545,34,25,0,74,0,133,135,589,1670
UTTAR PRADESH,RAIBAREILLY,2010,29,42,18,89,27,0,27,54,52,47,5,104,1,1,9,40,137,48,89,325,24,18,58,0,0,198,473,20,39,0,63,0,122,175,505,1456
UTTAR PRADESH,RAMABAI NAGAR,2010,30,33,16,79,12,0,12,24,83,80,3,166,2,0,11,24,102,38,64,241,36,33,63,3,1,161,509,22,38,0,88,0,148,212,747,1717
UTTAR PRADESH,RAMPUR,2010,68,77,19,164,65,0,65,130,114,96,18,228,11,2,96,68,347,138,209,871,69,68,203,1,8,4,490,23,44,0,121,0,188,137,781,2326
UTTAR PRADESH,SAHARANPUR,2010,58,55,32,145,11,0,11,22,40,35,5,80,0,8,23,37,402,201,201,872,70,65,213,14,0,22,640,26,20,0,140,0,186,256,1294,2786
UTTAR PRADESH,SANT KABIRNAGAR,2010,20,20,10,50,24,0,24,48,45,44,1,90,1,0,19,31,79,35,44,209,43,19,50,0,0,153,336,6,17,0,25,0,48,71,325,958
UTTAR PRADESH,SHAHJAHANPUR,2010,93,99,21,213,45,0,45,90,102,85,17,204,3,0,20,40,209,75,134,481,29,44,140,2,7,127,603,50,44,0,12,0,106,254,1018,2359
UTTAR PRADESH,SHRAWASTI,2010,18,8,6,32,14,0,14,28,25,23,2,50,0,0,8,17,41,1,40,107,18,14,45,0,0,155,266,16,19,0,3,0,38,34,159,600
UTTAR PRADESH,SIDHARTHNAGAR,2010,15,6,13,34,8,0,8,16,40,38,2,80,0,0,8,28,61,28,33,158,11,14,26,4,0,29,156,15,17,0,33,0,65,72,217,617
UTTAR PRADESH,SITAPUR,2010,77,40,25,142,11,0,11,22,114,109,5,228,5,0,36,70,274,78,196,659,23,36,86,4,1,146,856,45,54,0,111,0,210,560,1112,2830
UTTAR PRADESH,SONBHADRA,2010,15,6,23,44,21,0,21,42,23,20,3,46,0,0,8,25,66,36,30,165,7,36,109,1,0,94,350,20,13,0,16,0,49,103,392,978
UTTAR PRADESH,ST.RAVIDASNAGAR,2010,13,9,10,32,1,0,1,2,9,9,0,18,0,0,2,10,34,15,19,80,3,8,10,0,1,33,99,11,3,0,8,0,22,44,89,298
UTTAR PRADESH,SULTANPUR,2010,32,45,16,93,14,0,14,28,59,49,10,118,0,0,18,67,166,91,75,417,31,42,63,0,0,219,453,16,41,0,62,0,119,98,565,1554
UTTAR PRADESH,UNNAO,2010,46,54,28,128,32,0,32,64,81,76,5,162,4,0,22,52,127,49,78,332,37,49,81,3,0,197,653,26,57,0,74,0,157,286,380,1636
UTTAR PRADESH,VARANASI,2010,32,64,18,114,9,0,9,18,88,71,17,176,1,3,23,64,628,456,172,1347,60,131,240,25,1,250,934,26,14,0,166,0,206,227,990,3060
UTTARAKHAND,ALMORA,2010,3,3,1,7,3,0,3,6,5,5,0,10,0,0,1,16,15,0,15,47,7,2,2,0,0,9,31,4,3,0,4,0,11,11,73,162
UTTARAKHAND,BAGESHWAR,2010,2,0,1,3,2,0,2,4,2,2,0,4,0,0,0,4,10,1,9,24,1,0,1,0,0,7,13,2,3,1,1,0,7,4,5,46
UTTARAKHAND,CHAMOLI,2010,1,0,2,3,1,0,1,2,2,0,2,4,0,1,0,7,17,2,15,42,7,1,8,0,1,23,43,0,3,0,1,0,4,3,31,109
UTTARAKHAND,CHAMPAWAT,2010,4,0,1,5,1,0,1,2,3,0,3,6,0,0,0,4,11,5,6,26,2,1,2,1,1,26,56,1,1,0,0,0,2,23,14,96
UTTARAKHAND,DEHRADUN,2010,33,48,16,97,37,0,37,74,71,57,14,142,4,0,50,97,505,228,277,1161,130,41,204,14,8,230,787,12,26,74,117,0,229,160,493,2370
UTTARAKHAND,HARIDWAR,2010,44,62,7,113,28,0,28,56,86,71,15,172,3,0,51,56,474,206,268,1058,157,67,187,7,4,558,1185,15,31,67,103,0,216,205,442,2654
UTTARAKHAND,NAINITAL,2010,18,25,11,54,13,0,13,26,29,29,0,58,0,0,7,21,163,74,89,354,29,13,56,4,0,20,199,5,15,17,15,0,52,77,356,894
UTTARAKHAND,PAURI GARHWAL,2010,2,6,4,12,4,0,4,8,5,3,2,10,2,0,6,15,37,8,29,97,9,5,10,1,0,29,64,4,5,3,7,0,19,10,33,197
UTTARAKHAND,PITHORAGARH,2010,4,1,3,8,3,0,3,6,5,5,0,10,0,0,0,13,15,0,15,43,8,2,4,3,3,9,29,1,5,0,6,0,12,0,51,136
UTTARAKHAND,RUDRA PRAYAG,2010,5,3,1,9,5,0,5,10,3,3,0,6,0,0,2,9,8,0,8,27,11,5,3,0,0,18,47,6,3,1,1,0,11,10,13,107
UTTARAKHAND,TEHRI GARHWAL,2010,2,3,1,6,1,0,1,2,2,2,0,4,0,0,1,7,24,8,16,56,1,5,11,1,0,3,30,2,6,0,1,0,9,9,36,116
UTTARAKHAND,UDHAMSINGH NAGAR,2010,55,66,12,133,22,0,22,44,70,69,1,140,3,1,43,57,855,338,517,1814,91,24,75,2,0,42,460,23,23,0,75,0,121,226,523,2288
UTTARAKHAND,UTTARKASHI,2010,3,2,0,5,1,0,1,2,3,3,0,6,0,0,1,4,4,1,3,13,5,1,4,0,0,0,10,0,1,2,3,0,6,0,31,65
WEST BENGAL,24 PARGANAS NORTH,2010,244,224,179,647,173,0,173,346,438,292,146,876,15,108,83,28,2312,576,1736,4858,815,240,312,6,25,179,1588,71,174,8,2378,5,2636,11,7123,15151
WEST BENGAL,24 PARGANAS SOUTH,2010,263,2,25,290,258,0,258,516,215,215,0,430,12,69,39,9,2732,475,2257,5593,1238,9,116,1,15,223,1614,48,113,0,2879,0,3040,12,7021,15299
WEST BENGAL,ASANSOL,2010,34,8,14,56,18,0,18,36,21,13,8,42,4,64,5,5,323,175,148,724,49,5,47,1,3,69,283,19,13,0,310,0,342,109,720,1841
WEST BENGAL,BANKURA,2010,105,58,6,169,36,0,36,72,47,45,2,94,24,15,38,8,228,49,179,541,262,24,42,1,16,158,663,18,59,2,279,0,358,160,665,2251
WEST BENGAL,BIRBHUM,2010,94,22,20,136,44,0,44,88,52,29,23,104,5,31,28,11,388,82,306,851,281,16,42,0,23,420,989,25,48,0,301,0,374,207,489,2547
WEST BENGAL,BURDWAN,2010,134,19,33,186,72,0,72,144,112,69,43,224,12,61,54,13,693,257,436,1526,396,12,112,3,17,70,713,28,93,0,693,0,814,103,2266,4996
WEST BENGAL,COOCHBEHAR,2010,66,141,1,208,143,0,143,286,186,170,16,372,2,2,5,7,254,62,192,524,113,18,62,1,9,155,469,12,62,0,535,0,609,111,1836,3721
WEST BENGAL,DAKSHIN DINAJPUR,2010,40,88,17,145,56,0,56,112,96,87,9,192,0,4,13,9,163,52,111,352,29,6,33,4,11,184,357,19,77,0,264,0,360,90,868,2071
WEST BENGAL,DARJEELING,2010,62,3,17,82,36,0,36,72,77,75,2,154,2,25,15,12,593,186,407,1240,86,67,33,5,7,672,1009,2,57,7,158,0,224,139,773,2848
WEST BENGAL,HOOGHLY,2010,124,47,24,195,52,0,52,104,87,87,0,174,13,45,40,3,760,184,576,1621,728,0,115,7,52,159,1205,12,47,0,694,0,753,144,1595,4748
WEST BENGAL,HOWRAH,2010,111,7,15,133,59,0,59,118,185,154,31,370,40,41,68,64,1399,370,1029,3011,297,51,331,6,0,67,1129,31,121,0,1078,0,1230,377,4171,8519
WEST BENGAL,HOWRAH G.R.P.,2010,10,7,1,18,0,0,0,0,5,4,1,10,4,4,4,0,561,2,559,1134,2,3,17,0,0,0,24,0,8,0,0,0,8,2,80,708
WEST BENGAL,JALPAIGURI,2010,117,97,34,248,180,0,180,360,259,206,53,518,19,1,65,61,1290,165,1125,2726,74,87,75,1,14,1230,1714,12,269,0,649,0,930,233,2666,7433
WEST BENGAL,KHARAGPUR G.R.P.,2010,1,0,0,1,0,0,0,0,3,1,2,6,1,4,3,0,117,0,117,242,0,0,0,0,0,0,0,0,0,0,0,0,0,0,0,129
WEST BENGAL,KOLKATA,2010,49,55,43,147,32,0,32,64,125,91,34,250,0,26,18,66,3118,506,2612,6346,282,329,1271,73,0,2007,4324,12,226,133,400,3,774,362,6880,15510
WEST BENGAL,MALDA,2010,86,139,24,249,167,0,167,334,189,122,67,378,7,15,24,3,333,138,195,715,80,0,68,47,0,448,643,6,139,1,621,0,767,0,1889,4286
WEST BENGAL,MURSHIDABAD,2010,185,620,36,841,526,0,526,1052,511,441,70,1022,18,70,44,7,983,204,779,2105,553,54,170,30,54,3799,4971,45,609,6,2927,0,3587,311,1536,13094
WEST BENGAL,NADIA,2010,121,335,21,477,167,0,167,334,345,339,6,690,30,25,86,13,1191,190,1001,2536,189,35,176,18,26,1792,2425,65,102,4,1586,0,1757,189,2758,9274
WEST BENGAL,PASCHIM MIDNAPUR,2010,268,113,49,430,67,0,67,134,101,101,0,202,40,20,55,30,533,158,375,1211,445,35,58,2,36,142,722,18,70,1,669,0,758,4,1884,4640
WEST BENGAL,PURAB MIDNAPUR,2010,87,8,53,148,51,0,51,102,127,120,7,254,14,8,25,23,408,134,274,886,581,9,93,3,13,0,980,27,16,0,702,0,745,281,1867,4396
WEST BENGAL,PURULIA,2010,115,0,7,122,42,0,42,84,37,0,37,74,10,18,37,12,263,44,219,603,104,0,44,1,0,0,149,13,60,0,194,0,267,0,838,1795
WEST BENGAL,SEALDAH G.R.P.,2010,12,11,1,24,2,0,2,4,6,3,3,12,1,21,14,0,281,0,281,598,17,2,9,1,0,33,62,2,5,0,2,0,9,0,47,467
WEST BENGAL,SILIGURI G.R.P.,2010,7,1,0,8,0,0,0,0,3,1,2,6,0,0,1,0,102,0,102,205,0,0,0,1,0,0,1,0,3,0,0,0,3,0,15,133
WEST BENGAL,UTTAR DINAJPUR,2010,63,106,10,179,130,0,130,260,118,99,19,236,15,10,34,4,364,114,250,791,188,9,34,2,10,957,1202,22,94,1,477,0,594,2,1109,3759
A & N ISLANDS,ANDAMAN,2010,8,7,4,19,23,0,23,46,10,8,2,20,1,0,7,77,116,22,94,317,11,10,56,0,11,77,174,0,31,10,9,0,50,9,479,956
A & N ISLANDS,NICOBAR,2010,1,0,0,1,1,0,1,2,0,0,0,0,0,0,0,3,5,0,5,13,0,0,0,0,1,3,4,0,0,0,0,0,0,0,10,24
CHANDIGARH,CHANDIGARH,2010,21,30,9,60,31,0,31,62,38,28,10,76,5,6,67,236,1481,898,583,3276,65,23,163,3,9,65,334,5,29,4,41,0,79,6,1036,3373
D & N HAVELI,D and N HAVELI,2010,6,0,1,7,3,0,3,6,18,10,8,36,2,0,3,25,63,34,29,156,44,12,18,1,2,11,108,0,11,2,3,0,16,20,133,378
DAMAN & DIU,DAMAN,2010,5,2,1,8,1,0,1,2,2,2,0,4,6,0,0,23,41,23,18,111,8,3,3,0,0,9,55,0,2,0,1,0,3,32,25,164
DAMAN & DIU,DIU,2010,0,0,0,0,0,0,0,0,0,0,0,0,0,0,0,4,6,6,0,16,3,1,2,0,0,3,15,0,0,0,2,0,2,6,12,39
DELHI UT,CAW,2010,0,0,0,0,0,0,0,0,0,0,0,0,0,0,0,0,0,0,0,0,0,0,0,0,0,0,0,0,0,0,187,0,187,0,0,187
DELHI UT,CENTRAL,2010,25,11,3,39,20,0,20,40,126,62,64,252,0,0,35,65,1350,791,559,2800,5,20,352,3,1,152,542,2,25,3,62,0,92,9,559,2828
DELHI UT,CRIME BRANCH,2010,0,5,0,5,0,0,0,0,1,0,1,2,0,0,0,0,8,0,8,16,0,0,27,2,0,0,29,0,0,0,0,0,0,0,18,61
DELHI UT,EAST,2010,57,54,8,119,47,0,47,94,357,192,165,714,7,0,81,204,3443,2617,826,7178,14,26,174,1,7,196,600,12,83,8,163,0,266,182,1599,6723
DELHI UT,EOW,2010,0,0,0,0,0,0,0,0,0,0,0,0,0,0,0,0,0,0,0,0,0,1,84,0,0,0,85,0,0,0,0,0,0,0,65,150
DELHI UT,GRP(RLY),2010,12,5,0,17,2,0,2,4,23,5,18,46,2,0,9,0,647,32,615,1305,1,7,8,1,1,11,30,0,3,0,0,0,3,1,83,816
DELHI UT,IGI AIRPORT,2010,0,0,0,0,0,0,0,0,13,0,13,26,0,0,0,1,85,31,54,171,0,3,12,0,0,0,28,0,7,0,0,0,7,13,569,703
DELHI UT,NEW DELHI,2010,6,4,2,12,16,0,16,32,29,21,8,58,1,0,19,33,579,194,385,1211,3,18,97,14,1,30,228,0,20,10,2,0,32,65,503,1452
DELHI UT,NORTH,2010,30,16,7,53,7,0,7,14,161,88,73,322,0,0,24,75,1166,604,562,2431,1,25,109,1,7,142,304,8,23,8,63,0,102,19,997,2889
DELHI UT,NORTH-EAST,2010,68,27,7,102,51,0,51,102,458,252,206,916,5,1,57,81,2544,1821,723,5232,6,12,90,0,5,276,551,24,68,5,216,0,313,162,899,5062
DELHI UT,NORTH-WEST,2010,60,49,4,113,50,0,50,100,260,132,128,520,8,5,178,225,2411,1472,939,5238,2,20,112,0,5,177,340,11,62,5,163,0,241,24,1185,5016
DELHI UT,OUTER,2010,98,42,7,147,49,0,49,98,457,260,197,914,4,4,39,234,2129,1540,589,4539,3,23,141,0,5,245,443,21,64,9,124,0,218,26,1771,5495
DELHI UT,SOUTH,2010,35,21,5,61,59,0,59,118,240,144,96,480,4,12,47,203,2454,1677,777,5174,0,30,200,5,4,104,378,9,66,10,79,0,164,35,1686,5308
DELHI UT,SOUTH-EAST,2010,48,25,11,84,80,0,80,160,369,189,180,738,0,8,32,142,2345,1516,829,4872,10,44,179,3,3,238,803,13,92,10,60,0,175,326,1568,5606
DELHI UT,SOUTH-WEST,2010,63,20,3,86,54,0,54,108,363,203,160,726,1,0,30,83,1339,919,420,2792,7,15,92,0,2,144,271,24,28,5,94,0,151,11,1125,3503
DELHI UT,STF,2010,0,3,0,3,0,0,0,0,1,0,1,2,0,0,0,0,0,0,0,0,0,0,7,1,0,0,8,0,0,0,0,0,0,0,6,18
DELHI UT,WEST,2010,63,29,14,106,72,0,72,144,350,192,158,700,0,1,48,156,2588,1752,836,5381,1,29,161,2,11,210,455,19,60,7,191,0,277,41,1422,5475
LAKSHADWEEP,LAKSHADWEEP,2010,0,0,0,0,0,0,0,0,0,0,0,0,0,0,0,5,5,0,5,15,3,0,0,0,2,1,6,0,0,0,0,0,0,0,26,42
PUDUCHERRY,KARAIKAL,2010,4,3,0,7,1,0,1,2,2,2,0,4,0,0,0,21,47,22,25,115,31,2,13,0,1,208,299,0,15,5,1,0,21,44,364,762
PUDUCHERRY,PUDUCHERRY,2010,29,16,16,61,2,0,2,4,15,12,3,30,2,10,5,51,487,362,125,1042,100,10,64,3,9,598,982,1,31,17,6,0,55,198,1503,3173
ANDHRA PRADESH,ADILABAD,2011,109,94,8,211,84,0,84,168,77,70,7,154,5,0,8,230,346,96,250,935,85,24,175,3,33,1897,2576,20,112,142,429,0,703,359,881,5121
ANDHRA PRADESH,ANANTAPUR,2011,171,108,5,284,16,0,16,32,83,83,0,166,13,0,15,247,645,175,470,1565,85,16,155,1,38,1977,2867,36,156,16,198,0,406,595,854,5430
ANDHRA PRADESH,CHITTOOR,2011,91,55,5,151,17,0,17,34,84,47,37,168,5,0,17,159,612,245,367,1405,84,21,163,10,57,1848,2683,25,124,168,421,0,738,500,758,5224
ANDHRA PRADESH,CUDDAPAH,2011,120,67,6,193,41,0,41,82,73,65,8,146,3,0,4,143,586,248,338,1322,105,36,163,5,29,2050,2877,15,144,17,122,0,298,489,1122,5340
ANDHRA PRADESH,CYBERABAD,2011,213,128,17,358,89,0,89,178,146,90,56,292,9,0,93,1210,4010,1754,2256,9332,52,168,1293,13,49,4028,6788,51,158,234,1411,0,1854,1185,3088,17645
ANDHRA PRADESH,EAST GODAVARI,2011,83,110,3,196,72,0,72,144,60,51,9,120,2,0,23,308,1000,364,636,2333,31,88,280,23,34,2228,3247,17,176,224,575,0,992,563,1211,7111
ANDHRA PRADESH,GUNTAKAL RLY.,2011,9,0,0,9,0,0,0,0,0,0,0,0,1,0,4,0,227,0,227,459,1,0,2,15,0,6,28,0,0,3,1,0,4,4,24,297
ANDHRA PRADESH,GUNTUR,2011,88,73,2,163,40,0,40,80,58,57,1,116,4,0,8,255,691,80,611,1649,36,25,278,15,40,2934,3788,8,223,140,494,0,865,460,1154,7026
ANDHRA PRADESH,GUNTUR URBAN,2011,51,30,1,82,33,0,33,66,31,28,3,62,2,0,14,138,850,320,530,1854,3,13,273,5,9,1005,1537,6,86,111,395,0,598,229,648,3933
ANDHRA PRADESH,HYDERABAD CITY,2011,117,136,6,259,59,0,59,118,95,39,56,190,8,0,40,693,4416,1823,2593,9573,220,75,1864,44,50,3334,6092,37,157,93,1355,0,1642,505,2353,15657
ANDHRA PRADESH,KARIMNAGAR,2011,150,124,6,280,58,0,58,116,172,120,52,344,2,6,20,339,792,288,504,1951,179,59,588,3,73,2801,4277,40,253,235,702,0,1230,574,1797,8973
ANDHRA PRADESH,KHAMMAM,2011,108,98,6,212,84,0,84,168,81,73,8,162,5,0,12,262,540,212,328,1359,157,18,199,1,19,1945,2867,20,243,140,519,0,922,528,976,5961
ANDHRA PRADESH,KRISHNA,2011,70,78,1,149,80,0,80,160,89,75,14,178,2,0,13,264,592,145,447,1463,32,33,203,2,50,2606,3342,15,348,292,733,0,1388,416,938,6857
ANDHRA PRADESH,KURNOOL,2011,153,177,4,334,39,0,39,78,76,58,18,152,9,0,19,240,555,166,389,1378,116,13,382,4,45,1611,2724,20,340,222,424,0,1006,553,2439,7441
ANDHRA PRADESH,MAHABOOBNAGAR,2011,188,85,28,301,88,0,88,176,74,69,5,148,3,0,15,236,1168,10,1158,2590,67,25,194,4,76,1955,3029,28,162,66,259,0,515,708,1246,6675
ANDHRA PRADESH,MEDAK,2011,141,57,14,212,38,0,38,76,40,33,7,80,6,0,19,331,564,154,410,1484,72,13,250,8,62,1725,2879,26,121,50,384,0,581,749,999,5669
ANDHRA PRADESH,NALGONDA,2011,101,95,5,201,48,0,48,96,84,51,33,168,2,0,19,294,612,150,462,1539,130,31,264,6,62,1374,2645,36,229,150,255,0,670,778,3065,7640
ANDHRA PRADESH,NELLORE,2011,61,82,3,146,28,0,28,56,85,81,4,170,2,1,18,208,943,295,648,2115,36,87,229,6,51,2237,3106,7,166,119,187,0,479,460,1278,6294
ANDHRA PRADESH,NIZAMABAD,2011,135,55,9,199,63,0,63,126,84,51,33,168,9,0,30,408,766,231,535,1979,88,27,248,4,20,1900,2793,27,98,100,569,0,794,506,1245,6391
ANDHRA PRADESH,PRAKASHAM,2011,88,111,5,204,24,0,24,48,100,81,19,200,7,0,15,202,510,174,336,1244,53,71,276,7,34,1397,2333,11,243,56,266,0,576,495,2009,5980
ANDHRA PRADESH,RAJAHMUNDRY,2011,21,56,0,77,15,0,15,30,36,28,8,72,1,0,10,105,376,149,227,868,7,26,69,2,3,750,1006,3,44,34,189,0,270,149,245,2141
ANDHRA PRADESH,RANGA REDDY,2011,75,19,5,99,24,0,24,48,24,20,4,48,1,0,6,88,132,34,98,359,38,8,60,0,11,592,897,15,50,2,89,0,156,188,365,1792
ANDHRA PRADESH,SECUNDERABAD RLY.,2011,9,2,0,11,0,0,0,0,1,1,0,2,0,0,7,0,447,0,447,901,7,0,7,10,1,17,45,1,5,1,2,0,9,3,53,573
ANDHRA PRADESH,SRIKAKULAM,2011,40,65,3,108,29,0,29,58,28,23,5,56,3,0,7,124,254,14,240,642,100,24,73,0,24,1654,2162,8,91,83,333,0,515,287,931,4161
ANDHRA PRADESH,TIRUPATHI URBAN,2011,44,30,1,75,10,0,10,20,21,1,20,42,2,0,23,180,839,349,490,1883,37,5,245,4,11,709,1226,5,40,7,112,0,164,215,408,2948
ANDHRA PRADESH,VIJAYAWADA CITY,2011,35,66,5,106,37,0,37,74,70,50,20,140,2,0,35,232,1531,609,922,3331,2,101,430,6,24,1842,2718,17,248,355,1066,0,1686,313,808,7225
ANDHRA PRADESH,VIJAYAWADA RLY.,2011,2,0,0,2,1,0,1,2,3,2,1,6,1,0,3,0,400,0,400,804,0,0,6,0,0,17,27,1,3,2,1,0,7,4,35,479
ANDHRA PRADESH,VISAKHA RURAL,2011,66,28,0,94,38,0,38,76,36,30,6,72,0,0,11,166,283,15,268,743,47,20,131,0,22,1291,1824,8,120,128,203,0,459,313,557,3468
ANDHRA PRADESH,VISAKHAPATNAM,2011,39,34,5,78,57,0,57,114,50,48,2,100,13,0,28,283,1284,393,891,2892,3,57,244,4,11,1308,2037,12,31,50,386,0,479,410,577,4886
ANDHRA PRADESH,VIZIANAGARAM,2011,38,32,3,73,50,0,50,100,26,20,6,52,0,0,11,128,344,0,344,827,8,15,102,1,8,1551,1951,5,79,99,384,0,567,266,1668,4818
ANDHRA PRADESH,WARANGAL,2011,72,32,8,112,48,0,48,96,68,62,6,136,1,0,12,234,338,8,330,923,208,8,179,1,27,975,1703,26,157,27,89,0,299,305,1701,4516
ANDHRA PRADESH,WARANGAL URBAN,2011,46,10,5,61,35,0,35,70,55,15,40,110,1,0,21,160,415,115,300,1012,86,5,272,1,5,499,1098,26,78,54,63,0,221,230,1730,3797
ANDHRA PRADESH,WEST GODAVARI,2011,74,92,2,168,97,0,97,194,144,90,54,288,2,0,20,433,1199,350,849,2853,35,62,451,16,43,2389,3630,27,364,238,760,0,1389,634,1229,8311
ARUNACHAL PRADESH,ANJAW,2011,2,1,0,3,0,0,0,0,0,0,0,0,0,0,0,3,3,0,3,9,0,0,0,0,0,5,7,0,0,0,0,0,0,2,5,21
ARUNACHAL PRADESH,CHANGLANG,2011,9,4,0,13,3,0,3,6,12,7,5,24,0,0,4,18,33,2,31,88,1,4,5,0,0,42,56,0,3,0,2,0,5,4,57,201
ARUNACHAL PRADESH,DIBANG VALLEY,2011,3,1,0,4,3,0,3,6,3,2,1,6,4,0,5,3,14,3,11,40,4,1,4,0,2,12,24,0,1,0,0,0,1,1,29,90
ARUNACHAL PRADESH,K/KUMEY,2011,3,0,0,3,4,0,4,8,0,0,0,0,0,0,1,4,2,2,0,9,0,2,1,0,0,2,8,0,0,0,0,0,0,3,11,33
ARUNACHAL PRADESH,KAMENG EAST,2011,2,1,0,3,3,0,3,6,2,2,0,4,1,0,4,9,8,0,8,30,1,4,3,0,0,32,42,0,3,0,0,0,3,2,27,102
ARUNACHAL PRADESH,KAMENG WEST,2011,3,4,1,8,0,0,0,0,2,1,1,4,0,0,1,6,20,6,14,47,3,1,1,1,0,29,50,0,4,0,0,0,4,15,27,118
ARUNACHAL PRADESH,LOHIT,2011,12,3,0,15,5,0,5,10,10,4,6,20,1,0,5,9,38,7,31,91,0,5,2,1,2,16,41,0,2,0,0,0,2,15,32,158
ARUNACHAL PRADESH,PAPUM PARE,2011,7,6,0,13,4,0,4,8,23,17,6,46,4,0,12,26,119,82,37,280,30,17,31,0,19,68,186,0,7,0,9,0,16,21,150,553
ARUNACHAL PRADESH,RURAL,2011,0,3,0,3,2,0,2,4,5,4,1,10,2,0,2,6,13,5,8,36,1,1,5,0,2,22,35,0,4,0,3,0,7,4,24,99
ARUNACHAL PRADESH,SIANG EAST,2011,4,0,1,5,8,0,8,16,4,4,0,8,0,0,6,30,79,29,50,194,2,1,3,0,2,33,49,0,7,0,2,0,9,8,45,235
ARUNACHAL PRADESH,SIANG UPPER,2011,2,0,0,2,1,0,1,2,3,3,0,6,0,0,3,7,8,0,8,26,0,2,2,0,0,11,15,0,3,0,0,0,3,0,13,55
ARUNACHAL PRADESH,SIANG WEST,2011,2,3,0,5,2,0,2,4,8,5,3,16,0,0,8,11,32,9,23,83,4,5,9,0,3,36,63,0,8,0,2,0,10,6,71,210
ARUNACHAL PRADESH,SUBANSIRI LOWER,2011,4,1,0,5,2,0,2,4,3,3,0,6,0,0,5,5,15,2,13,40,0,2,0,0,2,10,18,0,0,0,0,0,0,4,25,78
ARUNACHAL PRADESH,SUBANSIRI UPPER,2011,1,1,0,2,2,0,2,4,8,6,2,16,0,0,3,13,5,0,5,26,2,6,5,0,1,45,64,0,5,0,0,0,5,5,34,136
ARUNACHAL PRADESH,TAWANG,2011,0,0,0,0,0,0,0,0,1,1,0,2,0,0,0,7,4,0,4,15,0,1,1,0,0,7,15,0,1,0,0,0,1,6,21,49
ARUNACHAL PRADESH,TIRAP,2011,11,1,0,12,3,0,3,6,9,1,8,18,1,0,5,23,21,5,16,71,0,1,2,0,1,9,15,0,3,0,0,0,3,2,51,143
ARUNACHAL PRADESH,UPPER DIBANG VALLEY,2011,0,0,0,0,0,0,0,0,0,0,0,0,0,0,0,3,0,0,0,3,1,1,0,0,0,0,2,0,0,0,0,0,0,0,0,5
ASSAM,BARPETA,2011,45,26,0,71,92,0,92,184,168,156,12,336,18,0,21,149,236,10,226,660,197,76,33,5,2,36,361,5,25,0,336,0,366,12,1480,2962
ASSAM,BASKA,2011,44,3,0,47,29,0,29,58,68,60,8,136,4,0,12,27,84,6,78,211,4,4,27,0,13,76,155,3,4,0,25,0,32,31,318,776
ASSAM,BONGAIGAON,2011,22,8,0,30,72,0,72,144,74,64,10,148,6,0,9,105,138,8,130,396,106,34,33,2,2,25,227,5,2,0,126,0,133,25,710,1504
ASSAM,C.I.D.,2011,0,0,0,0,0,0,0,0,1,0,1,2,0,0,0,0,4,0,4,8,0,7,19,0,0,0,26,0,0,0,0,0,0,0,26,57
ASSAM,CACHAR,2011,64,7,0,71,74,0,74,148,178,167,11,356,25,0,20,123,559,101,458,1286,245,52,66,6,35,397,882,4,7,0,498,0,509,81,1845,4286
ASSAM,CHIRANG,2011,27,0,0,27,30,0,30,60,43,40,3,86,6,0,21,45,73,3,70,218,9,14,16,1,4,17,71,4,8,0,51,0,63,10,297,676
ASSAM,DARRANG,2011,34,3,0,37,95,0,95,190,200,192,8,400,4,0,5,161,173,9,164,516,28,67,91,0,7,179,439,2,109,2,164,0,277,67,1231,2622
ASSAM,DHEMAJI,2011,23,14,0,37,62,0,62,124,63,59,4,126,7,0,11,45,90,0,90,243,22,13,15,0,10,144,265,5,40,0,122,0,167,61,345,1092
ASSAM,DHUBRI,2011,61,19,7,87,157,0,157,314,307,276,31,614,20,0,36,139,223,7,216,641,444,65,82,14,103,525,1326,12,210,2,693,0,917,93,1032,4244
ASSAM,DIBRUGARH,2011,89,0,10,99,54,0,54,108,135,29,106,270,1,0,23,98,437,101,336,996,22,61,102,0,0,104,598,0,7,0,135,0,142,309,942,2529
ASSAM,G.R.P.,2011,7,0,0,7,1,0,1,2,8,1,7,16,11,0,3,2,166,2,164,348,8,6,1,0,0,6,21,0,0,0,0,0,0,0,123,342
ASSAM,GOALPARA,2011,39,5,0,44,99,0,99,198,100,89,11,200,10,0,13,67,189,23,166,468,142,0,49,0,7,244,488,3,2,0,142,2,149,46,1044,2203
ASSAM,GOLAGHAT,2011,56,56,0,112,54,0,54,108,159,146,13,318,6,0,29,81,224,7,217,564,4,14,44,0,17,356,600,1,66,0,194,0,261,165,486,2012
ASSAM,GUWAHATI CITY,2011,58,59,2,119,56,0,56,112,366,306,60,732,22,3,252,696,2236,100,2136,5445,111,124,259,11,3,469,1207,10,112,0,213,0,335,230,5253,10545
ASSAM,HAILAKANDI,2011,20,2,0,22,61,0,61,122,78,63,15,156,4,0,6,66,124,2,122,324,153,19,23,2,29,29,281,4,27,0,126,0,157,26,556,1355
ASSAM,JORHAT,2011,48,9,5,62,49,0,49,98,85,11,74,170,5,0,30,137,347,43,304,866,19,37,76,4,6,450,728,2,49,0,172,0,223,136,481,2147
ASSAM,KAMRUP,2011,44,4,1,49,63,0,63,126,156,139,17,312,19,0,36,122,375,31,344,927,42,36,41,1,12,179,379,6,61,0,147,0,214,68,1455,2868
ASSAM,KARBI ANGLONG,2011,48,27,4,79,13,0,13,26,47,35,12,94,5,0,8,34,140,7,133,327,28,7,21,3,8,64,204,0,22,0,20,0,42,73,187,759
ASSAM,KARIMGANJ,2011,45,25,1,71,46,0,46,92,79,68,11,158,18,0,9,90,162,4,158,441,81,16,32,2,35,261,475,4,15,0,194,0,213,48,868,2031
ASSAM,KOKRAJHAR,2011,51,27,0,78,52,0,52,104,105,79,26,210,8,0,17,48,155,32,123,383,64,7,39,0,32,166,357,1,31,0,120,0,152,49,266,1238
ASSAM,LAKHIMPUR,2011,38,16,0,54,52,0,52,104,143,120,23,286,6,0,15,76,161,2,159,419,39,7,7,0,16,352,588,0,57,0,119,0,176,167,739,2010
ASSAM,MORIGAON,2011,27,8,4,39,54,0,54,108,96,93,3,192,3,0,5,65,62,17,45,197,103,14,41,2,3,112,325,3,12,0,112,0,127,50,428,1204
ASSAM,N.C.HILLS,2011,16,2,6,24,3,0,3,6,19,8,11,38,0,0,2,12,46,2,44,106,0,7,4,0,9,33,59,1,0,0,4,0,5,6,50,220
ASSAM,NAGAON,2011,91,70,4,165,165,0,165,330,374,358,16,748,52,0,139,344,448,37,411,1431,279,100,75,3,84,716,1763,20,82,4,772,0,878,506,1670,5998
ASSAM,NALBARI,2011,20,10,1,31,28,0,28,56,95,83,12,190,21,1,19,100,210,7,203,561,18,25,54,0,9,370,524,4,95,0,140,0,239,48,564,1832
ASSAM,R.P.O.,2011,6,0,0,6,5,0,5,10,3,3,0,6,1,0,0,1,8,0,8,18,10,0,0,0,0,2,13,0,1,0,10,0,11,1,30,78
ASSAM,SIBSAGAR,2011,61,30,0,91,49,0,49,98,132,118,14,264,1,0,31,137,379,8,371,927,39,13,80,2,15,334,578,8,78,0,99,0,185,95,671,2254
ASSAM,SONITPUR,2011,84,14,2,100,96,0,96,192,262,231,31,524,11,0,19,181,386,14,372,983,58,31,87,0,19,267,805,12,34,0,346,0,392,343,1379,3631
ASSAM,TINSUKIA,2011,98,49,1,148,61,0,61,122,153,135,18,306,6,0,34,114,400,1,399,954,45,53,60,2,13,254,549,1,27,0,121,0,149,122,671,2285
ASSAM,UDALGURI,2011,37,11,0,48,28,0,28,56,67,63,4,134,5,0,12,62,74,1,73,227,8,11,18,0,13,139,236,1,10,0,45,0,56,47,366,954
BIHAR,ARARIA,2011,69,44,14,127,69,0,69,138,115,91,24,230,19,2,45,62,262,58,204,652,266,31,14,0,14,98,475,26,14,0,24,0,64,52,1674,2914
BIHAR,ARWAL,2011,23,69,8,100,5,0,5,10,17,9,8,34,2,0,6,22,85,12,73,200,49,8,21,0,8,72,192,24,8,0,8,0,40,34,330,799
BIHAR,AURANGABAD,2011,88,105,1,194,18,0,18,36,62,60,2,124,31,0,38,120,299,38,261,787,334,74,168,0,13,366,1127,30,32,0,152,0,214,172,1306,3409
BIHAR,BAGAHA,2011,38,45,6,89,16,1,15,32,62,48,14,124,2,0,13,43,135,3,132,328,137,37,100,0,11,184,542,13,8,0,15,0,36,73,685,1623
BIHAR,BANKA,2011,51,55,7,113,26,0,26,52,66,56,10,132,10,0,14,58,135,20,115,352,124,25,20,1,19,369,652,31,8,0,26,0,65,94,626,1765
BIHAR,BEGUSARAI,2011,100,40,2,142,17,0,17,34,119,94,25,238,12,0,40,67,345,120,225,809,257,40,87,0,20,595,1410,39,12,0,39,0,90,411,1178,3420
BIHAR,BETTIAH,2011,74,12,2,88,21,0,21,42,118,81,37,236,0,1,14,117,445,137,308,1022,245,49,77,1,16,226,703,32,7,0,67,0,106,89,2290,3903
BIHAR,BHABHUA,2011,57,62,2,121,9,0,9,18,57,36,21,114,4,4,29,61,219,99,120,536,157,14,34,0,30,255,569,33,32,0,17,0,82,79,870,2025
BIHAR,BHAGALPUR,2011,85,51,10,146,23,0,23,46,106,94,12,212,7,4,36,127,396,94,302,966,216,20,68,3,41,527,1169,12,10,0,17,0,39,294,971,3024
BIHAR,BHOJPUR,2011,96,41,4,141,16,0,16,32,64,48,16,128,13,10,35,76,351,85,266,836,140,77,91,2,13,328,780,40,2,0,72,0,114,129,1964,3564
BIHAR,BUXAR,2011,65,34,1,100,13,0,13,26,76,52,24,152,15,2,40,108,254,48,206,673,214,51,75,0,6,657,1071,37,6,0,59,0,102,68,455,2236
BIHAR,DARBHANGA,2011,71,92,43,206,34,0,34,68,128,97,31,256,15,4,17,82,447,147,300,1012,489,301,143,0,27,1155,2272,38,202,0,284,0,524,157,1658,5387
BIHAR,GAYA,2011,155,22,9,186,23,0,23,46,155,63,92,310,45,8,70,161,757,202,555,1798,262,35,137,1,17,1200,2147,56,7,0,47,0,110,495,1545,5207
BIHAR,GOPALGANJ,2011,77,169,0,246,17,0,17,34,139,106,33,278,6,0,10,65,225,86,139,531,276,17,166,0,26,576,1161,35,30,0,56,0,121,100,1344,3334
BIHAR,JAMALPUR RLY.,2011,6,0,2,8,0,0,0,0,3,0,3,6,5,0,2,2,190,7,183,389,6,0,1,0,0,0,7,0,2,0,1,0,3,0,70,290
BIHAR,JAMUI,2011,66,140,18,224,23,0,23,46,71,28,43,142,19,0,28,51,184,33,151,466,174,12,50,0,32,589,913,13,34,0,40,0,87,56,302,1902
BIHAR,JEHANABAD,2011,51,10,7,68,10,0,10,20,31,14,17,62,1,0,19,60,181,58,123,442,135,10,30,9,4,79,325,20,8,0,22,0,50,58,913,1658
BIHAR,KATIHAR,2011,83,82,3,168,103,0,103,206,126,102,24,252,17,1,29,53,292,46,246,684,238,60,95,5,7,1157,1673,29,10,0,25,1,65,111,1126,3653
BIHAR,KATIHAR RLY.,2011,17,1,0,18,2,0,2,4,8,0,8,16,0,0,7,9,191,3,188,398,7,1,4,1,0,39,57,0,4,0,2,0,6,5,92,390
BIHAR,KHAGARIA,2011,55,45,0,100,14,0,14,28,53,42,11,106,6,9,16,15,105,5,100,256,204,10,20,1,15,429,772,15,0,0,26,0,41,93,768,1899
BIHAR,KISHANGANJ,2011,34,5,0,39,30,0,30,60,63,60,3,126,11,0,10,43,179,40,139,422,122,32,5,0,0,194,400,13,20,0,50,0,83,47,367,1225
BIHAR,LAKHISARAI,2011,40,8,1,49,5,0,5,10,51,31,20,102,6,0,19,30,126,31,95,307,100,15,47,1,9,180,418,14,12,0,44,0,70,66,469,1243
BIHAR,MADHEPURA,2011,44,12,1,57,8,0,8,16,78,67,11,156,6,1,30,24,163,38,125,387,231,41,62,0,7,299,696,11,0,0,21,0,32,56,715,1810
BIHAR,MADHUBANI,2011,81,8,0,89,44,0,44,88,182,148,34,364,18,0,35,109,392,125,267,946,388,0,37,2,0,940,1460,35,0,0,138,0,173,93,2158,4660
BIHAR,MOTIHARI,2011,136,741,38,915,37,0,37,74,209,179,30,418,13,0,58,174,580,191,389,1405,641,89,135,10,33,1055,2019,69,8,0,57,0,134,56,3350,7489
BIHAR,MUNGER,2011,68,49,5,122,7,0,7,14,72,56,16,144,12,2,44,51,220,43,177,549,159,2,78,0,7,731,1022,10,2,0,49,0,61,45,368,1981
BIHAR,MUZAFFARPUR,2011,154,24,14,192,56,0,56,112,255,219,36,510,30,6,86,204,1134,373,761,2594,445,52,226,0,36,247,1353,76,4,0,91,2,173,347,3338,6827
BIHAR,MUZAFFARPUR RLY.,2011,11,2,1,14,0,0,0,0,6,4,2,12,8,0,6,6,267,36,231,554,10,2,10,0,0,7,38,1,11,0,0,0,12,9,167,524
BIHAR,NALANDA,2011,84,61,24,169,15,0,15,30,81,72,9,162,2,1,27,93,247,104,143,617,163,48,140,0,10,1116,1713,55,29,0,96,0,180,236,1999,4527
BIHAR,NAUGACHIA,2011,44,20,36,100,7,0,7,14,38,20,18,76,5,2,9,18,49,1,48,132,118,41,60,0,7,223,571,8,6,0,44,0,58,122,621,1478
BIHAR,NAWADAH,2011,74,29,5,108,12,0,12,24,63,33,30,126,16,8,21,45,180,49,131,450,197,26,79,2,5,176,599,21,35,0,57,0,113,114,1358,2523
BIHAR,PATNA,2011,248,25,4,277,41,0,41,82,364,167,197,728,52,10,161,545,2879,1321,1558,6526,534,21,686,20,3,1036,2811,112,1,2,317,0,432,511,6140,13712
BIHAR,PATNA RLY.,2011,16,10,2,28,1,0,1,2,6,0,6,12,7,5,17,6,770,76,694,1575,20,0,13,0,0,0,33,2,11,0,0,0,13,0,257,1143
BIHAR,PURNEA,2011,86,48,7,141,62,0,62,124,131,78,53,262,9,2,22,57,186,46,140,462,178,62,230,0,51,275,936,13,24,3,140,0,180,140,1606,3332
BIHAR,ROHTAS,2011,126,95,4,225,20,0,20,40,106,84,22,212,23,7,45,184,607,215,392,1473,249,29,85,0,59,1521,2318,32,46,0,57,0,135,375,533,4203
BIHAR,SAHARSA,2011,34,109,5,148,8,0,8,16,63,41,22,126,5,2,36,57,125,28,97,350,288,41,73,0,15,216,690,17,35,0,27,1,80,57,806,2020
BIHAR,SAMASTIPUR,2011,107,221,11,339,40,0,40,80,166,105,61,332,14,3,54,89,338,110,228,836,336,45,91,4,37,308,996,46,9,2,66,0,123,175,2054,4216
BIHAR,SARAN,2011,123,408,27,558,10,0,10,20,146,137,9,292,10,0,43,115,524,168,356,1216,428,61,76,0,28,646,1439,74,46,0,131,1,252,200,2103,5200
BIHAR,SHEIKHPURA,2011,33,8,0,41,3,0,3,6,22,14,8,44,3,0,5,20,95,22,73,218,47,22,44,0,5,188,373,8,0,0,35,0,43,67,426,1031
BIHAR,SHEOHAR,2011,13,23,1,37,4,0,4,8,25,20,5,50,25,0,8,15,45,8,37,138,55,14,9,0,5,324,418,5,3,1,15,0,24,11,13,614
BIHAR,SITAMARHI,2011,71,33,4,108,8,0,8,16,58,49,9,116,18,2,39,116,458,237,221,1091,229,6,20,0,20,44,413,29,14,0,33,0,76,94,2328,3624
BIHAR,SIWAN,2011,85,180,0,265,16,0,16,32,196,150,46,392,13,1,16,87,309,89,220,735,295,31,55,0,15,175,791,139,4,3,53,5,204,220,1510,3408
BIHAR,SUPAUL,2011,49,12,4,65,23,0,23,46,78,48,30,156,5,1,13,34,233,44,189,519,253,76,38,0,10,313,743,24,8,0,28,0,60,53,788,2043
BIHAR,VAISHALI,2011,110,77,15,202,18,0,18,36,233,147,86,466,16,7,69,148,688,345,343,1616,352,113,76,1,24,276,1055,76,26,0,59,0,161,213,2064,4661
CHHATTISGARH,BALRAMPUR,2011,39,27,2,68,55,0,55,110,2,0,2,4,6,0,6,30,19,0,19,80,29,1,9,0,5,100,187,3,52,0,23,0,78,43,457,908
CHHATTISGARH,BILASPUR,2011,112,43,2,157,70,0,70,140,24,16,8,48,1,1,57,401,587,217,370,1634,153,12,84,8,26,1874,2400,17,146,4,72,0,239,243,1509,5446
CHHATTISGARH,BIZAPUR,2011,60,91,1,152,4,0,4,8,4,2,2,8,5,0,2,11,15,2,13,48,0,0,8,0,9,5,31,0,5,0,3,0,8,9,93,325
CHHATTISGARH,DANTEWARA,2011,54,69,0,123,8,0,8,16,9,7,2,18,12,0,2,26,42,18,24,124,31,5,12,0,13,29,141,0,10,1,9,0,20,51,291,674
CHHATTISGARH,DHAMTARI,2011,13,7,0,20,27,0,27,54,18,18,0,36,0,0,7,109,81,29,52,278,12,4,34,1,4,61,206,4,44,3,16,0,67,90,655,1190
CHHATTISGARH,DURG,2011,93,91,8,192,115,0,115,230,115,86,29,230,4,2,83,614,945,298,647,2593,75,16,174,13,36,226,945,13,291,43,131,1,479,405,7724,11218
CHHATTISGARH,GARIYABAND,2011,28,14,0,42,21,0,21,42,4,1,3,8,3,0,2,34,38,15,23,115,6,0,6,0,9,267,325,5,30,1,8,0,44,37,174,687
CHHATTISGARH,GRP RAIPUR,2011,4,0,0,4,2,0,2,4,0,0,0,0,0,0,2,5,193,6,187,393,2,0,2,0,1,12,20,1,1,0,1,0,3,3,48,277
CHHATTISGARH,JAGDALPUR,2011,66,22,1,89,68,0,68,136,9,9,0,18,3,0,11,111,102,60,42,329,28,6,18,2,12,732,974,0,29,3,19,0,51,176,844,2262
CHHATTISGARH,JANJGIR,2011,43,26,1,70,33,0,33,66,13,10,3,26,1,1,44,202,314,133,181,876,120,14,40,4,24,1194,1555,15,114,15,104,0,248,159,854,3335
CHHATTISGARH,JASHPUR,2011,78,14,0,92,78,0,78,156,49,33,16,98,2,0,14,59,80,24,56,235,19,12,32,3,4,88,226,1,69,2,36,0,108,68,604,1312
CHHATTISGARH,KABIRDHAM,2011,16,18,2,36,23,0,23,46,16,16,0,32,0,0,5,81,83,25,58,252,37,4,39,1,3,523,663,2,43,7,14,0,66,56,444,1417
CHHATTISGARH,KANKER,2011,51,26,1,78,29,0,29,58,8,4,4,16,8,0,8,28,36,13,23,116,30,5,7,0,15,30,148,4,14,2,10,0,30,61,556,929
CHHATTISGARH,KORBA,2011,34,13,0,47,39,0,39,78,5,2,3,10,2,1,36,148,229,120,109,645,64,3,22,7,16,706,960,5,86,12,48,0,151,142,830,2448
CHHATTISGARH,KORIYA,2011,45,20,0,65,72,0,72,144,16,11,5,32,1,0,10,138,104,50,54,357,21,3,31,1,2,536,657,3,95,1,55,1,155,63,472,1690
CHHATTISGARH,MAHASAMUND,2011,22,14,0,36,30,0,30,60,37,35,2,74,1,0,14,136,183,62,121,517,40,2,51,2,9,114,368,2,65,11,31,0,109,150,1226,2140
CHHATTISGARH,NARAYANPUR,2011,29,34,0,63,5,0,5,10,2,0,2,4,8,0,1,5,5,3,2,24,0,0,1,0,5,25,45,0,2,1,0,0,3,14,42,179
CHHATTISGARH,RAIGARH,2011,87,51,5,143,62,0,62,124,15,10,5,30,1,0,33,242,373,209,164,1022,66,15,64,7,13,688,1022,11,84,6,32,0,133,169,1000,3024
CHHATTISGARH,RAIPUR,2011,95,84,2,181,133,0,133,266,55,35,20,110,7,0,74,776,1441,815,626,3739,137,60,239,9,50,3161,4175,11,232,53,100,0,396,519,3414,10652
CHHATTISGARH,RAJNANDGAON,2011,43,34,1,78,38,0,38,76,22,21,1,44,0,2,23,169,166,87,79,526,20,11,26,7,16,91,352,4,70,3,23,0,100,181,2183,3133
CHHATTISGARH,SARGUJA,2011,54,33,1,88,65,0,65,130,32,32,0,64,3,0,24,143,186,81,105,542,28,2,38,0,9,84,268,0,114,3,36,0,153,107,1350,2312
CHHATTISGARH,SURAJPUR,2011,44,16,1,61,76,0,76,152,17,17,0,34,0,0,12,80,93,25,68,278,16,5,43,0,8,559,741,3,58,3,63,0,127,110,453,1660
GOA,NORTH GOA,2011,33,10,0,43,13,0,13,26,14,8,6,28,1,0,15,172,676,279,397,1540,45,28,88,22,18,131,484,1,20,9,10,0,40,152,598,2056
GOA,SOUTH GOA,2011,15,12,6,33,16,0,16,32,14,9,5,28,1,0,11,146,439,184,255,1036,29,17,54,9,6,84,310,0,9,3,8,0,20,111,403,1393
GUJARAT,AHMEDABAD COMMR.,2011,95,69,2,166,60,0,60,120,230,184,46,460,31,0,720,831,3874,2308,1566,9330,156,312,288,10,6,1427,2386,19,83,16,1390,0,1508,187,10397,20203
GUJARAT,AHMEDABAD RURAL,2011,36,16,3,55,10,0,10,20,74,71,3,148,16,0,37,130,319,136,183,821,90,88,24,8,7,338,1022,1,22,0,131,0,154,467,1871,3688
GUJARAT,AHWA-DANG,2011,6,3,0,9,1,0,1,2,0,0,0,0,0,0,0,8,13,9,4,34,0,1,1,1,1,16,48,1,1,0,8,0,10,28,138,227
GUJARAT,AMRELI,2011,26,3,2,31,10,0,10,20,79,77,2,158,1,0,12,101,134,56,78,382,44,39,16,8,6,231,502,0,28,1,143,0,172,158,1084,2126
GUJARAT,ANAND,2011,19,4,3,26,10,0,10,20,45,42,3,90,4,1,8,116,358,237,121,845,37,35,21,5,11,299,692,0,20,0,196,0,216,284,1678,3154
GUJARAT,BHARUCH,2011,34,10,0,44,13,0,13,26,28,27,1,56,9,0,14,124,341,177,164,829,51,86,13,8,4,235,709,0,9,0,4,0,13,312,1636,2931
GUJARAT,BHAVNAGAR,2011,55,26,2,83,8,0,8,16,88,88,0,176,1,2,25,149,449,232,217,1075,81,21,45,22,15,486,670,0,35,33,181,0,249,0,2533,4257
GUJARAT,CID CRIME,2011,1,0,0,1,0,0,0,0,0,0,0,0,0,0,0,0,1,0,1,2,0,5,4,0,0,0,9,0,0,0,0,0,0,0,1,12
GUJARAT,DAHOD,2011,41,11,3,55,6,0,6,12,53,48,5,106,15,3,29,107,214,122,92,582,49,6,11,2,21,711,974,0,11,0,14,0,25,174,429,1910
GUJARAT,GANDHINAGAR,2011,27,9,1,37,14,0,14,28,21,16,5,42,6,0,20,121,447,216,231,1041,38,13,45,10,4,197,567,0,16,1,132,0,149,260,4334,5716
GUJARAT,HIMATNAGAR,2011,35,5,2,42,10,0,10,20,48,46,2,96,6,1,8,101,244,114,130,604,46,35,36,9,9,151,584,0,29,4,229,0,262,298,3361,4667
GUJARAT,JAMNAGAR,2011,40,25,1,66,21,0,21,42,65,51,14,130,10,5,20,196,460,193,267,1151,124,49,47,2,5,479,707,0,34,8,356,0,398,1,3178,5126
GUJARAT,JUNAGADH,2011,31,13,0,44,11,0,11,22,69,68,1,138,4,0,13,157,380,233,147,934,95,21,35,8,16,445,831,1,26,4,423,0,454,211,2233,4196
GUJARAT,KHEDA NORTH,2011,45,8,1,54,12,0,12,24,53,48,5,106,7,0,13,82,211,101,110,524,30,24,37,12,6,280,666,0,14,0,132,0,146,277,3624,4868
GUJARAT,KUTCH (EAST(G)),2011,35,11,0,46,8,0,8,16,24,17,7,48,3,1,22,96,256,116,140,634,34,18,24,3,4,233,316,2,13,1,137,0,153,0,1701,2626
GUJARAT,KUTCH (WEST-BHUJ),2011,24,12,1,37,15,0,15,30,15,15,0,30,2,0,6,106,212,112,100,538,46,31,13,3,6,165,270,0,14,0,108,0,122,6,1134,1919
GUJARAT,MEHSANA,2011,28,15,1,44,9,0,9,18,71,63,8,142,8,0,30,185,581,266,315,1385,67,58,47,15,15,446,870,2,20,2,242,0,266,222,2304,4368
GUJARAT,NARMADA,2011,14,2,2,18,7,0,7,14,4,4,0,8,1,0,0,9,14,11,3,38,7,7,3,0,0,82,175,0,3,0,5,0,8,76,389,625
GUJARAT,NAVSARI,2011,21,9,1,31,2,0,2,4,10,10,0,20,3,0,8,62,142,74,68,357,19,24,13,8,2,63,129,0,6,2,31,0,39,0,944,1370
GUJARAT,PALANPUR,2011,52,22,0,74,38,0,38,76,92,87,5,184,7,0,62,217,400,193,207,1086,66,33,47,11,25,505,989,1,64,1,349,0,415,302,2979,5273
GUJARAT,PANCHMAHAL,2011,49,17,1,67,10,0,10,20,60,57,3,120,15,3,15,107,184,90,94,508,38,41,21,7,18,279,404,0,33,0,249,0,282,0,2393,3540
GUJARAT,PATAN,2011,16,15,0,31,16,0,16,32,47,44,3,94,9,0,22,89,282,96,186,684,44,35,18,6,20,373,650,0,43,1,156,0,200,154,1801,3147
GUJARAT,PORBANDAR,2011,10,9,1,20,6,0,6,12,12,9,3,24,0,1,3,30,76,38,38,186,13,26,10,5,2,82,179,0,1,1,84,0,86,41,459,872
GUJARAT,RAJKOT COMMR.,2011,44,22,0,66,10,0,10,20,40,34,6,80,3,0,36,187,923,733,190,2072,67,67,42,7,12,360,716,0,17,3,246,0,266,161,1692,3939
GUJARAT,RAJKOT RURAL,2011,41,23,4,68,23,0,23,46,75,69,6,150,6,0,20,142,257,132,125,682,60,65,21,4,11,273,787,2,21,6,279,0,308,353,2896,4582
GUJARAT,SURAT COMMR.,2011,100,38,2,140,36,0,36,72,112,83,29,224,12,4,78,356,1830,1263,567,4110,64,34,191,42,4,455,1031,0,34,3,276,0,313,241,4534,8446
GUJARAT,SURAT RURAL,2011,36,8,1,45,6,0,6,12,16,14,2,32,14,0,16,79,301,123,178,711,31,22,53,3,6,149,761,0,9,0,55,0,64,497,2106,3408
GUJARAT,SURENDRANAGAR,2011,32,15,1,48,19,0,19,38,44,41,3,88,5,0,13,104,216,105,111,554,58,35,12,7,7,441,808,0,28,4,129,0,161,248,1619,3037
GUJARAT,TAPI,2011,13,2,4,19,2,0,2,4,2,2,0,4,1,0,1,16,82,23,59,182,10,13,7,4,2,177,333,0,3,0,9,0,12,120,248,716
GUJARAT,VADODARA COMMR.,2011,21,27,2,50,9,0,9,18,50,44,6,100,13,1,83,295,1506,1006,500,3404,78,31,170,10,5,315,765,1,15,2,240,0,258,156,2697,5727
GUJARAT,VADODARA RURAL,2011,52,17,2,71,28,0,28,56,65,62,3,130,6,0,15,69,204,127,77,498,41,23,23,11,3,251,679,0,19,0,95,0,114,327,1882,3133
GUJARAT,VALSAD,2011,35,11,0,46,9,0,9,18,19,19,0,38,2,0,7,127,366,231,135,868,25,32,22,5,10,140,497,0,6,0,23,0,29,263,1430,2532
GUJARAT,W.RLY AHMEDABAD,2011,7,0,0,7,0,0,0,0,2,1,1,4,0,0,5,8,212,20,192,437,6,3,9,0,0,24,42,0,6,0,0,0,6,0,43,325
GUJARAT,W.RLY VADODARA,2011,5,1,0,6,0,0,0,0,1,1,0,2,1,2,7,2,554,41,513,1120,0,6,30,0,0,51,90,0,2,0,0,0,2,3,40,705
HARYANA,AMBALA,2011,42,33,4,79,37,0,37,74,34,23,11,68,8,18,29,410,655,384,271,1775,0,48,114,0,4,177,347,5,28,20,191,0,244,4,1108,2969
HARYANA,BHIWANI,2011,74,42,2,118,41,0,41,82,43,30,13,86,12,5,25,274,675,481,194,1666,172,25,112,0,18,233,572,18,26,12,97,0,153,12,1097,3015
HARYANA,FARIDABAD,2011,60,59,5,124,54,0,54,108,105,82,23,210,10,40,37,356,1917,1439,478,4277,173,160,42,1,9,213,827,10,31,59,218,0,318,229,1569,5357
HARYANA,FATEHABAD,2011,25,24,0,49,15,0,15,30,25,18,7,50,5,5,5,125,266,204,62,672,30,1,54,2,2,115,207,7,6,8,86,0,107,3,525,1334
HARYANA,GRP,2011,26,8,0,34,0,0,0,0,2,2,0,4,6,5,18,4,520,99,421,1073,27,2,8,0,0,12,66,4,2,130,0,0,136,17,474,1265
HARYANA,GURGAON,2011,89,57,4,150,40,0,40,80,49,37,12,98,12,33,79,535,3345,2800,545,7349,112,84,221,2,7,100,544,25,27,29,107,0,188,18,1665,6640
HARYANA,HISSAR,2011,73,77,2,152,36,0,36,72,83,62,21,166,8,0,45,388,1167,797,370,2775,102,21,250,1,17,266,671,14,37,18,248,0,317,14,1504,4371
HARYANA,JHAJJAR,2011,59,43,3,105,32,0,32,64,31,19,12,62,10,2,31,157,468,277,191,1136,81,16,62,0,9,92,503,12,20,26,117,0,175,243,548,2062
HARYANA,JIND,2011,50,34,4,88,37,0,37,74,32,28,4,64,0,0,34,252,604,404,200,1494,105,78,43,0,9,122,360,15,15,13,91,0,134,3,730,2271
HARYANA,KAITHAL,2011,36,23,4,63,20,0,20,40,23,17,6,46,7,3,14,218,350,200,150,942,0,53,37,2,7,192,305,8,18,0,119,0,145,14,707,1855
HARYANA,KARNAL,2011,46,48,5,99,62,0,62,124,22,18,4,44,7,18,25,218,813,635,178,1894,52,12,131,0,5,238,662,18,25,26,166,0,235,224,1041,3202
HARYANA,KURUKSHETRA,2011,29,21,2,52,29,0,29,58,34,30,4,68,7,1,18,216,534,397,137,1310,0,68,59,1,3,176,307,7,22,20,68,0,117,0,836,2151
HARYANA,MAHENDRAGARH,2011,33,22,1,56,26,0,26,52,46,38,8,92,14,3,20,184,496,266,230,1213,73,25,10,0,13,147,275,11,22,0,85,0,118,7,773,2011
HARYANA,MEWAT,2011,22,36,3,61,28,0,28,56,32,23,9,64,6,3,16,38,358,286,72,779,80,16,40,1,4,80,226,7,9,3,119,0,138,5,1064,1970
HARYANA,PALWAL,2011,43,55,2,100,54,0,54,108,54,43,11,108,4,2,22,77,627,447,180,1359,158,39,15,0,3,134,355,13,32,0,75,0,120,6,981,2396
HARYANA,PANCHKULA,2011,18,13,0,31,17,0,17,34,17,15,2,34,4,0,14,161,413,295,118,1005,0,4,45,2,0,32,86,2,9,0,77,0,88,3,641,1472
HARYANA,PANIPAT,2011,49,26,8,83,47,0,47,94,90,70,20,180,11,9,39,179,946,816,130,2130,126,20,132,1,4,145,657,11,29,19,163,0,222,229,909,3192
HARYANA,REWARI,2011,41,28,0,69,17,0,17,34,26,19,7,52,12,2,38,217,595,464,131,1459,45,50,19,0,10,137,266,7,19,34,94,0,154,5,1008,2404
HARYANA,ROHTAK,2011,77,50,1,128,57,0,57,114,47,32,15,94,11,14,53,340,859,613,246,2136,100,30,127,0,17,176,639,9,38,52,124,0,223,189,923,3294
HARYANA,SIRSA,2011,42,31,3,76,21,0,21,42,60,49,11,120,4,3,14,233,622,347,275,1498,29,22,42,4,12,256,374,16,26,0,170,0,212,9,752,2371
HARYANA,SONIPAT,2011,78,65,6,149,27,0,27,54,54,42,12,108,3,7,43,190,708,478,230,1659,1,26,115,0,4,197,611,23,19,15,156,0,213,268,949,2954
HARYANA,YAMUNANAGAR,2011,50,56,1,107,36,0,36,72,50,36,14,100,6,3,19,239,487,412,75,1241,0,12,83,1,9,183,291,13,14,6,169,0,202,3,745,2185
HIMACHAL PRADESH,BADDIPOLICEDIST,2011,6,5,0,11,8,0,8,16,17,15,2,34,0,0,0,56,66,36,30,188,26,29,16,0,1,155,273,0,7,0,9,0,16,46,132,579
HIMACHAL PRADESH,BILASPUR,2011,8,2,0,10,8,0,8,16,3,3,0,6,0,0,0,43,56,27,29,155,43,9,34,0,14,56,192,0,18,9,17,0,44,36,721,1077
HIMACHAL PRADESH,CHAMBA,2011,15,2,1,18,6,0,6,12,19,18,1,38,0,0,1,93,29,3,26,152,27,8,11,0,7,88,189,2,29,3,10,0,44,48,279,678
HIMACHAL PRADESH,CID,2011,0,0,0,0,0,0,0,0,0,0,0,0,0,0,0,0,0,0,0,0,0,0,0,0,0,0,0,0,0,0,0,0,0,0,2,2
HIMACHAL PRADESH,G.R.P.,2011,0,0,0,0,0,0,0,0,0,0,0,0,0,0,0,1,7,0,7,15,0,0,0,0,0,1,1,0,0,0,0,0,0,0,15,24
HIMACHAL PRADESH,HAMIRPUR,2011,3,5,0,8,5,0,5,10,8,7,1,16,0,0,0,29,35,13,22,99,21,6,16,0,5,182,257,0,17,12,5,0,34,27,417,793
HIMACHAL PRADESH,KANGRA,2011,21,7,2,30,32,0,32,64,68,55,13,136,0,0,4,219,171,46,125,565,85,12,80,3,20,186,393,1,60,12,42,0,115,7,1677,2709
HIMACHAL PRADESH,KINNAUR,2011,2,1,0,3,6,0,6,12,1,1,0,2,0,0,0,18,14,1,13,46,10,2,1,0,0,9,50,1,4,0,1,0,6,28,64,162
HIMACHAL PRADESH,KULLU,2011,13,2,0,15,20,0,20,40,13,12,1,26,0,0,0,68,67,15,52,202,23,10,26,0,3,39,137,0,38,2,21,0,61,36,553,934
HIMACHAL PRADESH,LAHAUL-SPITI,2011,0,0,0,0,1,0,1,2,0,0,0,0,0,0,0,1,1,0,1,3,0,0,0,0,1,1,7,0,0,0,0,0,0,5,92,102
HIMACHAL PRADESH,MANDI,2011,13,5,0,18,26,0,26,52,17,16,1,34,0,0,0,100,92,22,70,284,81,5,46,0,18,95,298,0,55,12,40,0,107,53,982,1640
HIMACHAL PRADESH,SHIMLA,2011,20,10,2,32,22,0,22,44,24,24,0,48,0,0,2,171,250,75,175,673,83,25,49,0,24,47,331,0,45,5,16,0,66,103,1968,2866
HIMACHAL PRADESH,SIRMAUR,2011,9,4,0,13,12,0,12,24,17,17,0,34,0,0,1,61,71,38,33,204,64,7,15,0,1,41,188,0,33,1,23,0,57,60,446,866
HIMACHAL PRADESH,SOLAN,2011,14,3,0,17,11,0,11,22,13,13,0,26,1,0,1,89,115,53,62,321,35,20,24,0,7,262,391,0,8,0,16,0,24,43,297,959
HIMACHAL PRADESH,UNA,2011,6,4,1,11,11,0,11,22,12,10,2,24,0,0,1,46,68,27,41,183,32,10,41,1,9,89,253,0,17,6,39,0,62,71,457,921
JAMMU & KASHMIR,ANANTNAG,2011,7,7,0,14,18,0,18,36,112,108,4,224,1,0,9,109,143,30,113,405,139,15,47,3,13,4,249,0,134,46,6,0,186,28,643,1484
JAMMU & KASHMIR,AWANTIPORA,2011,6,6,0,12,4,0,4,8,26,26,0,52,0,0,4,25,37,5,32,103,22,4,8,3,1,0,60,0,13,5,3,0,21,22,320,509
JAMMU & KASHMIR,BANDIPORA,2011,3,8,2,13,1,0,1,2,59,57,2,118,0,0,2,39,76,4,72,193,83,3,4,0,7,0,97,0,61,5,3,0,69,0,221,577
JAMMU & KASHMIR,BARAMULLA,2011,6,14,0,20,12,0,12,24,77,73,4,154,1,0,3,87,91,7,84,273,68,7,18,5,11,2,111,0,94,23,1,0,118,0,596,1116
JAMMU & KASHMIR,BUDGAM,2011,5,10,3,18,8,0,8,16,101,100,1,202,0,0,4,99,212,28,184,527,166,7,24,2,12,5,227,0,94,27,2,0,123,11,515,1307
JAMMU & KASHMIR,CRIME JAMMU,2011,0,0,0,0,0,0,0,0,0,0,0,0,0,0,0,0,0,0,0,0,0,0,16,0,0,0,16,0,0,0,0,0,0,0,0,16
JAMMU & KASHMIR,CRIME SRINAGAR,2011,0,0,0,0,0,0,0,0,0,0,0,0,0,0,0,0,0,0,0,0,0,0,23,0,0,0,23,0,0,0,0,0,0,0,0,23
JAMMU & KASHMIR,DODA,2011,8,14,0,22,16,0,16,32,47,43,4,94,0,0,0,42,44,2,42,130,27,4,14,0,10,8,66,0,25,7,20,0,52,3,417,706
JAMMU & KASHMIR,GANDERBAL,2011,4,4,2,10,9,0,9,18,32,30,2,64,4,0,0,32,43,5,38,122,68,3,12,1,5,2,99,0,57,1,1,0,59,8,235,523
JAMMU & KASHMIR,HANDWARA,2011,4,18,0,22,6,0,6,12,33,33,0,66,0,0,2,23,57,5,52,139,54,8,7,0,9,0,88,0,76,14,1,0,91,10,213,535
JAMMU & KASHMIR,JAMMU,2011,18,83,2,103,35,0,35,70,68,61,7,136,0,0,2,256,620,340,280,1498,56,41,110,3,17,18,365,3,38,45,51,0,137,120,2532,4118
JAMMU & KASHMIR,KARGIL,2011,3,0,0,3,1,0,1,2,1,1,0,2,0,0,0,2,5,0,5,12,9,0,4,0,2,1,16,0,2,0,2,0,4,0,82,114
JAMMU & KASHMIR,KATHUA,2011,10,20,2,32,17,0,17,34,38,32,6,76,0,0,1,60,78,30,48,217,37,7,14,0,4,10,76,5,32,8,19,0,64,4,804,1170
JAMMU & KASHMIR,KISHTWAR,2011,3,15,1,19,4,0,4,8,25,25,0,50,0,0,1,19,19,1,18,58,0,1,10,0,7,0,19,0,12,1,16,0,29,1,285,420
JAMMU & KASHMIR,KULGAM,2011,3,13,1,17,10,0,10,20,46,44,2,92,2,0,6,42,70,15,55,190,52,10,17,2,7,51,166,0,68,12,1,0,81,27,246,686
JAMMU & KASHMIR,KUPWARA,2011,9,23,3,35,11,0,11,22,46,45,1,92,0,0,1,50,76,11,65,203,148,8,18,4,14,7,205,0,45,11,4,0,60,6,283,767
JAMMU & KASHMIR,LEH,2011,0,1,0,1,3,0,3,6,1,0,1,2,0,0,0,11,4,0,4,19,4,8,4,2,0,1,19,0,7,1,0,0,8,0,142,189
JAMMU & KASHMIR,POONCH,2011,4,20,4,28,18,0,18,36,32,32,0,64,0,0,0,32,33,2,31,98,103,3,22,3,14,54,205,0,31,7,29,0,67,6,407,822
JAMMU & KASHMIR,PULWAMA,2011,7,9,1,17,5,0,5,10,39,34,5,78,1,0,2,25,57,9,48,142,67,9,6,2,7,44,145,0,11,7,0,0,18,10,134,443
JAMMU & KASHMIR,RAILWAYS JAMMU,2011,0,1,0,1,0,0,0,0,0,0,0,0,0,0,0,0,4,1,3,8,0,0,3,0,1,0,6,0,0,0,0,0,0,2,4,15
JAMMU & KASHMIR,RAILWAYS KASHMIR,2011,0,0,0,0,0,0,0,0,0,0,0,0,0,0,0,0,10,0,10,20,2,0,2,0,0,0,4,0,0,1,0,0,1,0,12,27
JAMMU & KASHMIR,RAJOURI,2011,9,39,5,53,32,0,32,64,43,43,0,86,1,0,0,47,63,13,50,174,33,16,35,1,14,14,162,1,30,4,49,0,84,49,1347,1832
JAMMU & KASHMIR,RAMBAN,2011,6,5,0,11,13,0,13,26,16,15,1,32,0,0,0,17,40,13,27,97,4,5,8,0,3,1,21,0,12,4,0,0,16,0,627,761
JAMMU & KASHMIR,REASI,2011,6,15,0,21,11,0,11,22,17,15,2,34,0,0,1,19,34,7,27,88,7,3,15,1,1,4,31,0,11,5,1,0,17,0,430,581
JAMMU & KASHMIR,SAMBA,2011,9,17,0,26,3,0,3,6,11,11,0,22,0,0,0,29,38,14,24,105,18,3,12,0,2,3,39,2,6,17,5,0,30,1,567,743
JAMMU & KASHMIR,SHOPIAN,2011,3,33,0,36,8,0,8,16,29,29,0,58,2,0,9,41,149,10,139,350,36,6,7,0,11,4,70,0,77,8,0,0,85,6,200,629
JAMMU & KASHMIR,SOPORE,2011,14,42,1,57,4,0,4,8,42,38,4,84,0,0,6,81,109,15,94,305,16,4,11,3,6,2,42,0,58,9,5,0,72,0,159,572
JAMMU & KASHMIR,SRINAGAR,2011,12,64,0,76,14,0,14,28,118,110,8,236,2,0,33,280,490,344,146,1295,147,17,126,4,23,9,397,0,171,70,54,0,295,71,1051,2756
JAMMU & KASHMIR,UDHAMPUR,2011,10,13,2,25,14,0,14,28,18,18,0,36,0,0,2,49,53,19,34,157,39,3,15,0,4,2,63,0,29,12,13,0,54,0,785,1063
JHARKHAND,BOKARO,2011,62,19,0,81,46,0,46,92,57,57,0,114,14,0,39,105,734,161,573,1626,114,61,60,3,0,0,238,13,4,0,102,0,119,0,1540,2973
JHARKHAND,CHAIBASA,2011,136,22,0,158,32,0,32,64,14,14,0,28,13,0,19,24,119,47,72,294,16,15,6,0,2,28,145,6,5,0,11,0,22,78,298,844
JHARKHAND,CHATRA,2011,50,15,0,65,12,0,12,24,22,17,5,44,16,0,30,22,95,20,75,258,85,3,20,0,6,12,220,15,1,0,9,0,25,94,418,925
JHARKHAND,DEOGHAR,2011,48,66,3,117,34,0,34,68,24,10,14,48,10,1,27,88,278,66,212,682,127,9,45,2,4,424,696,18,16,1,24,0,59,85,172,1506
JHARKHAND,DHANBAD,2011,79,18,12,109,32,0,32,64,99,83,16,198,37,5,60,160,852,401,451,1966,214,74,67,8,5,229,599,39,34,0,39,0,112,2,1643,3708
JHARKHAND,DHANBAD RLY.,2011,4,0,0,4,0,0,0,0,3,1,2,6,3,1,6,1,207,15,192,425,3,0,4,0,0,0,7,3,8,0,1,0,12,0,140,384
JHARKHAND,DUMKA,2011,59,29,5,93,34,0,34,68,28,18,10,56,6,0,13,56,292,41,251,659,81,12,28,0,13,217,437,7,19,0,40,0,66,86,537,1562
JHARKHAND,GARHWA,2011,70,61,4,135,51,0,51,102,33,26,7,66,7,0,28,50,62,27,35,209,210,27,82,1,13,527,919,19,22,0,89,1,131,59,449,1865
JHARKHAND,GIRIDIH,2011,60,8,1,69,47,0,47,94,63,41,22,126,28,2,23,108,390,87,303,941,263,12,64,0,5,118,588,30,40,2,35,5,112,126,988,2418
JHARKHAND,GODDA,2011,61,0,3,64,29,0,29,58,38,8,30,76,8,3,9,44,87,1,86,238,26,14,17,0,6,23,99,0,21,0,10,0,31,13,851,1263
JHARKHAND,GUMLA,2011,201,52,7,260,46,0,46,92,52,27,25,104,5,5,44,23,100,37,63,277,40,4,38,0,16,55,255,1,10,0,17,0,28,102,218,1036
JHARKHAND,HAZARIBAGH,2011,72,41,6,119,22,0,22,44,58,52,6,116,18,7,28,59,315,111,204,742,138,15,71,0,3,392,623,26,25,0,22,0,73,4,960,2282
JHARKHAND,JAMSHEDPUR,2011,85,29,12,126,39,0,39,78,73,54,19,146,11,0,36,153,832,379,453,1864,114,85,55,0,21,695,1136,17,32,0,76,0,125,166,575,3106
JHARKHAND,JAMSHEDPUR RLY.,2011,8,0,0,8,1,0,1,2,8,8,0,16,0,0,11,2,151,21,130,315,0,3,1,0,0,13,17,0,5,0,0,0,5,0,48,251
JHARKHAND,JAMTARA,2011,15,19,0,34,15,0,15,30,11,11,0,22,2,0,7,22,90,3,87,211,51,11,24,0,5,144,243,10,10,0,19,0,39,8,245,708
JHARKHAND,KHUNTI,2011,126,21,0,147,13,0,13,26,13,3,10,26,8,0,21,9,41,11,30,120,13,5,7,0,2,19,94,0,4,0,1,0,5,48,52,403
JHARKHAND,KODERMA,2011,25,40,1,66,7,0,7,14,24,19,5,48,5,0,12,26,140,37,103,323,88,20,69,0,0,150,375,16,7,0,34,0,57,48,378,1090
JHARKHAND,LATEHAR,2011,38,29,0,67,27,0,27,54,27,12,15,54,7,0,9,13,69,16,53,167,64,5,10,0,6,35,173,2,4,0,11,0,17,53,104,513
JHARKHAND,LOHARDAGGA,2011,33,9,1,43,30,0,30,60,26,12,14,52,5,4,12,17,118,19,99,274,25,0,33,1,6,87,206,3,2,0,13,0,18,54,143,622
JHARKHAND,PAKUR,2011,30,1,5,36,39,0,39,78,19,8,11,38,6,0,2,8,113,29,84,242,74,8,6,3,5,293,408,0,6,0,22,0,28,19,62,721
JHARKHAND,PALAMU,2011,93,72,0,165,28,0,28,56,63,34,29,126,31,0,47,78,246,96,150,648,180,9,49,0,5,244,574,28,6,0,12,0,46,87,755,2033
JHARKHAND,RAMGARH,2011,32,23,0,55,24,0,24,48,31,23,8,62,20,6,26,22,249,70,179,572,34,13,24,4,2,138,308,7,8,0,3,0,18,93,220,979
JHARKHAND,RANCHI,2011,151,38,6,195,50,0,50,100,66,54,12,132,29,4,54,69,451,89,362,1058,91,20,42,0,3,338,729,8,9,2,14,0,33,235,542,2222
JHARKHAND,SAHEBGANJ,2011,73,39,11,123,71,0,71,142,54,37,17,108,8,0,15,20,101,6,95,245,54,7,50,0,7,91,272,5,4,0,32,0,41,63,423,1128
JHARKHAND,SARAIKELA,2011,64,43,6,113,30,0,30,60,16,16,0,32,9,0,26,46,198,66,132,477,27,5,24,0,0,85,312,8,9,2,13,0,32,171,118,900
JHARKHAND,SIMDEGA,2011,72,24,0,96,25,0,25,50,19,15,4,38,3,2,10,10,48,16,32,121,1,10,11,0,3,46,105,1,6,0,10,0,17,34,61,396
KERALA,ALAPUZHA,2011,25,17,2,44,56,0,56,112,15,10,5,30,1,2,35,156,268,42,226,730,473,29,321,5,12,2103,2947,1,245,76,310,0,632,4,5771,9927
KERALA,ERNAKULAM COMMR.,2011,26,25,11,62,62,0,62,124,11,4,7,22,6,2,31,138,287,74,213,751,502,8,192,6,8,954,1673,1,149,44,225,0,419,3,10501,13192
KERALA,ERNAKULAM RURAL,2011,15,14,0,29,30,0,30,60,12,11,1,24,6,34,38,77,307,71,236,769,343,23,630,1,5,376,1380,0,105,32,136,0,273,2,32452,34638
KERALA,IDUKKI,2011,20,31,1,52,54,0,54,108,10,8,2,20,3,0,23,160,161,45,116,508,296,21,109,2,8,1307,1743,0,169,18,237,0,424,0,3566,6196
KERALA,KANNUR,2011,20,45,3,68,55,0,55,110,14,11,3,28,6,4,94,221,257,98,159,839,1065,11,189,1,61,1408,2739,0,161,23,373,0,557,4,3974,7989
KERALA,KASARGOD,2011,19,21,3,43,125,0,125,250,15,8,7,30,5,0,35,129,125,58,67,419,607,8,179,0,53,985,1835,0,136,10,196,0,342,3,1288,3942
KERALA,KOLLAM COMMR.,2011,14,41,3,58,51,0,51,102,21,20,1,42,4,21,16,105,227,90,137,600,602,16,86,5,18,1146,1874,1,192,19,319,0,531,1,3449,6357
KERALA,KOLLAM RURAL,2011,29,25,2,56,46,0,46,92,13,10,3,26,1,7,24,164,170,43,127,536,460,7,126,0,16,1500,2120,0,255,8,298,0,561,11,3374,6536
KERALA,KOTTAYAM,2011,22,50,5,77,51,0,51,102,24,21,3,48,3,0,30,161,281,101,180,756,485,23,198,6,28,1406,2146,2,258,31,285,0,576,0,5099,8448
KERALA,KOZHIKODE COMMR.,2011,5,15,0,20,14,0,14,28,11,10,1,22,0,30,48,136,241,106,135,696,446,30,191,2,10,685,1364,0,124,100,171,0,395,0,1737,3996
KERALA,KOZHIKODE RURAL,2011,12,31,1,44,46,0,46,92,21,16,5,42,2,1,27,134,157,69,88,478,997,6,164,0,96,1124,2389,1,179,13,322,0,515,2,4073,7409
KERALA,MALAPPURAM,2011,13,17,8,38,83,0,83,166,24,12,12,48,8,3,59,249,380,158,222,1079,822,33,392,2,10,898,2161,0,232,27,661,0,920,4,9101,13026
KERALA,PALAKKAD,2011,41,43,12,96,85,0,85,170,13,9,4,26,5,19,36,208,236,72,164,740,684,34,201,2,24,1372,2326,2,156,18,404,0,580,9,4117,7721
KERALA,PATHANAMTHITTA,2011,20,19,4,43,33,0,33,66,17,15,2,34,0,13,20,135,182,55,127,532,418,17,146,0,7,1060,1648,0,157,14,158,0,329,0,3112,5532
KERALA,RAILWAYS,2011,1,1,1,3,0,0,0,0,0,0,0,0,0,5,2,4,250,0,250,511,6,0,0,0,0,35,41,0,25,9,0,0,34,0,23,362
KERALA,THRISSUR COMMR.,2011,8,17,7,32,28,0,28,56,12,10,2,24,7,10,28,75,144,61,83,408,362,7,678,2,10,340,1402,0,100,28,131,0,259,3,2894,4891
KERALA,THRISSUR RURAL,2011,24,41,15,80,69,0,69,138,12,12,0,24,3,10,34,180,251,53,198,729,597,13,479,0,27,942,2069,1,263,28,449,0,741,11,8037,11486
KERALA,TRIVANDRUM COMMR.,2011,8,29,3,40,39,0,39,78,25,13,12,50,2,57,79,175,407,128,279,1127,526,35,405,15,14,982,1981,0,241,46,156,0,443,4,3343,6591
KERALA,TRIVANDRUM RURAL,2011,32,36,16,84,140,0,140,280,21,15,6,42,8,25,69,326,290,105,185,1008,858,15,273,5,36,2293,3481,4,547,24,422,0,997,1,4201,9642
KERALA,WAYANADU,2011,11,3,8,22,65,0,65,130,8,6,2,16,1,2,13,68,83,25,58,250,205,4,196,2,7,831,1248,2,62,5,124,0,193,3,2553,4256
MADHYA PRADESH,ALIRAJPUR,2011,76,39,0,115,24,0,24,48,19,18,1,38,1,0,5,25,59,24,35,149,10,1,4,0,11,278,378,0,23,0,8,0,31,74,605,1262
MADHYA PRADESH,ANUPPUR,2011,39,23,1,63,60,0,60,120,7,7,0,14,3,0,16,80,86,37,49,271,23,3,16,0,3,174,303,10,57,4,42,0,113,84,704,1435
MADHYA PRADESH,ASHOK NAGAR,2011,26,21,2,49,36,0,36,72,7,5,2,14,0,2,18,77,113,56,57,323,27,1,7,0,6,976,1081,8,105,8,33,0,154,64,1076,2613
MADHYA PRADESH,BALAGHAT,2011,51,21,4,76,55,0,55,110,7,7,0,14,0,0,12,89,90,35,55,281,27,9,23,1,13,337,503,3,104,7,37,0,151,93,1464,2447
MADHYA PRADESH,BARWANI,2011,51,19,0,70,39,0,39,78,8,7,1,16,0,0,8,72,143,61,82,366,25,4,8,1,8,233,451,2,58,5,11,0,76,172,1047,1914
MADHYA PRADESH,BETUL,2011,54,29,1,84,120,0,120,240,19,18,1,38,1,1,18,94,194,56,138,502,7,2,30,1,10,295,520,20,188,6,53,0,267,175,1960,3278
MADHYA PRADESH,BHIND,2011,73,92,4,169,51,0,51,102,22,18,4,44,4,1,78,121,226,146,80,656,55,9,30,0,17,1229,1484,28,71,11,45,0,155,144,1384,3695
MADHYA PRADESH,BHOPAL,2011,91,112,8,211,146,0,146,292,40,32,8,80,4,4,161,1031,2651,1795,856,6502,108,19,111,0,19,812,1505,19,144,16,198,2,379,436,8991,15123
MADHYA PRADESH,BHOPAL RLY.,2011,6,3,1,10,0,0,0,0,0,0,0,0,1,0,27,1,1154,22,1132,2337,5,5,2,0,0,0,14,0,8,2,0,0,10,2,231,1448
MADHYA PRADESH,BURHANPUR,2011,18,5,0,23,29,0,29,58,2,2,0,4,1,0,10,30,86,30,56,213,7,0,18,0,2,58,143,5,41,5,13,0,64,58,747,1135
MADHYA PRADESH,CHHATARPUR,2011,58,78,5,141,77,0,77,154,44,42,2,88,2,2,74,306,277,132,145,938,96,8,52,0,16,598,903,33,185,8,75,0,301,133,3006,5133
MADHYA PRADESH,CHHINDWARA,2011,71,26,2,99,111,0,111,222,24,22,2,48,1,2,12,208,272,113,159,767,70,7,42,0,19,1352,1710,14,189,41,89,0,333,220,2408,5180
MADHYA PRADESH,DAMOH,2011,45,56,0,101,52,0,52,104,21,14,7,42,0,1,22,155,142,78,64,462,21,4,20,0,20,1567,1707,27,193,0,139,0,359,75,1089,3649
MADHYA PRADESH,DATIYA,2011,53,43,0,96,25,0,25,50,19,19,0,38,0,2,39,92,155,58,97,443,29,2,26,0,11,285,443,10,65,0,37,0,112,90,1631,2614
MADHYA PRADESH,DEWAS,2011,43,69,0,112,102,0,102,204,26,21,5,52,3,2,26,219,664,325,339,1578,48,9,34,0,33,380,705,19,162,30,110,0,321,201,3254,5434
MADHYA PRADESH,DHAR,2011,81,63,3,147,103,0,103,206,43,41,2,86,4,4,25,167,510,276,234,1220,37,59,27,0,27,595,1076,62,189,13,74,0,338,331,3130,5547
MADHYA PRADESH,DINDORI,2011,22,4,5,31,46,0,46,92,6,4,2,12,0,0,2,26,30,13,17,88,9,1,12,0,0,86,173,1,67,5,21,0,94,65,630,1038
MADHYA PRADESH,GUNA,2011,45,43,2,90,75,0,75,150,26,24,2,52,5,3,22,152,305,161,144,792,67,12,25,0,15,698,986,9,122,14,30,1,176,169,1868,3708
MADHYA PRADESH,GWALIOR,2011,107,148,30,285,75,0,75,150,90,81,9,180,13,11,202,919,2120,1596,524,5385,131,38,154,2,28,1138,1765,34,170,14,168,0,386,274,5149,11015
MADHYA PRADESH,HARDA,2011,25,16,0,41,53,0,53,106,15,15,0,30,1,0,7,55,99,49,50,261,16,4,11,0,3,251,335,5,59,9,14,0,87,50,613,1306
MADHYA PRADESH,HOSHANGABAD,2011,59,50,5,114,59,0,59,118,28,26,2,56,4,1,66,211,261,162,99,804,26,12,40,0,25,306,548,16,149,17,120,0,302,139,2484,4078
MADHYA PRADESH,INDORE,2011,135,137,4,276,129,0,129,258,66,52,14,132,3,11,219,993,3634,2456,1178,8494,116,45,231,3,41,2629,3514,41,339,59,398,3,840,449,8884,18569
MADHYA PRADESH,INDORE RLY.,2011,4,1,3,8,2,0,2,4,1,1,0,2,0,0,6,2,260,0,260,528,1,0,0,0,0,3,4,1,4,0,0,0,5,0,58,346
MADHYA PRADESH,JABALPUR,2011,93,129,4,226,107,0,107,214,39,27,12,78,1,10,68,460,763,471,292,2065,89,13,129,0,20,3171,3582,39,269,40,212,2,562,160,4475,10293
MADHYA PRADESH,JABALPUR RLY.,2011,4,2,0,6,3,0,3,6,2,2,0,4,1,3,26,5,445,8,437,925,4,0,0,1,0,5,11,1,3,0,0,0,4,1,109,615
MADHYA PRADESH,JHABUA,2011,24,8,0,32,42,0,42,84,35,17,18,70,3,2,27,84,80,63,17,276,21,8,11,0,21,230,368,4,62,0,10,0,76,77,1279,2028
MADHYA PRADESH,KATNI,2011,41,26,4,71,62,0,62,124,8,7,1,16,1,2,7,157,139,66,73,445,19,8,33,0,8,920,1108,16,140,12,51,0,219,120,1454,3228
MADHYA PRADESH,KHANDWA,2011,38,28,0,66,59,0,59,118,13,10,3,26,1,0,20,176,231,111,120,659,17,2,15,1,15,92,255,5,141,19,24,0,189,113,1904,2914
MADHYA PRADESH,KHARGON,2011,37,26,6,69,39,0,39,78,13,13,0,26,1,4,23,124,381,163,218,914,30,8,23,0,10,54,442,38,118,14,38,0,208,317,2570,3874
MADHYA PRADESH,MANDLA,2011,36,14,2,52,63,0,63,126,9,9,0,18,0,0,8,66,63,15,48,200,4,2,27,0,7,308,414,4,101,12,27,0,144,66,1391,2210
MADHYA PRADESH,MANDSAUR,2011,37,52,0,89,49,0,49,98,26,18,8,52,4,1,38,163,314,143,171,834,20,39,46,0,11,203,471,4,100,6,58,10,178,152,2209,3542
MADHYA PRADESH,MORENA,2011,56,100,3,159,40,0,40,80,28,23,5,56,23,6,48,178,419,170,249,1093,103,2,43,0,17,1905,2251,32,85,4,85,0,206,181,1802,5160
MADHYA PRADESH,NARSINGHPUR,2011,45,34,0,79,65,0,65,130,18,15,3,36,1,1,15,134,136,65,71,423,33,3,27,0,17,1252,1476,20,108,25,69,0,222,144,802,2949
MADHYA PRADESH,NEEMUCH,2011,20,13,0,33,25,0,25,50,17,9,8,34,0,1,27,139,208,105,103,583,33,52,23,0,11,210,395,4,49,4,51,9,117,66,1129,2091
MADHYA PRADESH,PANNA,2011,33,18,2,53,48,0,48,96,10,5,5,20,0,2,19,132,76,21,55,305,9,0,16,0,6,267,368,14,87,5,48,0,154,70,1415,2277
MADHYA PRADESH,RAISEN,2011,47,70,3,120,118,0,118,236,36,22,14,72,0,3,19,137,265,118,147,689,41,6,19,0,17,321,557,15,179,16,67,0,277,153,2640,4172
MADHYA PRADESH,RAJGARH,2011,43,34,0,77,90,0,90,180,26,21,5,52,2,0,25,165,338,148,190,868,87,5,11,0,55,402,686,6,175,39,51,0,271,126,2929,4609
MADHYA PRADESH,RATLAM,2011,35,49,1,85,97,0,97,194,48,39,9,96,1,6,42,141,333,137,196,856,56,27,31,0,19,485,778,9,131,18,135,0,293,160,2005,3829
MADHYA PRADESH,REWA,2011,46,41,6,93,91,0,91,182,26,25,1,52,2,4,57,401,408,190,218,1280,0,12,64,0,15,1003,1277,32,122,107,112,8,381,183,2267,5007
MADHYA PRADESH,SAGAR,2011,94,96,1,191,131,0,131,262,106,104,2,212,2,2,55,381,491,200,291,1422,87,8,71,0,26,2526,2975,37,416,29,156,0,638,257,4006,8978
MADHYA PRADESH,SATNA,2011,66,35,4,105,83,0,83,166,20,13,7,40,1,2,44,300,484,280,204,1315,29,13,26,0,22,979,1397,20,177,7,109,0,313,328,2696,5445
MADHYA PRADESH,SEONI,2011,31,23,5,59,61,0,61,122,12,11,1,24,0,2,9,99,147,59,88,404,25,4,28,0,6,302,476,9,111,13,27,0,160,111,1687,2712
MADHYA PRADESH,SHAHDOL,2011,45,21,0,66,80,0,80,160,22,17,5,44,1,1,17,154,199,58,141,571,20,14,24,0,6,246,310,21,143,9,108,0,281,0,2073,3204
MADHYA PRADESH,SHAJAPUR,2011,49,36,0,85,50,0,50,100,13,10,3,26,1,1,26,135,390,174,216,943,28,19,17,0,15,1435,1644,8,135,17,7,0,167,130,611,3123
MADHYA PRADESH,SHEOPUR,2011,14,11,0,25,18,0,18,36,11,7,4,22,2,0,8,31,55,14,41,151,27,5,13,0,3,736,821,2,28,2,9,0,41,37,264,1276
MADHYA PRADESH,SHIVPURI,2011,55,53,3,111,93,0,93,186,27,18,9,54,7,10,45,149,254,88,166,719,52,5,35,1,16,1133,1470,13,168,5,65,0,251,228,2494,4911
MADHYA PRADESH,SIDHI,2011,29,9,0,38,32,0,32,64,32,31,1,64,0,0,9,137,131,29,102,408,8,3,21,0,10,321,452,16,93,1,45,0,155,89,1550,2536
MADHYA PRADESH,SIHORE,2011,44,58,1,103,82,0,82,164,26,26,0,52,3,1,29,175,346,156,190,900,46,9,35,0,27,418,718,11,119,14,76,0,220,183,2612,4315
MADHYA PRADESH,SINGRAULI,2011,43,13,7,63,43,0,43,86,25,24,1,50,3,0,9,82,99,27,72,292,30,5,11,0,7,347,543,13,89,1,59,0,162,143,1094,2123
MADHYA PRADESH,TIKAMGARH,2011,37,27,7,71,76,0,76,152,23,23,0,46,4,3,45,131,142,50,92,467,52,4,16,0,8,948,1128,18,153,4,36,10,221,100,1396,3240
MADHYA PRADESH,UJJAIN,2011,68,149,0,217,81,0,81,162,43,35,8,86,2,1,72,350,1144,621,523,2713,92,19,71,1,37,397,789,14,196,36,176,0,422,172,5290,8411
MADHYA PRADESH,UMARIYA,2011,21,11,0,32,22,0,22,44,4,4,0,8,0,0,9,73,61,20,41,204,8,0,19,0,5,110,142,3,78,10,27,0,118,0,943,1404
MADHYA PRADESH,VIDISHA,2011,47,56,0,103,87,0,87,174,30,27,3,60,0,2,31,246,341,144,197,961,49,8,32,0,20,705,927,16,197,19,79,0,311,113,2573,4651
MAHARASHTRA,AHMEDNAGAR,2011,107,108,3,218,78,0,78,156,82,59,23,164,64,20,161,626,1622,466,1156,4115,679,32,273,8,43,779,2527,32,160,5,677,0,874,713,1376,7648
MAHARASHTRA,AKOLA,2011,46,43,3,92,30,0,30,60,40,37,3,80,11,1,61,249,821,166,655,1964,115,15,125,20,36,759,1226,13,93,24,140,0,270,156,1224,4025
MAHARASHTRA,AMRAVATI COMMR.,2011,15,42,2,59,22,0,22,44,20,19,1,40,5,8,65,237,1004,236,768,2323,68,18,70,11,8,364,630,2,49,13,94,0,158,91,723,2931
MAHARASHTRA,AMRAVATI RURAL,2011,58,38,2,98,69,0,69,138,29,27,2,58,11,0,35,222,779,85,694,1826,92,13,40,3,81,923,1359,3,142,43,104,0,292,207,1334,4228
MAHARASHTRA,AURANGABAD COMMR.,2011,41,118,1,160,16,0,16,32,35,24,11,70,23,5,152,380,852,429,423,2264,154,21,194,5,26,470,1038,7,65,29,122,0,223,168,897,3781
MAHARASHTRA,AURANGABAD RURAL,2011,60,48,2,110,18,0,18,36,16,12,4,32,14,2,34,184,512,149,363,1258,277,9,58,1,37,695,1373,36,78,12,212,0,338,296,613,3214
MAHARASHTRA,BEED,2011,61,72,8,141,32,0,32,64,58,37,21,116,48,7,88,325,496,171,325,1460,333,52,158,1,45,953,1864,11,99,14,378,0,502,322,669,4230
MAHARASHTRA,BHANDARA,2011,33,15,4,52,23,0,23,46,12,9,3,24,3,2,19,171,444,82,362,1083,25,10,40,5,20,306,562,1,30,14,50,0,95,156,694,2077
MAHARASHTRA,BULDHANA,2011,60,41,1,102,26,0,26,52,28,27,1,56,11,1,35,168,610,177,433,1435,233,27,120,3,45,768,1461,14,124,24,194,0,356,265,1104,3902
MAHARASHTRA,CHANDRAPUR,2011,50,39,6,95,56,0,56,112,30,25,5,60,8,2,43,230,668,169,499,1619,82,18,67,3,36,629,1119,4,108,77,109,0,298,284,1279,3828
MAHARASHTRA,DHULE,2011,49,31,1,81,16,0,16,32,27,27,0,54,41,1,57,194,434,146,288,1161,212,27,79,1,15,379,998,4,52,7,203,0,266,285,634,2749
MAHARASHTRA,GADCHIROLI,2011,82,27,1,110,20,0,20,40,5,3,2,10,2,0,10,55,102,27,75,271,21,1,11,0,40,196,372,0,24,3,23,0,50,103,231,957
MAHARASHTRA,GONDIA,2011,37,22,2,61,31,0,31,62,24,23,1,48,5,0,19,159,370,73,297,923,35,12,49,2,21,363,607,1,67,19,36,0,123,125,548,1947
MAHARASHTRA,HINGOLI,2011,39,33,0,72,18,0,18,36,12,8,4,24,3,3,15,87,160,35,125,428,131,10,55,0,32,411,725,0,42,5,82,0,129,86,519,1743
MAHARASHTRA,JALGAON,2011,81,72,4,157,48,0,48,96,57,25,32,114,21,4,80,274,982,260,722,2343,356,107,308,7,31,788,2064,8,146,51,364,0,569,467,1262,5518
MAHARASHTRA,JALNA,2011,47,40,2,89,15,0,15,30,20,17,3,40,16,10,52,226,485,156,329,1274,203,16,95,0,18,604,1132,23,73,10,289,0,395,196,577,3017
MAHARASHTRA,KOLHAPUR,2011,65,41,2,108,42,0,42,84,38,35,3,76,23,3,51,367,876,321,555,2196,237,75,240,4,17,480,1434,19,59,18,121,0,217,381,955,4114
MAHARASHTRA,LATUR,2011,68,48,3,119,17,0,17,34,37,37,0,74,16,3,50,251,404,181,223,1128,280,11,128,1,26,684,1345,4,57,0,156,0,217,215,959,3418
MAHARASHTRA,MUMBAI COMMR.,2011,203,180,4,387,221,0,221,442,221,166,55,442,28,46,467,2745,12983,4702,8281,29252,379,553,1946,81,46,4302,7963,14,553,162,393,0,1122,656,6464,32647
MAHARASHTRA,MUMBAI RLY.,2011,12,2,1,15,3,0,3,6,9,6,3,18,2,0,63,3,2134,0,2134,4336,6,6,50,1,0,56,120,0,8,3,0,0,11,1,111,2471
MAHARASHTRA,NAGPUR COMMR.,2011,114,74,13,201,45,0,45,90,40,24,16,80,12,11,198,734,2287,1142,1145,5529,148,68,294,22,22,876,1673,4,68,53,174,0,299,243,2563,8063
MAHARASHTRA,NAGPUR RLY.,2011,3,3,0,6,1,0,1,2,0,0,0,0,6,0,29,4,1059,15,1044,2157,11,1,5,15,0,14,46,0,9,1,1,0,11,0,73,1235
MAHARASHTRA,NAGPUR RURAL,2011,65,31,5,101,44,0,44,88,25,24,1,50,5,6,36,206,873,173,700,1999,86,31,55,6,45,591,1298,11,65,15,62,0,153,484,1144,3891
MAHARASHTRA,NANDED,2011,90,76,3,169,32,0,32,64,52,43,9,104,15,4,59,389,498,149,349,1463,315,34,209,3,67,1088,1966,29,93,3,325,0,450,250,1528,5162
MAHARASHTRA,NANDURBAR,2011,43,16,1,60,20,0,20,40,18,15,3,36,12,1,10,71,180,54,126,454,90,8,39,3,3,278,562,0,40,7,87,0,134,141,418,1486
MAHARASHTRA,NASIK COMMR.,2011,37,32,4,73,25,0,25,50,16,11,5,32,28,6,154,516,2095,1079,1016,4894,111,31,197,14,21,258,809,5,37,10,115,0,167,177,623,4512
MAHARASHTRA,NASIK RURAL,2011,86,59,1,146,43,0,43,86,33,28,5,66,28,8,52,226,655,202,453,1624,359,49,171,6,9,758,2024,5,91,33,298,0,427,672,1347,4989
MAHARASHTRA,NAVI MUMBAI,2011,70,22,4,96,38,0,38,76,32,17,15,64,15,5,316,688,1935,913,1022,4894,129,81,410,9,6,504,1507,1,57,33,110,0,201,368,825,5658
MAHARASHTRA,OSMANABAD,2011,42,35,0,77,30,0,30,60,28,18,10,56,17,7,24,220,346,88,258,960,230,19,142,0,18,626,1312,2,88,11,186,0,287,277,735,3083
MAHARASHTRA,PARBHANI,2011,58,64,1,123,26,0,26,52,36,16,20,72,16,5,61,283,383,148,235,1131,169,5,90,0,39,979,1429,5,80,6,215,0,306,147,299,2967
MAHARASHTRA,PUNE COMMR.,2011,110,118,5,233,79,0,79,158,104,72,32,208,19,34,546,1192,4710,2869,1841,11211,478,93,769,34,27,991,2930,8,118,80,251,0,457,538,2318,12622
MAHARASHTRA,PUNE RLY.,2011,3,0,0,3,0,0,0,0,3,0,3,6,6,1,7,1,391,10,381,797,1,4,3,0,0,8,16,0,4,0,0,0,4,0,30,462
MAHARASHTRA,PUNE RURAL,2011,148,97,9,254,87,0,87,174,64,48,16,128,45,29,150,719,1778,824,954,4499,409,56,298,15,46,789,2683,16,122,26,172,0,336,1070,1757,7902
MAHARASHTRA,RAIGAD,2011,39,16,0,55,7,0,7,14,7,5,2,14,5,2,20,130,322,52,270,801,115,27,124,4,11,205,778,2,42,15,42,0,101,292,570,1997
MAHARASHTRA,RATNAGIRI,2011,15,12,2,29,30,0,30,60,12,10,2,24,4,0,16,139,228,33,195,615,78,30,62,2,25,169,514,1,35,18,49,0,103,148,388,1463
MAHARASHTRA,SANGLI,2011,53,29,4,86,40,0,40,80,22,13,9,44,10,0,22,178,544,265,279,1298,163,14,218,9,27,385,1131,5,51,8,98,0,162,315,548,2743
MAHARASHTRA,SATARA,2011,55,40,3,98,34,0,34,68,41,36,5,82,36,0,120,382,930,362,568,2398,226,42,191,5,28,417,1401,2,80,16,179,0,277,492,993,4312
MAHARASHTRA,SINDHUDURG,2011,12,7,2,21,11,0,11,22,10,7,3,20,1,0,19,72,92,10,82,276,42,14,70,1,15,107,333,0,8,12,5,0,25,84,208,792
MAHARASHTRA,SOLAPUR COMMR.,2011,24,29,2,55,22,0,22,44,29,18,11,58,25,5,74,205,520,288,232,1349,110,7,115,2,9,172,511,0,31,9,68,0,108,96,411,1965
MAHARASHTRA,SOLAPUR RURAL,2011,107,47,4,158,53,0,53,106,43,32,11,86,26,9,79,285,729,226,503,1857,401,19,136,4,40,725,1901,6,94,32,175,0,307,576,1126,4716
MAHARASHTRA,THANE COMMR.,2011,127,65,4,196,79,0,79,158,92,70,22,184,22,23,277,1127,2956,1324,1632,7361,279,127,855,21,23,2011,3628,8,161,38,342,0,549,312,704,9653
MAHARASHTRA,THANE RURAL,2011,147,61,19,227,63,0,63,126,55,32,23,110,42,11,295,759,1168,529,639,3443,345,50,364,8,26,788,2231,10,105,18,57,0,190,650,964,6005
MAHARASHTRA,WARDHA,2011,37,33,2,72,34,0,34,68,26,23,3,52,10,4,34,247,681,129,552,1657,86,10,53,5,56,693,1070,3,88,45,62,0,198,167,1116,3492
MAHARASHTRA,WASHIM,2011,35,32,3,70,13,0,13,26,27,21,6,54,10,1,20,114,432,150,282,1009,127,5,44,1,29,423,726,12,80,12,118,0,222,97,644,2279
MAHARASHTRA,YAVATMAL,2011,84,47,1,132,44,0,44,88,54,46,8,108,3,1,74,273,919,205,714,2189,130,25,78,5,40,1005,1538,8,118,37,198,0,361,255,1609,5008
MANIPUR,BISHNUPUR,2011,5,24,1,30,2,0,2,4,18,11,7,36,0,11,0,7,40,19,21,98,7,1,12,0,10,36,67,0,11,0,3,0,14,1,122,311
MANIPUR,CHANDEL,2011,2,8,0,10,1,0,1,2,0,0,0,0,0,12,0,1,5,1,4,23,1,0,0,0,2,5,8,0,0,0,0,0,0,0,26,63
MANIPUR,CHURACHANDPUR,2011,7,1,0,8,0,0,0,0,7,3,4,14,0,11,0,5,12,7,5,40,0,1,1,0,1,9,12,0,0,0,1,0,1,0,15,71
MANIPUR,CID,2011,0,0,0,0,0,0,0,0,0,0,0,0,0,0,0,0,0,0,0,0,0,0,1,0,0,0,1,0,0,0,0,0,0,0,1,2
MANIPUR,IMPHAL EAST,2011,17,37,0,54,11,0,11,22,36,28,8,72,0,48,1,11,76,58,18,212,12,7,22,0,10,71,122,0,7,0,8,0,15,0,135,509
MANIPUR,IMPHAL WEST,2011,24,118,2,144,17,0,17,34,61,45,16,122,0,39,2,14,496,422,74,1047,22,23,53,11,13,83,206,1,11,0,8,0,20,1,398,1397
MANIPUR,SENAPATI,2011,3,11,0,14,0,0,0,0,5,1,4,10,1,10,1,7,16,8,8,51,9,0,5,0,30,3,47,0,0,0,0,0,0,0,60,161
MANIPUR,TAMENGLONG,2011,4,0,0,4,0,0,0,0,0,0,0,0,0,5,2,0,1,0,1,9,1,1,2,0,12,5,21,0,1,0,0,0,1,0,19,53
MANIPUR,THOUBAL,2011,9,38,1,48,21,0,21,42,39,28,11,78,0,11,1,6,65,38,27,148,17,8,29,1,14,76,145,0,8,0,19,0,27,0,222,585
MANIPUR,UKHRUL,2011,7,8,0,15,1,0,1,2,3,0,3,6,0,7,0,1,8,0,8,24,1,1,1,0,7,4,14,0,0,0,0,0,0,0,17,66
MEGHALAYA,GARO HILLS EAST,2011,11,19,0,30,3,0,3,6,12,0,12,24,13,0,4,12,58,14,44,145,0,3,5,0,0,0,8,0,0,0,0,0,0,0,97,237
MEGHALAYA,GARO HILLS SOUTH,2011,11,5,0,16,2,0,2,4,6,4,2,12,1,0,2,4,38,23,15,83,0,0,1,4,0,12,22,0,2,0,1,0,3,5,21,115
MEGHALAYA,GARO HILLS WEST,2011,22,7,0,29,8,0,8,16,25,9,16,50,8,0,11,36,150,45,105,355,8,1,28,4,6,70,132,1,22,1,8,0,32,15,102,533
MEGHALAYA,JAINTIA HILLS,2011,52,4,0,56,43,0,43,86,12,8,4,24,5,0,7,12,82,25,57,188,0,9,25,2,5,47,103,0,6,0,0,0,6,15,99,425
MEGHALAYA,KHASI HILLS EAST,2011,36,5,2,43,42,0,42,84,20,8,12,40,6,0,28,68,257,58,199,616,0,37,96,1,14,30,225,0,32,0,11,0,43,47,211,943
MEGHALAYA,KHASI HILLS WEST,2011,17,6,1,24,15,0,15,30,8,5,3,16,6,0,4,13,53,15,38,129,0,2,6,2,2,18,38,0,8,0,0,0,8,8,98,267
MEGHALAYA,RI-BHOI,2011,21,5,0,26,17,0,17,34,4,3,1,8,10,0,7,0,58,10,48,133,0,0,5,0,7,20,32,0,4,0,1,3,8,0,73,235
MIZORAM,AIZAWL,2011,10,10,6,26,35,0,35,70,1,0,1,2,0,0,4,190,395,31,364,984,0,9,46,1,12,44,137,0,43,0,9,0,52,25,143,983
MIZORAM,CHAMPHAI,2011,4,4,0,8,10,0,10,20,0,0,0,0,0,0,0,49,80,2,78,209,0,2,6,1,0,12,21,0,10,0,0,0,10,0,21,199
MIZORAM,KOLASIB,2011,5,2,0,7,7,0,7,14,2,0,2,4,0,0,0,18,57,2,55,132,0,3,1,0,3,10,17,0,3,1,0,0,4,0,34,146
MIZORAM,LAWNGTLAI,2011,1,1,0,2,2,0,2,4,1,0,1,2,0,0,0,7,29,0,29,65,0,1,2,0,0,4,11,0,0,0,0,0,0,4,12,64
MIZORAM,LUNGLEI,2011,2,3,1,6,13,0,13,26,2,0,2,4,0,0,1,36,93,4,89,223,0,4,8,0,1,5,18,0,3,0,0,0,3,0,19,191
MIZORAM,MAMIT,2011,2,2,1,5,4,0,4,8,0,0,0,0,1,0,1,10,31,0,31,74,0,0,1,0,1,11,17,0,4,0,0,0,4,4,12,85
MIZORAM,SAIHA,2011,1,2,0,3,2,0,2,4,0,0,0,0,0,0,0,15,25,0,25,65,0,0,2,0,0,8,14,0,5,0,0,0,5,4,15,79
MIZORAM,SERCHHIP,2011,1,0,0,1,4,0,4,8,0,0,0,0,0,0,0,11,24,0,24,59,0,2,0,0,2,3,7,0,4,0,0,0,4,0,23,74
NAGALAND,DIMAPUR,2011,15,10,0,25,9,0,9,18,24,1,23,48,4,0,46,26,170,6,164,416,0,9,16,4,1,14,51,0,7,0,1,0,8,7,136,499
NAGALAND,KIPHIRE,2011,0,0,0,0,0,0,0,0,0,0,0,0,0,0,0,0,0,0,0,0,0,0,0,0,0,0,0,0,0,0,0,0,0,0,13,13
NAGALAND,KOHIMA,2011,7,6,8,21,0,0,0,0,0,0,0,0,0,0,5,28,70,59,11,173,0,3,7,0,0,10,20,0,0,0,0,0,0,0,64,208
NAGALAND,LONGLENG,2011,0,2,1,3,1,0,1,2,1,0,1,2,0,0,0,0,11,0,11,22,0,0,1,0,0,0,1,0,0,0,0,0,0,0,1,18
NAGALAND,MOKOKCHUNG,2011,3,0,1,4,2,0,2,4,2,1,1,4,0,0,3,0,21,11,10,45,0,0,2,0,0,3,8,0,0,0,0,0,0,3,16,56
NAGALAND,MON,2011,6,3,0,9,2,0,2,4,0,0,0,0,1,0,0,3,8,4,4,20,1,0,0,1,0,6,10,0,0,0,0,0,0,2,9,42
NAGALAND,PEREN,2011,4,1,0,5,0,0,0,0,0,0,0,0,0,0,0,1,5,0,5,11,0,1,0,0,0,3,4,0,0,0,0,0,0,0,7,22
NAGALAND,PHEK,2011,4,8,0,12,3,0,3,6,0,0,0,0,0,0,1,2,10,1,9,23,0,1,1,0,1,3,6,0,2,0,0,0,2,0,12,48
NAGALAND,TUENSANG,2011,1,2,1,4,2,0,2,4,4,0,4,8,0,0,2,1,17,0,17,37,0,0,3,0,0,1,7,0,0,0,0,0,0,3,5,42
NAGALAND,WOKHA,2011,2,7,0,9,1,0,1,2,2,0,2,4,1,0,2,0,24,3,21,51,0,2,1,0,0,5,8,0,0,0,0,0,0,0,18,65
NAGALAND,ZUNHEBOTO,2011,4,4,0,8,3,0,3,6,1,1,0,2,1,0,0,12,24,1,23,61,0,0,0,0,0,10,10,0,0,0,0,0,0,0,11,70
ODISHA,ANGUL,2011,71,47,0,118,63,0,63,126,44,39,5,88,21,1,80,162,470,156,314,1204,142,2,57,0,12,32,420,25,299,8,58,0,390,175,1614,3383
ODISHA,BALASORE,2011,62,66,1,129,75,0,75,150,111,97,14,222,24,3,53,227,397,127,270,1101,45,20,76,0,20,1552,1713,45,217,19,279,0,560,0,449,3741
ODISHA,BARAGARH,2011,34,99,0,133,21,0,21,42,16,11,5,32,11,0,41,91,216,104,112,575,82,3,21,0,23,62,287,16,91,18,99,0,224,96,697,1737
ODISHA,BERHAMPUR,2011,29,96,3,128,13,0,13,26,20,15,5,40,8,14,66,94,252,133,119,686,26,11,82,0,21,279,508,9,154,12,86,0,261,89,334,1698
ODISHA,BHADRAK,2011,38,32,0,70,26,0,26,52,55,51,4,110,5,0,20,81,155,50,105,416,29,7,78,1,27,32,262,24,93,4,138,0,259,88,1444,2377
ODISHA,BOLANGIR,2011,31,112,0,143,52,0,52,104,24,24,0,48,12,0,47,106,175,54,121,515,81,8,68,0,19,0,446,6,166,4,44,0,220,270,733,1958
ODISHA,BOUDH,2011,12,12,0,24,14,0,14,28,19,16,3,38,0,0,11,22,52,12,40,137,14,7,11,1,6,153,222,0,56,5,15,0,76,30,74,514
ODISHA,CUTTACK,2011,49,28,0,77,34,0,34,68,46,40,6,92,9,0,61,106,205,57,148,586,33,1,43,0,19,0,193,24,26,5,133,0,188,97,1562,2481
ODISHA,DCP BBSR,2011,34,63,0,97,35,0,35,70,40,32,8,80,8,10,76,213,1191,646,545,2689,41,10,122,2,10,708,1075,13,43,5,32,0,93,182,1219,4057
ODISHA,DCP CTC,2011,27,21,13,61,19,0,19,38,31,25,6,62,4,8,54,103,512,278,234,1193,27,11,42,0,3,0,181,0,17,2,88,0,107,98,1181,2261
ODISHA,DEOGARH,2011,14,23,0,37,15,0,15,30,9,8,1,18,4,1,9,17,21,7,14,73,6,2,14,0,4,124,191,2,68,1,6,0,77,41,96,477
ODISHA,DHENKANAL,2011,58,59,0,117,17,0,17,34,32,29,3,64,8,0,77,84,312,73,239,793,67,7,35,0,13,32,269,22,185,11,24,0,242,115,580,1738
ODISHA,GAJAPATI,2011,10,10,0,20,11,0,11,22,6,6,0,12,1,0,3,20,24,4,20,72,29,3,9,0,8,62,136,0,56,3,20,0,79,25,62,362
ODISHA,GANJAM,2011,85,202,0,287,50,0,50,100,51,39,12,102,33,0,88,118,186,68,118,611,93,26,45,0,36,305,579,32,358,15,0,0,405,74,401,2198
ODISHA,JAGATSINGHPUR,2011,35,24,0,59,31,0,31,62,47,42,5,94,16,4,49,88,202,72,130,561,45,3,24,0,16,127,422,18,12,0,75,0,105,207,567,1590
ODISHA,JAJPUR,2011,64,17,0,81,31,0,31,62,49,44,5,98,19,0,64,121,342,111,231,888,33,4,46,0,15,942,1438,30,94,9,97,0,230,398,117,2492
ODISHA,JHARSUGUDA,2011,29,28,0,57,27,0,27,54,14,12,2,28,10,4,49,95,268,93,175,694,44,12,58,0,10,368,600,7,45,4,17,0,73,108,112,1309
ODISHA,KALAHANDI,2011,38,34,1,73,46,0,46,92,23,22,1,46,11,0,29,74,78,17,61,270,74,6,70,0,5,382,572,9,97,11,95,0,212,35,475,1593
ODISHA,KANDHAMAL,2011,36,10,0,46,32,0,32,64,25,21,4,50,6,0,19,48,71,21,50,215,20,7,30,0,4,290,351,9,70,8,41,0,128,0,165,891
ODISHA,KENDRAPARA,2011,38,33,0,71,41,0,41,82,44,43,1,88,13,5,50,103,132,58,74,435,31,3,16,0,15,217,282,36,14,1,147,0,198,0,824,1763
ODISHA,KEONJHAR,2011,102,89,14,205,75,0,75,150,48,44,4,96,22,6,89,87,295,91,204,794,50,15,24,4,17,406,773,22,134,11,110,0,277,257,284,2161
ODISHA,KHURDA,2011,20,21,10,51,29,0,29,58,30,27,3,60,12,0,66,59,169,81,88,475,36,3,29,0,16,4,198,10,14,2,139,0,165,110,841,1620
ODISHA,KORAPUT,2011,46,42,2,90,53,0,53,106,40,36,4,80,17,0,34,96,123,25,98,393,64,1,33,0,15,16,219,0,126,10,48,0,184,90,615,1471
ODISHA,MALKANGIR,2011,37,30,0,67,8,0,8,16,10,10,0,20,20,0,7,20,64,7,57,175,56,6,20,0,4,0,110,6,46,7,19,0,78,24,114,498
ODISHA,MAYURBHANJ,2011,103,73,0,176,76,0,76,152,89,87,2,178,3,1,24,91,261,50,211,641,17,29,50,2,18,105,305,34,227,20,143,0,424,84,1115,2565
ODISHA,NAYAGARH,2011,37,40,0,77,25,0,25,50,30,26,4,60,11,5,31,49,145,33,112,386,29,4,20,0,14,405,520,16,4,1,89,0,110,48,188,1191
ODISHA,NOWRANGPUR,2011,34,30,0,64,44,0,44,88,44,44,0,88,3,0,11,35,71,11,60,191,32,3,23,0,6,72,213,2,80,13,43,0,138,77,412,1035
ODISHA,NUAPADA,2011,17,2,0,19,4,0,4,8,12,10,2,24,5,0,11,32,61,26,35,170,16,4,17,0,4,35,107,2,51,6,20,0,79,31,446,776
ODISHA,PURI,2011,49,65,0,114,21,0,21,42,37,27,10,74,13,11,106,151,360,94,266,1001,75,1,67,0,10,47,319,27,16,1,98,0,142,119,1670,2944
ODISHA,RAYAGADA,2011,38,45,5,88,32,0,32,64,36,34,2,72,15,0,16,65,108,16,92,312,36,5,14,0,6,60,190,7,106,6,38,0,157,69,298,1005
ODISHA,ROURKELA,2011,68,43,0,111,26,0,26,52,22,19,3,44,41,3,40,98,380,122,258,942,39,4,55,0,3,153,444,1,63,6,31,0,101,190,439,1705
ODISHA,SAMBALPUR,2011,37,54,0,91,30,0,30,60,13,12,1,26,23,1,118,167,409,127,282,1127,79,18,36,0,4,396,878,2,48,2,29,0,81,345,836,2647
ODISHA,SONEPUR,2011,20,21,0,41,10,0,10,20,4,4,0,8,1,0,15,34,63,17,46,176,28,0,32,0,5,116,218,3,48,1,9,0,61,37,213,660
ODISHA,SRP(CUTTACK),2011,4,3,1,8,0,0,0,0,3,0,3,6,1,3,15,10,492,44,448,1013,2,0,7,0,0,16,25,0,8,1,0,0,9,0,82,648
ODISHA,SRP(ROURKELA),2011,8,5,0,13,1,0,1,2,0,0,0,0,2,3,8,20,290,54,236,613,0,2,6,0,0,0,10,1,9,1,3,0,14,2,131,492
ODISHA,SUNDARGARH,2011,63,42,1,106,25,0,25,50,15,12,3,30,5,1,46,44,172,47,125,440,35,2,11,0,15,396,626,5,66,2,7,0,80,167,119,1239
PUNJAB,AMRITSAR,2011,52,41,1,94,16,0,16,32,21,20,1,42,2,5,6,60,99,53,46,271,0,18,144,6,8,209,554,1,16,0,58,0,75,169,239,1171
PUNJAB,BARNALA,2011,11,24,1,36,5,0,5,10,7,5,2,14,0,2,0,57,92,38,54,243,0,7,44,3,2,103,248,3,6,0,10,0,19,89,358,824
PUNJAB,BATALA,2011,28,28,3,59,13,0,13,26,16,14,2,32,1,2,2,49,93,38,55,240,0,11,103,1,10,185,388,4,8,0,35,0,47,78,188,858
PUNJAB,BHATINDA,2011,48,54,1,103,37,0,37,74,31,20,11,62,1,1,8,168,269,161,108,716,0,13,133,1,2,244,523,5,11,1,49,0,66,130,402,1609
PUNJAB,CP AMRITSAR,2011,32,75,0,107,20,0,20,40,43,34,9,86,0,16,12,117,390,142,248,925,0,16,261,3,4,154,504,4,7,1,101,0,113,66,485,1807
PUNJAB,CP JALANDHAR,2011,29,39,8,76,15,0,15,30,45,40,5,90,1,5,23,146,487,206,281,1149,0,21,231,1,10,169,511,4,19,3,74,0,100,79,553,1962
PUNJAB,CP LUDHIANA,2011,76,83,12,171,48,0,48,96,94,76,18,188,1,11,14,203,493,241,252,1215,0,34,388,2,7,240,936,14,25,12,109,0,160,265,1023,3154
PUNJAB,FARIDKOT,2011,17,18,2,37,8,0,8,16,7,6,1,14,1,6,1,42,74,36,38,198,0,4,49,0,2,158,214,1,10,0,20,0,31,1,339,760
PUNJAB,FATEHGARH SAHIB,2011,13,12,2,27,4,0,4,8,9,8,1,18,2,5,5,40,102,60,42,256,0,7,62,0,0,143,330,4,4,1,21,0,30,118,238,792
PUNJAB,FAZILKA,2011,22,21,3,46,21,0,21,42,25,17,8,50,0,1,0,60,100,48,52,261,0,6,83,2,0,195,337,3,5,0,29,0,37,51,213,840
PUNJAB,FEROZPUR,2011,31,45,4,80,20,0,20,40,32,25,7,64,2,5,3,91,141,61,80,383,0,18,137,8,7,233,494,6,9,0,53,0,68,91,277,1213
PUNJAB,G.R.P,2011,6,3,2,11,0,0,0,0,1,0,1,2,0,0,0,1,52,7,45,105,0,0,2,0,0,9,11,0,0,0,0,0,0,0,275,351
PUNJAB,GURDASPUR,2011,22,29,6,57,12,0,12,24,26,22,4,52,1,0,3,53,50,20,30,157,0,8,85,0,0,89,275,6,17,0,38,0,61,93,242,780
PUNJAB,HOSHIARPUR,2011,51,43,5,99,28,0,28,56,31,23,8,62,0,14,44,118,211,68,143,598,0,7,153,1,5,290,663,11,13,2,72,0,98,207,315,1621
PUNJAB,JALANDHAR,2011,41,51,4,96,31,0,31,62,32,26,6,64,3,11,31,151,193,47,146,582,0,3,146,2,6,299,599,6,22,0,57,0,85,143,370,1602
PUNJAB,KAPURTHALA,2011,33,39,3,75,16,0,16,32,20,17,3,40,3,5,29,96,146,53,93,425,0,6,146,1,0,227,491,2,10,0,39,0,51,111,250,1182
PUNJAB,KHANNA,2011,17,28,4,49,7,0,7,14,12,8,4,24,1,5,2,55,119,45,74,301,0,4,81,1,0,109,333,1,6,0,10,0,17,138,272,872
PUNJAB,LUDHIANA,2011,16,30,2,48,8,0,8,16,15,10,5,30,1,5,4,45,93,39,54,241,0,4,99,3,4,91,308,4,4,4,22,0,34,107,306,867
PUNJAB,MANSA,2011,28,26,1,55,14,0,14,28,9,5,4,18,2,2,1,42,49,21,28,145,0,3,60,3,1,113,225,4,5,0,13,0,22,45,162,583
PUNJAB,MOGA,2011,32,60,3,95,12,0,12,24,26,12,14,52,2,4,9,140,232,107,125,619,0,18,149,3,5,203,465,5,3,0,26,0,34,87,319,1338
PUNJAB,MUKTSAR,2011,24,21,8,53,17,0,17,34,16,14,2,32,1,2,3,61,86,40,46,239,0,5,62,2,2,161,305,7,8,0,16,0,31,73,164,739
PUNJAB,PATHANKOT,2011,12,9,4,25,10,0,10,20,15,12,3,30,0,0,1,30,45,22,23,121,0,9,29,1,1,54,152,5,2,0,21,0,28,58,235,541
PUNJAB,PATIALA,2011,47,43,12,102,25,0,25,50,31,26,5,62,0,16,4,162,281,145,136,744,0,12,266,1,2,278,882,13,22,0,95,0,130,323,1020,2653
PUNJAB,ROPAR,2011,20,16,4,40,14,0,14,28,25,16,9,50,0,3,4,61,151,68,83,370,0,5,57,2,0,115,350,5,9,1,18,0,33,171,402,1083
PUNJAB,SANGRUR,2011,38,52,9,99,30,0,30,60,25,11,14,50,1,8,6,147,205,88,117,572,0,15,120,1,3,240,585,14,10,0,36,0,60,206,704,1870
PUNJAB,SAS NGR,2011,31,38,4,73,24,0,24,48,39,27,12,78,0,4,4,137,352,214,138,849,0,18,312,1,0,161,969,4,13,3,76,0,96,477,370,2068
PUNJAB,SBS NAGAR,2011,18,21,3,42,8,0,8,16,9,6,3,18,2,1,17,80,95,22,73,290,0,4,39,2,2,125,278,4,6,3,14,0,27,106,170,729
PUNJAB,TARN TARAN,2011,47,48,1,96,16,0,16,32,19,17,2,38,0,4,0,76,84,17,67,248,0,5,130,7,0,160,396,3,12,0,24,0,39,94,284,1014
RAJASTHAN,AJMER,2011,50,41,9,100,70,0,70,140,123,108,15,246,1,2,17,187,616,365,251,1439,11,10,1014,2,14,195,1723,15,105,0,709,0,829,477,2959,6627
RAJASTHAN,ALWAR,2011,104,51,4,159,99,0,99,198,161,143,18,322,0,2,30,189,1818,1522,296,3857,9,26,981,4,15,2604,4124,53,136,0,556,0,745,485,3316,10643
RAJASTHAN,BANSWARA,2011,34,14,0,48,55,0,55,110,102,95,7,204,2,1,7,57,121,62,59,309,61,12,138,1,22,616,999,6,59,2,190,0,257,149,918,2567
RAJASTHAN,BARAN,2011,24,38,4,66,60,0,60,120,91,88,3,182,0,0,7,68,286,123,163,647,5,25,286,0,9,426,874,10,158,1,351,0,520,123,1516,3488
RAJASTHAN,BARMER,2011,29,27,0,56,21,0,21,42,34,34,0,68,0,0,1,82,236,111,125,555,3,9,304,1,18,456,1016,27,36,0,201,0,264,225,1682,3392
RAJASTHAN,BHARATPUR,2011,95,83,2,180,69,0,69,138,193,139,54,386,2,1,39,69,1468,950,518,3047,1,13,750,4,28,157,1223,29,85,0,478,0,592,270,5284,9120
RAJASTHAN,BHILWARA,2011,34,30,5,69,52,0,52,104,85,74,11,170,0,1,29,164,654,390,264,1502,16,10,453,2,15,88,888,16,90,0,558,0,664,304,2091,4697
RAJASTHAN,BIKANER,2011,39,47,15,101,55,0,55,110,31,25,6,62,1,0,4,124,294,140,154,717,0,7,525,4,9,225,1048,17,54,0,446,0,517,278,1656,3831
RAJASTHAN,BUNDI,2011,22,44,5,71,40,0,40,80,110,99,11,220,0,0,5,69,227,129,98,528,5,14,274,0,13,694,1144,6,114,0,298,0,418,144,1221,3305
RAJASTHAN,CHITTORGARH,2011,27,37,2,66,50,0,50,100,116,98,18,232,0,1,22,135,436,191,245,1030,41,45,350,1,16,726,1368,4,48,1,588,0,641,189,1411,4246
RAJASTHAN,CHURU,2011,40,46,0,86,37,0,37,74,33,26,7,66,0,0,3,110,195,81,114,503,2,3,385,0,6,416,1003,10,11,0,342,0,363,191,1238,3068
RAJASTHAN,DAUSA,2011,24,18,6,48,13,0,13,26,98,72,26,196,3,8,19,71,908,596,312,1917,22,7,316,1,12,110,746,12,17,0,184,0,213,278,3018,5145
RAJASTHAN,DHOLPUR,2011,56,66,1,123,32,0,32,64,76,64,12,152,0,14,16,31,420,195,225,901,1,11,187,2,8,1211,1542,19,12,0,197,0,228,122,1261,3743
RAJASTHAN,DUNGARPUR,2011,24,11,1,36,39,0,39,78,89,87,2,178,0,0,11,40,57,27,30,165,14,41,70,0,21,134,392,5,57,0,134,0,196,112,1170,2030
RAJASTHAN,G.R.P.AJMER,2011,6,6,0,12,2,0,2,4,6,6,0,12,1,0,5,0,500,22,478,1006,1,3,3,1,0,4,15,0,9,0,0,0,9,3,115,665
RAJASTHAN,G.R.P.JODHPUR,2011,4,1,0,5,0,0,0,0,2,1,1,4,0,0,1,0,85,6,79,171,2,1,0,0,0,0,4,0,7,0,0,0,7,1,51,155
RAJASTHAN,GANGANAGAR,2011,56,76,1,133,99,0,99,198,76,68,8,152,0,0,10,176,365,164,201,916,1,31,945,6,4,857,2038,19,73,1,653,0,746,194,1790,5433
RAJASTHAN,HANUMANGARH,2011,53,48,1,102,82,0,82,164,46,38,8,92,0,0,6,61,183,72,111,433,0,12,715,0,2,300,1197,12,66,0,405,0,483,168,1834,3994
RAJASTHAN,JAIPUR EAST,2011,23,36,0,59,31,0,31,62,78,69,9,156,6,4,64,356,2191,1747,444,4812,75,32,602,0,9,100,1043,15,59,0,272,0,346,225,2197,6375
RAJASTHAN,JAIPUR NORTH,2011,17,18,2,37,20,0,20,40,43,38,5,86,2,3,32,82,651,432,219,1421,31,29,765,2,5,290,1213,8,23,0,241,0,272,91,1041,3396
RAJASTHAN,JAIPUR RURAL,2011,49,28,3,80,37,0,37,74,88,75,13,176,1,2,30,144,562,305,257,1301,14,15,519,0,7,388,1347,15,37,0,213,0,265,404,2649,5205
RAJASTHAN,JAIPUR SOUTH,2011,16,9,4,29,18,0,18,36,53,47,6,106,0,2,35,188,1071,679,392,2367,20,59,597,0,4,118,959,6,18,0,215,0,239,161,1541,4135
RAJASTHAN,JAIPUR WEST,2011,27,19,0,46,23,0,23,46,88,72,16,176,0,3,48,263,982,589,393,2278,11,151,792,1,6,241,1480,10,25,0,208,0,243,278,1815,4991
RAJASTHAN,JAISALMER,2011,11,8,0,19,4,0,4,8,7,5,2,14,0,0,3,43,126,49,77,298,14,5,86,0,9,227,400,5,17,0,20,0,42,59,437,1081
RAJASTHAN,JALORE,2011,35,14,0,49,22,0,22,44,50,47,3,100,0,0,3,65,170,56,114,408,9,13,191,2,15,11,357,14,24,0,154,0,192,116,1557,2465
RAJASTHAN,JHALAWAR,2011,33,64,1,98,67,0,67,134,70,55,15,140,0,7,21,59,366,180,186,819,47,10,179,0,31,779,1158,14,201,3,385,0,603,112,1147,3596
RAJASTHAN,JHUNJHUNU,2011,41,35,2,78,51,0,51,102,79,59,20,158,1,0,10,110,309,143,166,739,11,6,512,1,11,427,1179,21,68,0,284,0,373,211,1888,4078
RAJASTHAN,JODHPUR CITY,2011,29,54,6,89,33,0,33,66,58,45,13,116,0,1,17,173,945,657,288,2081,4,18,684,4,12,641,1604,13,57,1,338,0,409,241,941,4270
RAJASTHAN,JODHPUR RURAL,2011,21,9,0,30,26,0,26,52,38,35,3,76,0,0,6,51,146,44,102,349,0,3,240,0,14,771,1230,17,28,0,133,0,178,202,840,2545
RAJASTHAN,KARAULI,2011,32,44,0,76,38,0,38,76,108,78,30,216,1,1,21,33,619,307,312,1294,8,8,178,1,13,16,320,18,18,0,174,0,210,96,2975,4402
RAJASTHAN,KOTA CITY,2011,35,100,6,141,24,0,24,48,91,74,17,182,0,9,15,120,863,671,192,1870,2,16,499,1,2,144,772,5,58,0,413,0,476,108,1665,4176
RAJASTHAN,KOTA RURAL,2011,26,57,4,87,44,0,44,88,59,50,9,118,0,0,6,38,147,76,71,338,0,5,134,0,9,225,477,5,98,0,235,0,338,104,1115,2311
RAJASTHAN,NAGAUR,2011,44,62,1,107,70,0,70,140,68,60,8,136,0,1,12,148,375,150,225,911,0,7,466,0,11,105,882,14,66,0,398,0,478,293,2117,4258
RAJASTHAN,PALI,2011,31,80,8,119,64,0,64,128,106,88,18,212,2,0,32,214,264,115,149,776,0,7,463,4,4,36,787,11,84,0,451,0,546,273,3213,5347
RAJASTHAN,PRATAPGARH,2011,39,31,0,70,103,0,103,206,79,77,2,158,0,1,5,53,128,43,85,315,21,9,142,2,18,413,683,7,65,0,212,0,284,78,847,2253
RAJASTHAN,RAJSAMAND,2011,21,20,2,43,14,0,14,28,52,44,8,104,0,1,13,59,145,67,78,363,22,7,261,1,3,505,981,2,61,0,234,0,297,182,677,2282
RAJASTHAN,SAWAI MADHOPUR,2011,31,30,1,62,24,0,24,48,89,72,17,178,0,2,11,48,538,334,204,1137,0,14,266,0,9,0,392,4,43,0,201,0,248,103,2311,3725
RAJASTHAN,SIKAR,2011,49,32,0,81,50,0,50,100,91,69,22,182,0,1,9,180,533,211,322,1256,22,12,803,2,14,275,1463,26,11,0,232,0,269,335,2740,5417
RAJASTHAN,SIROHI,2011,19,28,0,47,27,0,27,54,60,52,8,120,2,0,6,61,104,33,71,277,22,11,241,1,9,429,879,5,76,0,156,0,237,166,529,1952
RAJASTHAN,TONK,2011,28,14,3,45,25,0,25,50,79,75,4,158,0,1,8,93,261,128,133,624,49,5,275,1,5,879,1378,5,23,0,315,0,343,164,1041,3274
RAJASTHAN,UDAIPUR,2011,83,90,1,174,110,0,110,220,198,162,36,396,3,3,88,296,734,404,330,1858,174,19,906,4,41,1738,3289,14,150,0,444,0,608,407,2436,7939
SIKKIM,EAST,2011,8,3,3,14,7,0,7,14,5,5,0,10,0,0,2,28,40,7,33,110,8,3,20,3,4,24,86,0,6,0,2,0,8,24,59,249
SIKKIM,NORTH,2011,1,0,0,1,0,0,0,0,0,0,0,0,0,0,0,3,9,0,9,21,2,0,1,0,0,6,16,0,1,0,0,0,1,7,16,46
SIKKIM,SOUTH,2011,2,3,4,9,4,0,4,8,4,4,0,8,0,0,3,24,20,1,19,67,10,1,6,0,0,24,62,0,11,0,1,0,12,21,57,195
SIKKIM,WEST,2011,3,1,1,5,5,0,5,10,1,1,0,2,0,0,0,5,3,0,3,11,5,0,4,0,0,21,35,0,6,0,1,0,7,5,45,106
TAMIL NADU,ARIYALUR,2011,28,23,0,51,16,0,16,32,19,17,2,38,0,0,9,38,94,31,63,235,42,0,16,0,10,210,387,1,47,3,15,0,66,109,1273,1953
TAMIL NADU,CHENNAI,2011,168,332,1,501,76,0,76,152,56,41,15,112,3,0,219,766,2866,425,2441,6720,160,22,767,99,7,1466,3952,20,73,121,229,0,443,1431,12464,21346
TAMIL NADU,CHENNAI RLY.,2011,6,5,0,11,0,0,0,0,1,1,0,2,1,0,26,1,216,5,211,460,4,1,5,1,0,41,57,1,6,5,0,0,12,5,190,515
TAMIL NADU,COIMBATORE RURAL,2011,39,31,0,70,5,0,5,10,48,29,19,96,4,0,112,166,402,111,291,1086,78,9,51,11,0,464,1167,1,43,0,50,0,94,554,2522,4590
TAMIL NADU,COIMBATORE URBAN,2011,26,41,0,67,9,0,9,18,27,10,17,54,0,0,48,105,824,339,485,1801,30,6,171,19,23,398,930,2,32,5,83,0,122,283,1898,4030
TAMIL NADU,CUDDALORE,2011,68,201,0,269,30,0,30,60,102,102,0,204,2,0,40,114,345,149,196,846,229,0,43,0,65,1010,1845,16,12,0,57,0,85,498,6383,9215
TAMIL NADU,DHARMAPURI,2011,55,28,7,90,14,0,14,28,70,61,9,140,6,0,34,68,157,87,70,422,95,3,31,6,21,891,1299,0,44,0,53,0,97,252,1739,3574
TAMIL NADU,DINDIGUL,2011,65,81,0,146,18,0,18,36,50,50,0,100,1,0,52,97,256,97,159,662,93,12,103,3,17,533,1322,3,45,0,117,0,165,561,3319,5426
TAMIL NADU,ERODE,2011,47,30,1,78,10,0,10,20,42,35,7,84,2,0,63,101,409,228,181,984,22,6,89,5,8,485,1175,1,35,3,19,0,58,560,4260,6198
TAMIL NADU,KANCHIPURAM,2011,87,85,0,172,19,0,19,38,22,22,0,44,1,0,22,97,275,76,199,670,135,3,61,9,12,497,1571,1,25,4,25,0,55,854,4035,6269
TAMIL NADU,KANYAKUMARI,2011,44,70,0,114,10,0,10,20,50,50,0,100,2,1,114,180,268,76,192,833,1,3,127,6,21,735,1169,3,7,137,90,0,237,276,3054,5199
TAMIL NADU,KARUR,2011,28,31,0,59,8,0,8,16,60,56,4,120,0,0,39,55,183,83,100,460,18,8,34,4,2,261,620,1,21,3,22,0,47,293,1503,2574
TAMIL NADU,KRISHNAGIRI,2011,72,43,0,115,12,0,12,24,64,52,12,128,3,0,48,127,290,163,127,758,146,2,84,24,20,726,1452,7,32,1,29,0,69,450,2326,4506
TAMIL NADU,MADURAI RURAL,2011,71,140,1,212,21,0,21,42,94,88,6,188,18,3,156,198,355,136,219,1085,183,3,209,2,20,638,1546,12,68,3,73,0,156,491,3406,6165
TAMIL NADU,MADURAI URBAN,2011,35,56,0,91,7,0,7,14,25,18,7,50,1,0,85,106,455,209,246,1102,25,10,183,20,2,171,534,5,22,4,71,0,102,123,1467,2873
TAMIL NADU,NAGAPATTINAM,2011,44,41,0,85,13,0,13,26,34,32,2,68,0,0,25,62,164,41,123,415,60,0,14,1,21,455,805,5,40,27,12,0,84,254,2881,4153
TAMIL NADU,NAMAKKAL,2011,38,31,0,69,8,0,8,16,63,55,8,126,3,1,29,90,173,81,92,469,53,2,78,0,12,520,1093,1,58,12,14,0,85,428,2912,4526
TAMIL NADU,NILGIRIS,2011,17,15,0,32,6,0,6,12,7,7,0,14,0,0,14,50,65,14,51,194,10,2,13,2,1,176,261,0,8,2,4,0,14,57,875,1324
TAMIL NADU,PERAMBALUR,2011,14,20,0,34,7,0,7,14,25,25,0,50,0,0,32,42,78,33,45,230,11,0,24,1,4,129,327,1,18,0,3,0,22,158,951,1518
TAMIL NADU,PUDUKOTTAI,2011,35,70,1,106,7,0,7,14,43,41,2,86,2,0,36,76,169,75,94,452,55,28,37,1,22,330,777,0,24,2,18,0,44,304,2313,3573
TAMIL NADU,RAMNATHAPURAM,2011,42,60,0,102,6,0,6,12,53,51,2,106,0,0,22,101,190,36,154,503,86,1,50,0,40,495,900,1,14,0,9,0,24,228,2113,3511
TAMIL NADU,SALEM RURAL,2011,70,74,1,145,35,0,35,70,108,100,8,216,6,1,40,112,187,71,116,533,231,1,75,1,35,1650,2556,4,108,0,51,0,163,563,2869,6222
TAMIL NADU,SALEM URBAN,2011,28,26,0,54,23,0,23,46,38,35,3,76,3,0,60,55,273,165,108,664,27,8,61,1,2,355,580,2,21,9,38,0,70,126,2289,3445
TAMIL NADU,SIVAGANGAI,2011,30,40,1,71,5,0,5,10,35,30,5,70,5,0,16,92,200,50,150,513,39,4,69,0,16,236,625,1,33,1,43,0,78,261,1947,3074
TAMIL NADU,THANJAVUR,2011,61,97,0,158,10,0,10,20,46,43,3,92,1,4,103,233,588,302,286,1517,155,3,45,4,24,870,1540,1,76,0,12,0,89,439,3756,6528
TAMIL NADU,THENI,2011,34,113,2,149,22,0,22,44,88,79,9,176,2,0,33,125,261,72,189,682,68,5,185,4,21,666,1200,12,40,0,89,0,141,251,2998,5019
TAMIL NADU,THIRUNELVELI RURAL,2011,94,196,0,290,52,0,52,104,56,46,10,112,1,0,76,203,345,51,294,970,4,7,179,7,54,1040,1717,8,57,0,120,0,185,426,5018,7943
TAMIL NADU,THIRUNELVELI URBAN,2011,22,53,0,75,7,0,7,14,17,13,4,34,1,0,36,36,92,38,54,257,0,1,75,1,3,131,314,0,7,0,2,0,9,103,647,1234
TAMIL NADU,THIRUVALLUR,2011,30,38,3,71,6,0,6,12,10,10,0,20,2,0,27,64,126,39,87,345,70,2,61,0,12,362,828,7,2,1,12,0,22,321,2297,3453
TAMIL NADU,THIRUVANNAMALAI,2011,45,49,0,94,24,0,24,48,75,59,16,150,2,0,3,76,188,93,95,457,136,2,67,7,31,635,1220,3,11,0,11,0,25,342,2591,4298
TAMIL NADU,THIRUVARUR,2011,24,38,1,63,4,0,4,8,21,20,1,42,0,0,12,85,134,51,83,365,26,4,19,0,30,467,711,2,8,0,6,0,16,165,3351,4397
TAMIL NADU,THOOTHUGUDI,2011,72,216,1,289,29,0,29,58,42,35,7,84,4,0,92,218,393,140,253,1100,0,20,134,7,40,587,1132,4,2,0,40,0,46,344,3160,5405
TAMIL NADU,TIRUPPUR,2011,47,24,0,71,9,0,9,18,61,43,18,122,8,0,98,276,827,461,366,2036,52,24,245,4,7,421,1433,9,42,0,89,0,140,680,3846,6769
TAMIL NADU,TRICHY RLY.,2011,5,1,0,6,0,0,0,0,0,0,0,0,0,0,3,1,104,1,103,212,1,0,0,0,0,10,17,0,3,1,1,0,5,6,94,230
TAMIL NADU,TRICHY RURAL,2011,49,77,0,126,13,0,13,26,59,52,7,118,6,0,79,121,222,77,145,650,39,0,22,1,19,306,2244,2,38,0,35,0,75,1857,1851,4796
TAMIL NADU,TRICHY URBAN,2011,27,21,1,49,6,0,6,12,28,21,7,56,0,0,30,55,437,154,283,959,10,0,57,8,2,142,393,2,17,26,28,0,73,174,2425,3496
TAMIL NADU,VELLORE,2011,77,72,5,154,25,0,25,50,84,78,6,168,3,0,23,186,560,321,239,1332,3,6,81,12,16,794,1652,5,29,0,44,0,78,740,4907,7672
TAMIL NADU,VILLUPURAM,2011,87,325,2,414,86,0,86,172,206,187,19,412,6,1,64,175,497,292,205,1240,522,10,213,1,53,1340,2954,7,274,0,140,0,421,815,6121,10945
TAMIL NADU,VIRUDHUNAGAR,2011,46,68,0,114,19,0,19,38,55,49,6,110,2,0,46,95,256,38,218,655,90,20,94,3,13,524,1038,1,25,94,58,0,178,294,3112,4915
TRIPURA,DHALAI,2011,24,13,0,37,21,0,21,42,16,9,7,32,1,0,9,20,33,4,29,96,2,4,5,0,6,96,114,1,38,0,52,0,91,1,95,437
TRIPURA,GRP,2011,1,0,0,1,0,0,0,0,0,0,0,0,0,0,0,0,3,0,3,6,1,0,1,0,0,2,4,0,0,0,0,0,0,0,3,11
TRIPURA,NORTH,2011,31,9,0,40,40,0,40,80,31,27,4,62,1,0,2,26,80,10,70,189,13,15,23,4,3,178,238,1,50,1,172,0,224,2,189,871
TRIPURA,SOUTH,2011,36,31,0,67,58,0,58,116,34,24,10,68,0,0,12,56,134,14,120,336,65,14,36,1,18,455,594,5,84,1,181,0,271,5,549,1775
TRIPURA,WEST,2011,71,22,0,93,86,0,86,172,73,56,17,146,9,0,27,125,244,31,213,649,94,21,34,4,31,609,799,23,122,7,297,0,449,6,804,2709
UTTAR PRADESH,AGRA,2011,181,182,38,401,76,0,76,152,395,328,67,790,20,0,185,381,3706,2869,837,7998,486,149,386,39,7,411,1993,87,196,0,341,0,624,515,2509,10290
UTTAR PRADESH,ALIGARH,2011,168,174,33,375,66,0,66,132,320,265,55,640,9,0,91,178,1260,717,543,2798,316,121,346,1,25,293,1443,73,194,0,256,0,523,341,1616,5881
UTTAR PRADESH,ALLAHABAD,2011,156,126,34,316,67,0,67,134,220,190,30,440,8,2,88,257,1390,970,420,3135,218,113,256,12,10,439,1444,75,93,1,266,0,435,396,2029,6256
UTTAR PRADESH,AMBEDKAR NAGAR,2011,42,39,10,91,16,0,16,32,80,74,6,160,2,0,15,52,113,53,60,295,53,25,57,0,5,195,408,16,33,0,88,0,137,73,369,1283
UTTAR PRADESH,AURAIYA,2011,29,20,9,58,15,0,15,30,76,73,3,152,3,0,19,16,129,88,41,296,11,19,41,3,1,90,318,25,14,0,26,0,65,153,484,1183
UTTAR PRADESH,AZAMGARH,2011,55,40,31,126,28,0,28,56,120,101,19,240,5,1,58,76,214,96,118,568,145,48,95,1,0,307,1010,27,27,0,49,0,103,414,432,2173
UTTAR PRADESH,BADAUN,2011,97,124,40,261,18,0,18,36,137,115,22,274,4,0,34,50,156,58,98,400,7,30,87,3,6,312,642,48,62,0,59,0,169,197,1128,2599
UTTAR PRADESH,BAGHPAT,2011,66,87,17,170,12,0,12,24,88,74,14,176,2,0,49,65,269,131,138,654,74,36,84,0,1,157,485,17,35,0,106,0,158,133,438,1736
UTTAR PRADESH,BAHRAICH,2011,53,55,19,127,57,0,57,114,133,128,5,266,12,0,28,74,223,92,131,560,87,46,179,3,23,175,621,62,49,0,55,0,166,108,1238,2679
UTTAR PRADESH,BALLIA,2011,33,53,15,101,7,0,7,14,66,64,2,132,1,0,7,66,135,83,52,344,57,18,54,0,8,168,404,17,21,0,27,0,65,99,296,1148
UTTAR PRADESH,BALRAMPUR,2011,16,12,9,37,10,0,10,20,50,50,0,100,10,0,8,28,44,13,31,134,21,15,75,1,6,103,318,16,13,0,0,0,29,97,123,657
UTTAR PRADESH,BANDA,2011,40,27,19,86,26,0,26,52,48,48,0,96,2,0,2,59,121,36,85,305,31,33,38,0,12,28,261,29,56,0,31,0,116,119,560,1281
UTTAR PRADESH,BARABANKI,2011,71,52,21,144,36,0,36,72,142,142,0,284,0,0,13,60,201,87,114,475,6,50,109,2,7,337,779,25,51,0,51,0,127,268,714,2216
UTTAR PRADESH,BAREILLY,2011,116,150,40,306,34,0,34,68,205,193,12,410,3,0,56,129,609,308,301,1406,107,130,271,6,0,170,1039,63,92,0,155,0,310,355,2319,5010
UTTAR PRADESH,BASTI,2011,21,10,11,42,7,0,7,14,29,28,1,58,0,0,15,9,45,22,23,114,11,10,22,0,7,71,227,11,5,0,17,0,33,106,389,796
UTTAR PRADESH,BHIM NAGAR,2011,72,90,14,176,34,0,34,68,114,105,9,228,19,4,48,65,196,70,126,528,36,44,0,0,2,31,215,29,43,0,61,0,133,102,733,1737
UTTAR PRADESH,BIJNOR,2011,85,37,20,142,39,0,39,78,128,118,10,256,2,0,35,45,249,100,149,580,33,33,187,3,6,937,1430,30,14,0,238,0,282,231,203,2555
UTTAR PRADESH,BULANDSHAHAR,2011,162,175,27,364,47,0,47,94,218,192,26,436,10,2,69,108,501,245,256,1191,99,44,216,1,1,17,805,50,94,0,362,0,506,427,1268,3898
UTTAR PRADESH,CHANDOLI,2011,19,13,9,41,8,0,8,16,20,19,1,40,0,0,7,24,83,44,39,197,5,12,45,0,0,148,281,17,7,0,48,0,72,71,400,936
UTTAR PRADESH,CHITRAKOOT DHAM,2011,24,6,9,39,20,0,20,40,25,22,3,50,1,0,6,51,73,28,45,204,9,9,20,1,2,10,113,14,24,0,11,0,49,62,211,588
UTTAR PRADESH,CSM NAGAR,2011,30,36,9,75,20,0,20,40,99,96,3,198,0,0,8,40,106,43,63,260,51,16,39,0,3,180,417,17,40,0,53,0,110,128,312,1187
UTTAR PRADESH,DEORIA,2011,34,17,12,63,8,0,8,16,58,53,5,116,3,1,11,45,100,44,56,260,32,11,69,4,9,86,374,27,12,0,24,0,63,163,462,1188
UTTAR PRADESH,ETAH,2011,54,83,18,155,19,0,19,38,69,61,8,138,1,0,23,23,191,119,72,429,32,25,54,0,6,239,526,30,25,0,57,0,112,170,576,1695
UTTAR PRADESH,ETAWAH,2011,59,44,15,118,13,0,13,26,81,73,8,162,1,0,18,30,208,142,66,465,6,29,101,3,2,121,453,42,28,0,52,0,122,191,1090,2134
UTTAR PRADESH,FAIZABAD,2011,49,31,18,98,27,0,27,54,119,114,5,238,1,5,24,83,230,98,132,573,57,34,89,6,4,222,632,11,56,0,21,0,88,220,742,2049
UTTAR PRADESH,FATEHGARH,2011,61,45,14,120,16,0,16,32,91,83,8,182,1,0,12,40,154,92,62,361,23,26,63,0,3,70,312,25,35,0,59,0,119,127,320,1185
UTTAR PRADESH,FATEHPUR,2011,64,32,12,108,40,0,40,80,106,92,14,212,8,0,30,41,139,73,66,357,30,34,146,0,3,289,749,45,55,0,45,0,145,247,890,2256
UTTAR PRADESH,FIROZABAD,2011,96,104,23,223,32,0,32,64,174,144,30,348,8,0,53,64,389,242,147,903,104,30,137,0,1,230,774,43,57,0,83,0,183,272,1069,2969
UTTAR PRADESH,G.R.P.,2011,30,14,9,53,2,0,2,4,13,6,7,26,30,4,216,1,3043,90,2953,6337,62,19,34,3,0,7,125,1,38,0,0,0,39,0,1590,5116
UTTAR PRADESH,GAUTAMBUDH NAGAR,2011,88,106,15,209,25,0,25,50,141,95,46,282,16,0,235,170,2967,2128,839,6355,108,90,319,2,0,16,860,25,42,0,102,0,169,325,1423,6215
UTTAR PRADESH,GHAZIABAD,2011,162,136,35,333,22,0,22,44,257,219,38,514,7,1,135,212,3108,2450,658,6571,113,156,432,2,0,16,1091,47,59,0,255,0,361,372,2286,7813
UTTAR PRADESH,GHAZIPUR,2011,46,29,19,94,11,0,11,22,21,18,3,42,8,0,32,29,94,41,53,257,50,19,47,0,5,90,268,35,16,0,26,0,77,57,160,794
UTTAR PRADESH,GONDA,2011,46,51,22,119,34,0,34,68,129,116,13,258,20,0,28,98,201,75,126,548,67,91,280,1,18,380,972,27,29,0,6,0,62,135,818,2481
UTTAR PRADESH,GORAKHPUR,2011,105,100,31,236,50,0,50,100,232,215,17,464,6,0,47,205,1179,857,322,2616,203,114,365,17,11,407,1455,41,71,0,224,0,336,338,1328,5074
UTTAR PRADESH,HAMIRPUR,2011,34,20,17,71,12,0,12,24,38,38,0,76,1,0,4,15,69,15,54,158,6,19,25,3,8,62,197,15,33,0,20,0,68,74,163,638
UTTAR PRADESH,HARDOI,2011,61,51,35,147,24,0,24,48,130,123,7,260,3,0,8,62,182,58,124,437,25,37,78,0,3,265,653,32,55,0,72,0,159,245,1736,3104
UTTAR PRADESH,HATHRAS,2011,61,49,10,120,35,0,35,70,93,77,16,186,11,0,40,48,210,106,104,519,60,18,74,0,6,113,447,24,42,0,84,0,150,176,441,1595
UTTAR PRADESH,J.P.NAGAR,2011,66,36,18,120,44,0,44,88,61,50,11,122,20,3,32,39,180,104,76,454,20,21,104,2,6,311,535,16,21,0,83,0,120,71,357,1511
UTTAR PRADESH,JALAUN,2011,38,22,19,79,7,0,7,14,49,47,2,98,1,0,11,20,115,71,44,262,9,23,30,1,4,3,201,40,18,0,22,0,80,131,503,1066
UTTAR PRADESH,JAUNPUR,2011,41,47,26,114,14,0,14,28,93,90,3,186,1,0,19,53,138,76,62,349,41,18,55,3,15,273,621,42,22,0,41,0,105,216,482,1640
UTTAR PRADESH,JHANSI,2011,66,29,11,106,19,0,19,38,97,92,5,194,3,1,40,104,387,258,129,922,70,33,84,4,9,20,375,28,45,0,52,0,125,155,677,1934
UTTAR PRADESH,KANNAUJ,2011,37,41,17,95,14,0,14,28,107,101,6,214,2,0,9,31,99,50,49,240,39,37,82,0,15,19,314,34,49,0,98,0,181,122,1206,2058
UTTAR PRADESH,KANPUR NAGAR,2011,159,140,41,340,71,0,71,142,343,303,40,686,11,0,133,319,1738,1353,385,3939,177,208,510,35,3,309,1695,69,140,2,284,0,495,453,2516,7661
UTTAR PRADESH,KANSHIRAM NAGAR,2011,46,43,18,107,22,0,22,44,62,47,15,124,0,0,13,21,94,54,40,222,38,13,37,0,11,98,279,22,33,0,21,0,76,82,310,984
UTTAR PRADESH,KAUSHAMBI,2011,52,19,11,82,23,0,23,46,53,40,13,106,1,0,26,100,107,34,73,341,14,25,53,1,5,89,303,22,36,0,31,0,89,116,626,1410
UTTAR PRADESH,KHIRI,2011,89,93,32,214,35,0,35,70,140,132,8,280,2,0,25,45,296,168,128,664,28,11,91,1,10,386,718,57,76,0,57,0,190,191,1177,2842
UTTAR PRADESH,KUSHI NAGAR,2011,50,24,26,100,13,0,13,26,76,75,1,152,2,1,3,29,111,77,34,257,60,35,84,1,10,137,485,35,11,0,31,0,77,158,632,1529
UTTAR PRADESH,LALITPUR,2011,19,11,13,43,15,0,15,30,37,30,7,74,0,0,10,20,60,21,39,150,22,15,31,0,2,82,203,14,52,0,26,0,92,51,348,828
UTTAR PRADESH,LUCKNOW,2011,119,97,46,262,55,0,55,110,292,283,9,584,11,0,61,454,2167,1327,840,4860,182,392,790,19,11,43,1930,48,142,0,511,0,701,493,4605,10538
UTTAR PRADESH,MAHARAJGANJ,2011,22,10,13,45,18,0,18,36,43,42,1,86,0,0,7,20,49,25,24,125,9,16,29,0,2,56,214,26,15,0,12,0,53,102,315,764
UTTAR PRADESH,MAHOBA,2011,13,19,16,48,16,0,16,32,33,31,2,66,2,0,14,31,68,21,47,183,10,20,37,1,0,1,122,15,41,0,31,0,87,53,223,644
UTTAR PRADESH,MAINPURI,2011,82,74,24,180,33,0,33,66,111,92,19,222,2,0,65,55,268,168,100,658,61,27,79,0,9,190,590,34,52,0,52,0,138,224,770,2212
UTTAR PRADESH,MATHURA,2011,113,125,13,251,39,0,39,78,145,123,22,290,3,0,73,91,732,472,260,1631,132,88,262,9,0,186,1144,36,76,0,226,0,338,467,1730,4546
UTTAR PRADESH,MAU,2011,28,70,15,113,19,0,19,38,66,60,6,132,0,0,23,68,170,110,60,431,79,25,47,0,0,175,428,7,31,0,64,0,102,102,281,1270
UTTAR PRADESH,MEERUT,2011,189,235,25,449,79,0,79,158,323,271,52,646,9,1,235,247,2445,1660,785,5382,238,96,444,8,7,24,1174,36,99,0,400,0,535,357,2110,7607
UTTAR PRADESH,MIRZAPUR,2011,28,3,10,41,3,0,3,6,5,5,0,10,0,0,2,20,65,33,32,152,1,37,48,0,2,101,288,20,3,0,34,0,57,99,531,1012
UTTAR PRADESH,MORADABAD,2011,103,89,19,211,55,0,55,110,183,174,9,366,20,6,119,111,867,505,362,1990,87,69,151,9,5,84,621,30,48,0,210,0,288,216,1137,3618
UTTAR PRADESH,MUZAFFARNAGAR,2011,126,166,13,305,19,0,19,38,238,179,59,476,2,0,64,71,508,233,275,1153,165,91,243,1,2,9,716,25,37,0,203,0,265,205,1891,4079
UTTAR PRADESH,PANCHSHIL NAGAR,2011,61,72,10,143,18,0,18,36,100,78,22,200,4,0,55,61,353,226,127,826,58,26,139,1,3,22,439,15,25,0,72,0,112,190,774,2059
UTTAR PRADESH,PILIBHIT,2011,46,32,7,85,12,0,12,24,69,62,7,138,0,0,10,15,105,46,59,235,9,49,154,0,0,3,324,39,31,0,69,0,139,109,1874,2633
UTTAR PRADESH,PRABUDDH NAGAR,2011,57,65,12,134,11,0,11,22,66,52,14,132,2,3,55,22,207,102,105,496,53,16,63,2,3,9,213,10,13,0,83,0,106,67,467,1286
UTTAR PRADESH,PRATAPGARH,2011,58,56,17,131,24,0,24,48,90,85,5,180,2,0,19,59,161,77,84,402,80,43,63,0,13,345,662,31,35,0,121,0,187,118,519,1854
UTTAR PRADESH,RAIBAREILLY,2011,36,28,17,81,29,0,29,58,60,55,5,120,2,0,10,42,130,36,94,314,36,14,54,0,0,194,476,16,36,0,51,0,103,178,620,1553
UTTAR PRADESH,RAMABAI NAGAR,2011,50,27,20,97,21,0,21,42,90,83,7,180,6,0,13,18,122,45,77,281,32,35,41,5,9,386,759,29,35,0,65,0,129,251,695,1950
UTTAR PRADESH,RAMPUR,2011,79,91,8,178,43,0,43,86,121,98,23,242,15,0,72,87,387,164,223,948,84,66,204,4,0,2,456,26,27,0,86,0,139,96,1016,2514
UTTAR PRADESH,SAHARANPUR,2011,78,78,21,177,21,0,21,42,90,82,8,180,4,0,31,50,436,211,225,957,58,58,182,13,0,12,519,32,16,0,135,0,183,196,1568,3079
UTTAR PRADESH,SANT KABIRNAGAR,2011,17,18,12,47,17,0,17,34,48,48,0,96,0,0,9,27,47,17,30,130,25,16,24,0,5,149,274,6,12,0,19,0,37,55,286,792
UTTAR PRADESH,SHAHJAHANPUR,2011,87,108,24,219,40,0,40,80,141,130,11,282,5,1,21,57,251,91,160,586,41,29,108,1,37,256,719,47,54,0,28,0,129,247,1037,2620
UTTAR PRADESH,SHRAWASTI,2011,18,13,9,40,16,0,16,32,40,36,4,80,0,0,5,28,51,12,39,135,9,3,38,0,8,137,238,16,26,0,1,0,43,43,115,576
UTTAR PRADESH,SIDHARTHNAGAR,2011,14,6,10,30,9,0,9,18,42,42,0,84,0,0,5,27,62,24,38,156,10,7,16,0,0,20,126,17,21,0,29,0,67,73,293,661
UTTAR PRADESH,SITAPUR,2011,102,68,26,196,66,0,66,132,232,202,30,464,5,0,40,89,347,113,234,828,49,51,100,3,24,235,746,60,131,0,138,0,329,284,1344,3394
UTTAR PRADESH,SONBHADRA,2011,18,11,18,47,19,0,19,38,26,21,5,52,0,0,4,29,84,45,39,201,4,37,77,0,5,59,290,8,21,0,16,0,45,108,361,905
UTTAR PRADESH,ST.RAVIDASNAGAR,2011,8,9,8,25,2,0,2,4,7,6,1,14,0,0,2,14,49,15,34,114,7,13,27,0,0,29,144,11,3,0,10,0,24,68,81,348
UTTAR PRADESH,SULTANPUR,2011,41,57,19,117,21,0,21,42,52,46,6,104,1,1,17,59,197,77,120,472,42,29,51,1,20,251,632,14,23,0,58,0,95,238,359,1551
UTTAR PRADESH,UNNAO,2011,61,48,33,142,36,0,36,72,112,104,8,224,1,0,6,57,186,74,112,436,44,55,104,3,5,119,594,30,66,0,85,0,181,264,876,2191
UTTAR PRADESH,VARANASI,2011,48,53,18,119,11,0,11,22,92,76,16,184,2,2,33,76,557,385,172,1227,58,121,285,25,6,218,937,41,17,0,136,0,194,224,998,3021
UTTARAKHAND,ALMORA,2011,2,0,1,3,3,0,3,6,2,2,0,4,0,0,3,10,12,0,12,37,0,3,15,1,3,4,29,6,4,0,6,0,16,3,44,122
UTTARAKHAND,BAGESHWAR,2011,1,0,1,2,2,0,2,4,2,2,0,4,0,0,0,4,2,0,2,8,0,1,1,0,0,8,13,2,2,1,4,0,9,3,14,48
UTTARAKHAND,CHAMOLI,2011,4,2,0,6,2,0,2,4,1,1,0,2,0,0,1,8,13,1,12,35,3,1,8,0,0,7,26,0,2,0,2,0,4,7,19,80
UTTARAKHAND,CHAMPAWAT,2011,2,6,0,8,4,0,4,8,3,3,0,6,0,0,1,7,13,4,9,34,0,1,1,1,0,23,36,0,2,0,4,0,6,10,12,90
UTTARAKHAND,DEHRADUN,2011,25,35,16,76,31,0,31,62,55,47,8,110,0,1,23,98,481,213,268,1084,66,25,176,7,1,202,623,10,16,38,101,0,165,146,416,1969
UTTARAKHAND,HARIDWAR,2011,56,58,13,127,26,0,26,52,95,75,20,190,9,0,89,79,633,263,370,1443,161,37,148,6,5,413,964,22,30,22,58,0,132,194,478,2632
UTTARAKHAND,NAINITAL,2011,17,14,8,39,10,0,10,20,24,24,0,48,0,0,16,20,158,77,81,352,27,7,34,3,0,26,177,15,4,5,19,0,43,80,281,768
UTTARAKHAND,PAURI GARHWAL,2011,6,1,4,11,1,0,1,2,5,4,1,10,0,0,0,11,48,18,30,107,20,1,21,1,2,18,76,2,6,1,6,0,15,13,42,209
UTTARAKHAND,PITHORAGARH,2011,5,3,1,9,9,0,9,18,4,4,0,8,0,0,3,9,11,0,11,34,4,1,7,0,5,38,61,5,8,0,5,0,18,6,33,157
UTTARAKHAND,RUDRA PRAYAG,2011,5,3,2,10,3,0,3,6,4,4,0,8,0,0,1,14,5,0,5,25,3,2,3,1,1,3,20,3,6,3,6,0,18,7,19,94
UTTARAKHAND,TEHRI GARHWAL,2011,4,1,0,5,3,0,3,6,1,1,0,2,0,0,4,6,6,2,4,22,6,3,8,0,0,2,25,1,1,0,1,0,3,6,44,97
UTTARAKHAND,UDHAMSINGH NAGAR,2011,49,65,7,121,31,0,31,62,116,114,2,232,4,0,38,71,704,260,444,1521,106,31,95,6,0,106,564,17,33,0,94,0,144,220,640,2433
UTTARAKHAND,UTTARKASHI,2011,2,1,1,4,4,0,4,8,2,2,0,4,0,0,0,5,7,2,5,19,5,2,2,0,0,2,12,0,2,2,1,0,5,1,36,75
WEST BENGAL,24 PARGANAS NORTH,2011,232,215,126,573,203,0,203,406,587,414,173,1174,32,150,117,27,2918,811,2107,6162,720,259,440,9,41,238,1724,88,218,10,2847,0,3163,17,7918,17412
WEST BENGAL,24 PARGANAS SOUTH,2011,247,3,33,283,274,0,274,548,349,349,0,698,15,103,32,4,2288,399,1889,4730,1445,15,159,5,26,207,1882,43,121,3,2793,0,2960,25,7062,15252
WEST BENGAL,ASANSOL,2011,58,3,11,72,31,0,31,62,64,50,14,128,8,71,23,9,641,275,366,1393,99,10,76,0,0,173,527,10,30,7,461,0,508,169,1427,3381
WEST BENGAL,BANKURA,2011,67,45,3,115,44,0,44,88,42,36,6,84,11,11,33,22,266,47,219,609,183,23,39,1,11,298,719,16,83,1,195,0,295,164,738,2296
WEST BENGAL,BIRBHUM,2011,93,83,34,210,44,0,44,88,58,51,7,116,8,39,30,7,353,107,246,790,139,18,37,3,29,429,825,25,63,0,337,0,425,170,512,2511
WEST BENGAL,BURDWAN,2011,90,19,16,125,52,0,52,104,101,83,18,202,9,84,33,9,462,156,306,1059,274,18,107,2,14,22,1150,16,21,0,665,0,702,713,1270,3997
WEST BENGAL,COOCHBEHAR,2011,53,112,13,178,133,0,133,266,194,174,20,388,4,3,13,9,280,71,209,589,37,20,63,7,31,20,290,25,76,0,494,0,595,112,1655,3354
WEST BENGAL,DAKSHIN DINAJPUR,2011,42,92,14,148,55,0,55,110,121,111,10,242,2,6,10,9,198,49,149,423,28,21,32,7,9,194,425,11,77,5,283,0,376,134,986,2336
WEST BENGAL,DARJEELING,2011,57,0,8,65,49,0,49,98,88,88,0,176,2,17,24,10,616,134,482,1285,56,82,36,4,9,822,1054,4,51,6,337,0,398,45,1232,3555
WEST BENGAL,HOOGHLY,2011,112,31,21,164,54,0,54,108,130,109,21,260,7,97,24,10,803,266,537,1744,596,11,267,4,53,28,968,21,38,0,816,0,875,9,2259,5391
WEST BENGAL,HOWRAH,2011,39,38,9,86,35,0,35,70,129,114,15,258,26,11,40,66,594,159,435,1331,153,21,136,2,5,32,589,26,75,16,644,0,761,240,3110,5447
WEST BENGAL,HOWRAH CITY,2011,38,0,12,50,24,0,24,48,110,103,7,220,6,46,36,34,1120,259,861,2362,74,55,197,2,8,38,419,2,2,0,411,0,415,45,2449,4709
WEST BENGAL,HOWRAH G.R.P.,2011,6,9,1,16,1,0,1,2,8,6,2,16,0,2,7,0,523,0,523,1055,1,3,10,1,0,0,15,0,5,0,1,0,6,0,89,667
WEST BENGAL,JALPAIGURI,2011,108,79,27,214,211,0,211,422,293,257,36,586,9,0,37,50,1521,295,1226,3138,54,83,109,3,33,320,881,13,223,0,947,0,1183,279,3487,7886
WEST BENGAL,KHARAGPUR G.R.P.,2011,4,0,1,5,0,0,0,0,2,0,2,4,1,2,8,0,170,3,167,351,3,0,0,1,0,0,4,0,5,0,1,0,6,0,27,225
WEST BENGAL,KOLKATA,2011,54,85,28,167,46,0,46,92,148,116,32,296,1,44,34,63,3532,539,2993,7206,336,333,1625,63,0,2271,5042,11,254,144,557,0,966,414,7109,17152
WEST BENGAL,MALDA,2011,98,108,15,221,179,0,179,358,243,202,41,486,3,30,16,9,410,157,253,878,88,5,53,46,22,256,470,14,38,0,762,0,814,0,2101,4496
WEST BENGAL,MURSHIDABAD,2011,145,637,28,810,433,0,433,866,566,492,74,1132,21,79,47,13,1109,186,923,2378,252,96,189,27,45,4012,4911,49,621,5,2956,0,3631,290,2534,14154
WEST BENGAL,NADIA,2011,136,375,26,537,185,0,185,370,500,453,47,1000,25,40,43,20,1373,243,1130,2874,207,99,291,11,13,2668,3445,65,128,2,1923,0,2118,156,3985,12271
WEST BENGAL,PASCHIM MIDNAPUR,2011,171,111,23,305,53,0,53,106,141,141,0,282,22,30,70,39,685,187,498,1531,640,35,85,5,34,174,978,27,89,0,803,0,919,5,2252,5494
WEST BENGAL,PURAB MIDNAPUR,2011,84,13,19,116,65,0,65,130,175,156,19,350,10,24,26,29,387,114,273,863,461,39,118,1,0,0,874,22,18,0,835,0,875,255,2084,4665
WEST BENGAL,PURULIA,2011,93,0,4,97,65,0,65,130,52,52,0,104,6,25,29,6,265,66,199,596,129,1,60,0,10,0,200,3,64,0,197,0,264,0,886,1895
WEST BENGAL,SEALDAH G.R.P.,2011,13,6,2,21,1,0,1,2,8,4,4,16,1,9,2,0,377,0,377,766,14,1,9,0,0,50,74,0,7,0,1,0,8,0,34,535
WEST BENGAL,SILIGURI G.R.P.,2011,3,0,0,3,0,0,0,0,4,1,3,8,0,0,0,0,150,0,150,300,1,0,0,0,0,0,1,0,4,0,0,0,4,0,69,231
WEST BENGAL,UTTAR DINAJPUR,2011,66,178,12,256,126,0,126,252,172,149,23,344,7,16,26,10,405,119,286,869,29,16,33,3,20,842,950,19,52,1,506,0,578,7,1339,3885
A & N ISLANDS,ANDAMAN,2011,14,5,2,21,13,0,13,26,15,12,3,30,1,0,1,96,86,4,82,270,11,3,31,0,6,77,134,0,14,3,5,0,22,6,382,771
A & N ISLANDS,NICOBAR,2011,0,1,0,1,0,0,0,0,0,0,0,0,0,0,0,3,2,0,2,7,0,0,1,0,0,4,5,0,1,0,0,0,1,0,10,22
CHANDIGARH,CHANDIGARH,2011,24,40,6,70,27,0,27,54,58,46,12,116,6,2,68,285,1502,915,587,3365,66,25,255,0,9,45,407,2,21,12,46,0,81,7,1036,3542
D & N HAVELI,D and N HAVELI,2011,14,2,0,16,4,0,4,8,9,8,1,18,7,0,2,22,69,43,26,169,20,10,18,2,5,25,104,0,2,0,3,0,5,24,134,372
DAMAN & DIU,DAMAN,2011,6,1,0,7,1,0,1,2,2,1,1,4,4,0,4,24,37,25,12,106,15,2,7,1,0,9,70,0,0,0,2,0,2,36,19,170
DAMAN & DIU,DIU,2011,0,0,0,0,0,0,0,0,1,1,0,2,0,0,2,7,10,8,2,29,4,1,3,1,0,2,18,0,0,0,0,0,0,7,16,54
DELHI UT,CAW,2011,0,0,0,0,1,0,1,2,0,0,0,0,0,0,0,0,0,0,0,0,0,0,0,0,0,0,0,0,1,0,128,0,129,0,0,130
DELHI UT,CENTRAL,2011,25,15,10,50,16,0,16,32,154,89,65,308,0,0,26,39,1308,831,477,2681,2,21,143,2,0,146,321,3,32,4,29,0,68,7,469,2451
DELHI UT,CRIME BRANCH,2011,1,4,0,5,1,0,1,2,0,0,0,0,0,0,0,0,3,0,3,6,0,0,77,6,0,0,83,0,0,0,0,0,0,0,29,121
DELHI UT,EAST,2011,54,53,6,113,55,0,55,110,393,226,167,786,7,1,67,154,3490,2405,1085,7209,10,21,193,3,5,190,616,14,78,17,160,0,269,194,1839,7004
DELHI UT,EOW,2011,0,0,0,0,0,0,0,0,0,0,0,0,0,0,0,0,0,0,0,0,0,2,147,0,0,0,149,0,0,0,0,0,0,0,0,149
DELHI UT,GRP(RLY),2011,10,3,0,13,4,0,4,8,25,10,15,50,3,0,21,4,746,32,714,1520,0,15,9,0,0,4,28,1,7,1,0,0,9,0,119,972
DELHI UT,IGI AIRPORT,2011,1,0,0,1,0,0,0,0,3,0,3,6,0,0,0,0,67,12,55,134,1,4,435,0,0,1,448,0,8,2,0,0,10,7,36,565
DELHI UT,NEW DELHI,2011,6,4,3,13,2,0,2,4,33,17,16,66,1,0,12,38,418,166,252,887,3,22,126,15,0,18,266,1,17,12,5,0,35,82,363,1181
DELHI UT,NORTH,2011,38,19,3,60,11,0,11,22,177,84,93,354,1,1,38,59,1176,614,562,2451,1,32,153,4,2,133,358,4,15,10,88,0,117,33,843,2841
DELHI UT,NORTH-EAST,2011,66,43,9,118,69,0,69,138,530,285,245,1060,5,5,55,76,2702,1812,890,5545,3,17,101,0,1,288,575,21,88,21,254,0,384,165,1215,5734
DELHI UT,NORTH-WEST,2011,51,36,2,89,58,0,58,116,331,177,154,662,4,0,89,180,2268,1554,714,4809,1,18,165,1,3,132,351,10,48,13,117,0,188,31,1331,4889
DELHI UT,OUTER,2011,84,60,10,154,73,0,73,146,577,328,249,1154,4,4,74,260,2220,1570,650,4782,4,36,167,1,8,248,487,34,65,3,196,0,298,23,1967,6118
DELHI UT,SOUTH,2011,30,25,5,60,65,0,65,130,222,143,79,444,1,5,31,203,2252,1457,795,4744,4,36,211,3,2,124,415,11,50,29,59,0,149,35,1738,5141
DELHI UT,SOUTH-EAST,2011,61,33,6,100,75,0,75,150,478,234,244,956,4,3,54,147,2437,1578,859,5082,6,59,262,3,8,270,878,19,127,32,108,0,286,270,1915,6377
DELHI UT,SOUTH-WEST,2011,51,44,5,100,69,0,69,138,391,238,153,782,0,1,52,158,1234,818,416,2679,10,16,172,4,6,131,353,11,56,10,144,0,221,14,1204,3783
DELHI UT,STF,2011,1,2,0,3,0,0,0,0,0,0,0,0,0,0,0,0,0,0,0,0,0,0,4,2,0,0,6,0,0,0,0,0,0,0,5,14
DELHI UT,WEST,2011,64,45,12,121,73,0,73,146,453,254,199,906,3,5,43,101,2578,1819,759,5308,5,38,225,0,7,261,843,13,65,8,287,0,373,307,1290,5883
LAKSHADWEEP,LAKSHADWEEP,2011,0,1,0,1,0,0,0,0,0,0,0,0,0,0,0,0,4,0,4,8,5,1,0,0,3,3,12,0,0,0,0,0,0,0,27,44
PUDUCHERRY,KARAIKAL,2011,0,2,2,4,0,0,0,0,1,0,1,2,0,0,2,9,42,24,18,95,30,1,5,0,4,222,292,0,10,4,1,0,15,30,388,753
PUDUCHERRY,PUDUCHERRY,2011,32,20,10,62,7,0,7,14,11,9,2,22,5,10,9,56,665,487,178,1410,95,8,49,4,6,631,1006,1,25,12,9,0,47,213,1731,3609
ANDHRA PRADESH,ADILABAD,2012,81,80,14,175,88,0,88,176,82,61,21,164,2,0,14,240,373,104,269,1002,56,25,216,3,35,2172,2907,7,90,155,498,0,750,400,1079,5710
ANDHRA PRADESH,ANANTAPUR,2012,173,123,3,299,18,0,18,36,74,63,11,148,14,1,6,211,581,155,426,1394,41,12,168,3,24,2018,2842,19,195,8,130,0,352,576,1043,5441
ANDHRA PRADESH,CHITTOOR,2012,91,75,5,171,28,0,28,56,56,49,7,112,3,0,10,136,501,208,293,1151,32,9,217,4,27,622,1431,33,90,269,339,0,731,520,1398,4465
ANDHRA PRADESH,CUDDAPAH,2012,118,96,2,216,26,0,26,52,76,44,32,152,4,0,9,136,513,154,359,1175,114,76,332,0,6,2355,3383,13,217,37,120,0,387,500,1360,6110
ANDHRA PRADESH,CYBERABAD,2012,198,113,10,321,75,0,75,150,158,102,56,316,14,0,86,1101,4461,1887,2574,10123,28,168,1762,8,48,4013,7122,45,183,282,976,0,1486,1095,3155,17979
ANDHRA PRADESH,EAST GODAVARI,2012,70,94,3,167,71,0,71,142,54,40,14,108,1,0,16,345,861,281,580,2084,31,82,204,16,38,2222,3152,17,248,160,536,0,961,559,1317,6945
ANDHRA PRADESH,GUNTAKAL RLY.,2012,7,0,0,7,1,0,1,2,1,0,1,2,1,0,3,0,268,0,268,540,1,1,0,13,1,11,29,1,1,1,2,0,5,2,24,339
ANDHRA PRADESH,GUNTUR,2012,96,68,1,165,23,0,23,46,63,53,10,126,0,0,6,146,708,176,532,1568,31,25,261,25,33,2309,3145,21,252,83,656,0,1012,461,2103,7371
ANDHRA PRADESH,GUNTUR URBAN,2012,56,53,3,112,24,0,24,48,42,32,10,84,2,0,29,155,904,409,495,1994,11,16,294,7,15,1072,1644,9,84,83,687,0,863,229,912,4687
ANDHRA PRADESH,HYDERABAD CITY,2012,102,166,6,274,74,0,74,148,88,31,57,176,12,0,57,647,3694,1370,2324,8104,354,71,2131,25,101,3381,6566,23,145,141,1339,0,1648,503,2932,15992
ANDHRA PRADESH,KARIMNAGAR,2012,128,112,11,251,40,0,40,80,141,98,43,282,4,0,25,326,860,228,632,2075,112,65,678,3,63,2636,4131,46,224,232,759,0,1261,574,1952,8991
ANDHRA PRADESH,KHAMMAM,2012,130,110,7,247,78,0,78,156,73,62,11,146,5,0,14,284,528,157,371,1359,150,22,251,9,33,1956,2968,13,233,172,231,0,649,547,1195,6041
ANDHRA PRADESH,KRISHNA,2012,78,53,1,132,67,0,67,134,67,55,12,134,2,0,9,263,673,139,534,1620,26,54,218,7,52,2601,3373,16,341,309,791,0,1457,415,1168,7211
ANDHRA PRADESH,KURNOOL,2012,111,143,4,258,22,0,22,44,58,46,12,116,3,0,18,246,518,4,514,1303,71,13,329,5,34,2382,3383,15,331,75,166,0,587,549,1594,6687
ANDHRA PRADESH,MAHABOOBNAGAR,2012,182,90,15,287,56,0,56,112,76,70,6,152,3,0,16,235,961,9,952,2176,58,24,189,4,38,1870,2979,27,154,45,204,0,430,796,1442,6485
ANDHRA PRADESH,MEDAK,2012,113,43,5,161,26,0,26,52,54,45,9,108,6,0,17,409,693,158,535,1818,130,21,324,2,52,1674,2844,20,112,55,475,0,662,641,1198,6070
ANDHRA PRADESH,NALGONDA,2012,86,88,6,180,52,0,52,104,89,79,10,178,9,0,20,323,802,191,611,1956,115,44,400,5,70,2995,4429,20,246,264,302,0,832,800,2198,8934
ANDHRA PRADESH,NELLORE,2012,94,86,1,181,23,0,23,46,90,72,18,180,5,0,42,292,833,255,578,2005,22,107,163,5,45,2550,3382,9,210,142,405,0,766,490,1240,6854
ANDHRA PRADESH,NIZAMABAD,2012,113,48,12,173,35,0,35,70,38,23,15,76,4,0,15,345,613,178,435,1590,66,33,297,3,47,1332,2222,19,100,102,596,0,817,444,1280,5542
ANDHRA PRADESH,PRAKASHAM,2012,108,117,5,230,37,0,37,74,84,69,15,168,2,0,27,258,674,230,444,1635,41,68,362,9,19,2523,3513,16,213,47,263,0,539,491,1311,6675
ANDHRA PRADESH,RAJAHMUNDRY,2012,23,25,3,51,13,0,13,26,9,5,4,18,0,0,7,120,337,99,238,801,0,34,93,1,5,734,1038,3,49,35,183,0,270,171,280,2125
ANDHRA PRADESH,RANGA REDDY,2012,72,27,5,104,27,0,27,54,22,21,1,44,5,0,11,148,175,33,142,514,22,5,79,0,26,600,922,16,58,31,152,0,257,190,423,2094
ANDHRA PRADESH,SECUNDERABAD RLY.,2012,4,0,0,4,2,0,2,4,0,0,0,0,0,0,3,0,787,0,787,1577,0,0,4,13,0,9,30,0,5,5,0,0,10,4,80,916
ANDHRA PRADESH,SRIKAKULAM,2012,35,40,1,76,39,0,39,78,18,18,0,36,1,0,9,112,179,7,172,480,9,14,107,1,21,1511,1935,3,116,69,312,0,500,272,949,3818
ANDHRA PRADESH,TIRUPATHI URBAN,2012,37,29,2,68,12,0,12,24,25,14,11,50,0,0,13,188,630,197,433,1461,22,7,172,2,6,672,1078,6,21,11,96,0,134,197,461,2609
ANDHRA PRADESH,VIJAYAWADA CITY,2012,42,56,6,104,47,0,47,94,66,39,27,132,1,0,60,221,1385,567,818,3052,16,123,416,6,33,1961,2925,16,223,418,1136,0,1793,370,1084,7686
ANDHRA PRADESH,VIJAYAWADA RLY.,2012,7,1,0,8,0,0,0,0,3,3,0,6,3,0,4,0,597,0,597,1201,0,0,0,50,0,18,71,0,5,6,1,0,12,3,34,732
ANDHRA PRADESH,VISAKHA RURAL,2012,67,29,4,100,27,0,27,54,22,13,9,44,0,0,3,120,224,76,148,571,52,16,84,4,13,992,1497,9,67,20,134,0,230,336,510,2733
ANDHRA PRADESH,VISAKHAPATNAM,2012,44,27,1,72,50,0,50,100,27,20,7,54,14,0,27,366,1062,301,761,2531,12,68,252,6,10,1207,1950,11,23,11,412,0,457,395,601,4626
ANDHRA PRADESH,VIZIANAGARAM,2012,44,36,7,87,44,0,44,88,21,20,1,42,2,0,4,162,263,2,261,694,1,11,118,0,15,1504,1938,3,96,103,363,0,565,289,1396,4482
ANDHRA PRADESH,WARANGAL,2012,75,47,10,132,56,0,56,112,66,58,8,132,3,0,22,262,388,69,319,1063,173,5,197,6,25,1482,2194,20,117,34,101,0,272,306,1327,4722
ANDHRA PRADESH,WARANGAL URBAN,2012,41,17,1,59,30,0,30,60,41,39,2,82,2,0,14,193,421,98,323,1051,70,3,281,1,8,1071,1660,9,71,74,267,0,421,226,742,3583
ANDHRA PRADESH,WEST GODAVARI,2012,91,91,4,186,130,0,130,260,86,59,27,172,4,0,52,452,1008,294,714,2524,11,49,403,14,37,2313,3405,19,296,235,757,0,1307,578,1237,7867
ARUNACHAL PRADESH,ANJAW,2012,0,0,0,0,0,0,0,0,1,1,0,2,0,0,0,3,2,0,2,7,0,1,0,0,0,3,4,0,0,0,0,0,0,0,5,15
ARUNACHAL PRADESH,CHANGLANG,2012,7,6,0,13,6,0,6,12,12,7,5,24,2,0,4,22,31,0,31,90,4,6,4,0,0,42,59,1,5,0,4,0,10,3,64,223
ARUNACHAL PRADESH,DIBANG VALLEY,2012,4,0,0,4,2,0,2,4,5,4,1,10,2,0,2,8,16,4,12,44,0,0,1,1,1,13,22,0,2,0,1,0,3,6,14,78
ARUNACHAL PRADESH,K/KUMEY,2012,1,0,0,1,2,0,2,4,1,1,0,2,1,0,0,0,5,0,5,11,0,2,1,0,0,6,10,0,1,0,0,0,1,1,8,29
ARUNACHAL PRADESH,KAMENG EAST,2012,9,1,1,11,6,0,6,12,2,2,0,4,2,0,4,8,9,0,9,32,0,2,8,0,0,43,58,0,1,0,0,0,1,5,39,140
ARUNACHAL PRADESH,KAMENG WEST,2012,6,1,0,7,0,0,0,0,3,1,2,6,1,0,1,11,14,4,10,41,0,2,1,0,0,30,51,0,1,0,2,0,3,18,21,112
ARUNACHAL PRADESH,LOHIT,2012,11,4,0,15,3,0,3,6,12,5,7,24,1,0,7,28,38,7,31,112,0,6,5,0,0,20,48,0,11,0,2,0,13,17,61,226
ARUNACHAL PRADESH,PAPUM PARE,2012,4,5,0,9,7,0,7,14,20,15,5,40,4,0,15,30,102,40,62,253,10,13,40,0,17,62,157,0,8,2,3,0,13,15,148,505
ARUNACHAL PRADESH,RURAL,2012,6,1,0,7,6,0,6,12,4,3,1,8,0,0,1,9,11,5,6,32,2,5,6,0,2,20,38,0,8,0,1,0,9,3,19,104
ARUNACHAL PRADESH,SIANG EAST,2012,5,0,0,5,6,0,6,12,1,0,1,2,2,0,6,16,46,15,31,116,0,1,2,0,1,16,30,0,4,0,1,0,5,10,53,170
ARUNACHAL PRADESH,SIANG UPPER,2012,1,1,0,2,1,0,1,2,3,3,0,6,1,0,0,6,11,0,11,29,5,2,3,0,1,7,20,0,0,0,3,0,3,2,4,51
ARUNACHAL PRADESH,SIANG WEST,2012,4,1,0,5,2,0,2,4,4,4,0,8,0,0,8,18,38,12,26,102,4,7,2,0,4,54,76,0,6,0,7,0,13,5,54,218
ARUNACHAL PRADESH,SUBANSIRI LOWER,2012,4,1,0,5,0,0,0,0,4,2,2,8,1,0,7,12,12,3,9,44,0,5,4,0,3,33,49,0,5,0,2,0,7,4,39,136
ARUNACHAL PRADESH,SUBANSIRI UPPER,2012,3,0,0,3,4,0,4,8,4,4,0,8,0,0,4,5,19,0,19,47,0,0,3,0,3,61,71,0,11,0,0,0,11,4,47,168
ARUNACHAL PRADESH,TAWANG,2012,2,0,0,2,0,0,0,0,0,0,0,0,0,0,1,8,16,0,16,41,1,1,1,0,0,2,6,0,1,0,0,0,1,1,12,46
ARUNACHAL PRADESH,TIRAP,2012,6,7,0,13,1,0,1,2,6,6,0,12,3,0,5,26,31,5,26,96,2,2,4,0,1,25,34,0,2,0,0,0,2,0,66,187
ARUNACHAL PRADESH,UPPER DIBANG VALLEY,2012,0,1,0,1,0,0,0,0,0,0,0,0,0,0,0,5,1,0,1,7,0,0,0,0,0,1,1,0,1,0,0,0,1,0,3,12
ASSAM,BAKSA,2012,38,7,0,45,33,0,33,66,62,50,12,124,5,0,14,22,104,26,78,249,3,6,14,0,4,66,124,3,4,0,15,0,22,31,233,664
ASSAM,BARPETA,2012,34,21,1,56,98,0,98,196,225,224,1,450,18,0,42,165,214,55,159,653,314,164,83,1,39,225,990,5,67,0,638,0,710,164,2246,4764
ASSAM,BIEO,2012,0,0,0,0,0,0,0,0,0,0,0,0,0,0,0,0,0,0,0,0,0,16,0,0,0,0,16,0,0,0,0,0,0,0,0,16
ASSAM,BONGAIGAON,2012,17,9,0,26,50,0,50,100,73,59,14,146,9,1,5,63,147,52,95,372,54,25,21,4,7,150,333,6,15,0,169,0,190,72,484,1381
ASSAM,C.I.D.,2012,1,0,0,1,4,0,4,8,2,1,1,4,0,0,0,0,5,0,5,10,0,3,0,0,0,0,3,0,0,0,0,0,0,0,50,65
ASSAM,CACHAR,2012,72,0,0,72,94,0,94,188,175,163,12,350,13,0,13,264,573,198,375,1436,226,51,75,0,18,475,931,19,11,0,551,0,581,86,1942,4658
ASSAM,CHIRANG,2012,40,4,0,44,24,0,24,48,40,30,10,80,5,0,6,59,63,18,45,196,23,12,6,1,29,16,99,0,11,0,78,0,89,12,289,718
ASSAM,DARRANG,2012,36,3,0,39,88,0,88,176,191,168,23,382,9,0,16,160,160,41,119,505,48,83,97,0,10,300,606,9,246,0,387,0,642,68,696,2607
ASSAM,DHEMAJI,2012,24,10,0,34,74,0,74,148,87,61,26,174,5,0,15,40,101,29,72,262,11,13,32,0,7,96,180,2,17,0,82,0,101,21,470,1107
ASSAM,DHUBRI,2012,65,46,1,112,159,0,159,318,315,305,10,630,12,1,20,189,254,57,197,730,572,121,144,9,56,590,1554,13,218,1,729,0,961,62,1056,4633
ASSAM,DIBRUGARH,2012,81,33,2,116,50,0,50,100,134,75,59,268,8,0,25,117,560,128,432,1270,24,68,33,3,23,256,514,0,138,0,316,0,454,107,1019,2997
ASSAM,G.R.P.,2012,15,0,0,15,3,0,3,6,4,3,1,8,4,0,16,8,154,7,147,336,33,10,46,2,10,3,129,2,3,1,10,0,16,25,162,511
ASSAM,GOALPARA,2012,55,44,3,102,65,0,65,130,84,68,16,168,20,2,32,134,293,132,161,774,108,0,56,0,32,170,452,3,97,0,323,0,423,86,808,2415
ASSAM,GOLAGHAT,2012,58,34,0,92,60,0,60,120,181,154,27,362,8,2,54,100,231,77,154,626,16,9,58,4,25,474,787,1,72,0,226,0,299,201,431,2245
ASSAM,GUWAHATI CITY,2012,83,6,3,92,78,0,78,156,341,326,15,682,14,0,275,816,2426,870,1556,5957,40,173,330,19,11,320,1058,9,90,0,237,0,336,165,3294,8730
ASSAM,HAILAKANDI,2012,24,13,0,37,56,0,56,112,96,65,31,192,11,0,6,33,149,23,126,348,176,14,40,0,15,51,328,6,52,0,125,0,183,32,423,1322
ASSAM,HAMREN,2012,9,0,0,9,3,0,3,6,16,12,4,32,0,0,3,19,36,3,33,94,3,9,1,0,3,21,46,0,2,0,3,0,5,9,13,150
ASSAM,JORHAT,2012,36,36,0,72,42,0,42,84,106,95,11,212,3,0,41,124,435,136,299,1038,11,45,117,2,14,332,699,1,53,0,254,0,308,178,782,2612
ASSAM,KAMRUP,2012,48,11,2,61,54,0,54,108,121,107,14,242,14,0,22,125,361,117,244,883,58,49,61,3,9,173,464,5,70,0,172,0,247,111,3553,5022
ASSAM,KARBI ANGLONG,2012,35,24,1,60,28,0,28,56,58,50,8,116,4,0,5,34,177,63,114,397,16,15,10,0,7,53,131,0,4,0,30,0,34,30,293,824
ASSAM,KARIMGANJ,2012,36,22,0,58,32,0,32,64,85,85,0,170,15,0,9,122,197,23,174,540,59,31,29,2,21,106,286,11,4,0,262,0,277,38,1129,2210
ASSAM,KOKRAJHAR,2012,110,42,0,152,27,0,27,54,90,65,25,180,4,0,6,77,220,77,143,527,2818,29,28,0,2350,97,5352,3,31,0,84,2,120,30,411,6459
ASSAM,LAKHIMPUR,2012,37,10,13,60,62,0,62,124,128,97,31,256,6,0,15,105,184,48,136,494,18,10,12,0,0,86,247,0,25,0,19,0,44,121,1117,1968
ASSAM,MORIGAON,2012,20,33,0,53,58,0,58,116,88,88,0,176,5,1,13,58,98,33,65,273,109,18,50,2,3,436,741,4,25,0,115,0,144,123,190,1449
ASSAM,N.C.HILLS,2012,15,13,11,39,5,0,5,10,23,13,10,46,0,0,0,16,35,0,35,86,7,2,10,1,4,38,62,0,0,0,0,0,0,0,69,249
ASSAM,NAGAON,2012,74,86,9,169,173,0,173,346,351,348,3,702,39,0,93,337,540,159,381,1549,184,94,109,2,63,828,1430,10,245,3,875,0,1133,150,1715,5980
ASSAM,NALBARI,2012,22,3,1,26,34,0,34,68,101,89,12,202,7,0,25,110,177,57,120,496,27,34,47,1,5,339,497,3,83,0,131,0,217,44,607,1801
ASSAM,R.P.O.,2012,2,0,0,2,0,0,0,0,8,6,2,16,2,0,0,4,4,0,4,14,0,0,0,1,0,0,1,0,0,0,0,0,0,0,79,100
ASSAM,SIBSAGAR,2012,71,60,0,131,78,0,78,156,168,153,15,336,5,0,32,145,427,100,327,1036,24,26,98,3,17,282,525,5,134,0,269,0,408,75,767,2686
ASSAM,SONITPUR,2012,91,41,1,133,97,0,97,194,241,220,21,482,14,0,34,220,464,116,348,1196,72,65,46,0,29,341,958,11,39,0,124,0,174,405,1645,3980
ASSAM,TINSUKIA,2012,86,32,6,124,64,0,64,128,160,142,18,320,5,0,61,128,496,35,461,1186,10,69,32,1,8,202,410,1,43,0,137,0,181,88,915,2544
ASSAM,UDALGURI,2012,33,27,0,60,23,0,23,46,58,38,20,116,2,0,9,31,109,40,69,260,13,14,20,0,11,150,239,8,41,0,46,0,95,31,189,815
BIHAR,ARARIA,2012,81,107,15,203,53,0,53,106,122,78,44,244,7,2,16,39,220,37,183,504,190,16,34,0,38,514,890,21,8,7,32,0,68,98,906,2526
BIHAR,ARWAL,2012,20,72,5,97,5,0,5,10,26,24,2,52,1,0,6,29,60,3,57,156,32,11,16,0,4,375,463,13,0,0,22,0,35,25,136,858
BIHAR,AURANGABAD,2012,89,192,2,283,22,0,22,44,71,58,13,142,32,0,45,73,330,63,267,810,320,42,95,0,22,1148,1803,27,2,0,110,0,139,176,481,3279
BIHAR,BAGAHA,2012,43,0,0,43,11,0,11,22,76,69,7,152,2,0,8,48,126,17,109,310,150,43,22,0,43,43,324,9,0,0,37,0,46,23,1045,1729
BIHAR,BANKA,2012,76,35,3,114,17,0,17,34,52,45,7,104,15,1,24,45,136,25,111,357,201,21,39,0,12,787,1170,17,0,0,37,0,54,110,173,1801
BIHAR,BEGUSARAI,2012,120,261,0,381,11,0,11,22,143,113,30,286,14,0,53,107,425,125,300,1024,295,21,46,0,29,1469,1956,27,0,0,79,0,106,96,521,3717
BIHAR,BETTIAH,2012,83,150,5,238,35,0,35,70,166,141,25,332,6,2,24,136,653,183,470,1474,483,68,115,7,20,2392,3164,28,0,0,20,0,48,79,601,5073
BIHAR,BHABHUA,2012,48,43,23,114,10,0,10,20,45,38,7,90,3,0,16,54,238,95,143,549,129,31,16,0,28,902,1148,21,0,0,42,0,63,42,176,1867
BIHAR,BHAGALPUR,2012,99,77,6,182,31,0,31,62,132,106,26,264,9,4,51,140,360,140,220,924,271,52,99,3,14,762,1308,24,0,4,119,0,147,107,770,3134
BIHAR,BHOJPUR,2012,71,121,6,198,9,0,9,18,74,69,5,148,13,1,21,115,345,86,259,840,137,12,78,0,18,2188,2511,38,0,0,56,0,94,78,465,3846
BIHAR,BUXAR,2012,56,110,7,173,21,0,21,42,89,70,19,178,13,0,36,107,306,104,202,768,218,65,81,2,38,345,792,28,29,0,86,0,143,43,886,2566
BIHAR,DARBHANGA,2012,78,407,24,509,44,0,44,88,207,150,57,414,9,5,46,86,460,166,294,1066,812,148,174,1,25,1894,3408,34,0,1,377,0,412,354,1128,6314
BIHAR,GAYA,2012,153,39,4,196,35,0,35,70,154,120,34,308,39,4,46,147,687,407,280,1610,397,28,165,1,7,772,1682,53,0,0,92,0,145,312,2947,6082
BIHAR,GOPALGANJ,2012,103,37,3,143,20,0,20,40,135,89,46,270,13,0,17,71,274,122,152,649,339,51,130,1,21,2173,2775,43,0,0,190,0,233,60,278,3959
BIHAR,JAMALPUR RLY.,2012,8,9,0,17,1,0,1,2,2,0,2,4,3,0,8,0,186,16,170,383,4,0,0,0,0,28,32,0,0,0,0,0,0,0,15,264
BIHAR,JAMUI,2012,79,137,16,232,27,0,27,54,56,43,13,112,15,0,34,55,149,27,122,402,181,18,55,0,16,482,814,18,2,0,65,0,85,62,285,1752
BIHAR,JEHANABAD,2012,46,12,2,60,8,0,8,16,47,41,6,94,4,0,14,29,160,30,130,367,103,7,17,0,3,647,813,24,0,0,37,0,61,36,252,1448
BIHAR,KATIHAR,2012,91,94,2,187,73,0,73,146,137,112,25,274,13,2,32,62,400,176,224,909,229,106,86,1,32,1662,2236,24,1,1,111,0,137,120,793,4072
BIHAR,KATIHAR RLY.,2012,13,1,1,15,0,0,0,0,8,6,2,16,3,0,4,3,166,8,158,342,1,2,5,0,1,34,45,0,1,0,1,0,2,2,71,317
BIHAR,KHAGARIA,2012,65,72,2,139,18,0,18,36,53,34,19,106,7,0,19,14,134,39,95,308,151,3,29,0,14,1151,1446,12,0,0,41,0,53,98,374,2257
BIHAR,KISHANGANJ,2012,39,0,1,40,32,0,32,64,72,71,1,144,8,0,6,51,150,51,99,365,174,39,10,1,2,227,485,19,0,0,50,0,69,32,507,1420
BIHAR,LAKHISARAI,2012,40,86,2,128,13,0,13,26,39,28,11,78,7,0,13,26,107,26,81,260,141,10,48,0,6,290,552,10,3,0,55,0,68,57,285,1238
BIHAR,MADHEPURA,2012,56,130,4,190,31,0,31,62,77,56,21,154,10,2,37,30,203,56,147,485,314,42,58,0,12,1102,1553,15,0,2,46,0,63,25,97,2293
BIHAR,MADHUBANI,2012,77,71,0,148,31,0,31,62,191,163,28,382,19,0,20,102,427,111,316,995,454,20,30,3,5,2109,2762,27,0,0,195,0,222,141,965,4887
BIHAR,MOTIHARI,2012,124,735,6,865,22,0,22,44,233,198,35,466,27,1,46,213,553,154,399,1393,728,104,182,5,21,1468,2563,67,0,16,156,0,239,55,3071,7833
BIHAR,MUNGER,2012,68,32,3,103,9,0,9,18,65,49,16,130,8,1,28,33,166,39,127,402,140,42,90,4,1,415,751,8,1,0,40,0,49,59,616,1829
BIHAR,MUZAFFARPUR,2012,198,611,12,821,34,0,34,68,279,220,59,558,48,1,73,284,1469,751,718,3344,427,28,292,0,8,2219,3172,83,0,0,80,3,166,198,959,7306
BIHAR,MUZAFFARPUR RLY.,2012,11,0,2,13,2,0,2,4,1,0,1,2,3,0,10,3,301,50,251,618,12,0,11,0,0,0,23,0,0,0,0,0,0,0,197,553
BIHAR,NALANDA,2012,114,75,34,223,11,0,11,22,113,85,28,226,6,2,16,67,269,82,187,629,174,41,220,1,14,2540,3087,79,7,1,116,0,203,97,996,4993
BIHAR,NAUGACHIA,2012,47,95,12,154,2,0,2,4,21,18,3,42,2,0,8,17,60,17,43,147,119,11,41,0,4,637,863,10,0,0,64,0,74,51,293,1494
BIHAR,NAWADAH,2012,82,30,4,116,18,0,18,36,89,57,32,178,5,1,18,52,187,70,117,450,261,61,102,0,12,602,1193,29,0,0,13,0,42,155,1008,2729
BIHAR,PATNA,2012,356,86,17,459,49,0,49,98,376,300,76,752,38,0,119,552,3114,1503,1611,6937,522,9,748,4,12,4157,5962,97,19,1,377,0,494,510,2852,14015
BIHAR,PATNA RLY.,2012,11,9,0,20,2,0,2,4,8,5,3,16,6,4,9,0,777,59,718,1573,11,2,13,1,0,13,40,3,16,0,2,0,21,0,201,1088
BIHAR,PURNEA,2012,97,228,2,327,39,0,39,78,142,95,47,284,16,3,17,68,171,60,111,446,175,109,143,0,137,2014,2729,17,8,4,0,1,30,151,411,3953
BIHAR,ROHTAS,2012,132,214,4,350,26,0,26,52,130,94,36,260,23,0,34,183,583,195,388,1406,222,13,78,0,12,593,1102,44,15,0,92,0,151,184,1083,3665
BIHAR,SAHARSA,2012,53,198,6,257,16,0,16,32,95,76,19,190,1,0,35,44,194,64,130,468,251,54,74,2,14,303,751,10,0,0,72,0,82,53,946,2421
BIHAR,SAMASTIPUR,2012,99,241,15,355,24,0,24,48,131,112,19,262,7,5,38,55,351,108,243,807,320,49,82,1,57,428,1096,34,0,0,114,0,148,159,2607,4817
BIHAR,SARAN,2012,128,289,13,430,23,0,23,46,178,137,41,356,17,1,37,144,651,189,462,1501,370,36,93,0,32,734,1419,74,0,0,138,0,212,154,2142,5254
BIHAR,SHEIKHPURA,2012,30,88,2,120,10,0,10,20,39,27,12,78,6,0,8,34,73,20,53,194,65,37,28,1,1,426,583,8,0,0,37,0,45,25,271,1189
BIHAR,SHEOHAR,2012,20,6,0,26,2,0,2,4,32,22,10,64,5,2,6,9,76,20,56,174,51,5,6,0,7,329,405,9,3,0,9,0,21,7,19,603
BIHAR,SITAMARHI,2012,97,35,7,139,20,0,20,40,167,143,24,334,27,6,41,118,482,231,251,1156,170,11,24,0,28,2047,2433,30,0,0,100,0,130,153,419,3982
BIHAR,SIWAN,2012,112,55,0,167,20,0,20,40,193,166,27,386,8,0,33,108,430,203,227,1009,379,14,154,0,4,75,753,64,2,0,101,0,167,127,2500,4379
BIHAR,SUPAUL,2012,31,9,0,40,20,0,20,40,118,90,28,236,8,3,14,53,233,45,188,544,316,71,50,0,9,1243,1787,15,0,0,79,0,94,98,256,2626
BIHAR,VAISHALI,2012,122,153,13,288,20,0,20,40,223,171,52,446,14,1,80,152,825,431,394,1897,432,97,54,1,16,2088,2907,62,1,0,196,0,259,219,417,5186
CHHATTISGARH,BALOD,2012,15,2,2,19,22,0,22,44,7,6,1,14,2,0,6,70,75,25,50,228,14,1,27,1,4,24,164,4,50,1,9,0,64,93,688,1117
CHHATTISGARH,BALODA BAZAR,2012,24,18,2,44,45,0,45,90,18,18,0,36,3,0,26,182,181,57,124,573,39,6,18,0,20,858,1072,0,98,10,37,0,145,131,655,2371
CHHATTISGARH,BALRAMPUR,2012,39,18,0,57,64,0,64,128,5,0,5,10,4,0,7,33,48,0,48,140,14,3,14,0,3,87,191,0,52,2,30,0,84,70,457,950
CHHATTISGARH,BEMETARA,2012,12,15,0,27,24,0,24,48,19,18,1,38,0,0,8,57,105,35,70,275,19,0,16,1,6,30,159,3,61,5,29,0,98,87,826,1323
CHHATTISGARH,BILASPUR,2012,74,42,1,117,47,0,47,94,33,28,5,66,7,0,65,428,484,240,244,1468,140,11,82,12,25,1612,2059,10,169,11,95,0,285,177,1051,4576
CHHATTISGARH,BIZAPUR,2012,46,58,0,104,4,0,4,8,3,3,0,6,7,0,7,13,14,2,12,55,3,0,1,2,3,10,39,0,5,0,1,0,6,20,94,291
CHHATTISGARH,DANTEWARA,2012,40,12,1,53,7,0,7,14,1,1,0,2,3,0,0,17,16,4,12,52,7,0,5,0,7,16,79,0,4,0,5,0,9,44,175,360
CHHATTISGARH,DHAMTARI,2012,17,7,1,25,21,0,21,42,2,2,0,4,0,0,7,97,95,46,49,294,14,4,24,1,3,51,190,1,36,11,15,0,63,93,647,1147
CHHATTISGARH,DURG,2012,52,44,1,97,91,0,91,182,55,47,8,110,1,0,32,377,793,362,431,1996,31,17,125,1,21,165,621,9,178,25,111,0,323,261,5081,7471
CHHATTISGARH,GARIYABAND,2012,13,13,2,28,19,0,19,38,6,2,4,12,2,0,5,53,75,20,55,210,18,2,12,0,6,267,348,1,28,5,6,0,40,43,255,831
CHHATTISGARH,GRP RAIPUR,2012,3,1,1,5,2,0,2,4,7,6,1,14,0,0,2,3,196,10,186,397,0,0,2,0,0,9,11,0,5,0,2,0,7,0,56,289
CHHATTISGARH,JAGDALPUR,2012,42,22,2,66,36,0,36,72,11,10,1,22,0,0,9,76,81,48,33,247,27,3,18,3,21,455,641,0,20,0,8,0,28,114,506,1454
CHHATTISGARH,JANJGIR,2012,51,16,1,68,33,0,33,66,21,19,2,42,2,0,32,236,379,188,191,1028,123,14,50,1,23,1162,1546,11,104,13,123,0,251,173,719,3287
CHHATTISGARH,JASHPUR,2012,54,27,1,82,80,0,80,160,60,19,41,120,1,1,10,67,81,31,50,241,18,8,23,0,6,77,203,2,29,0,31,0,62,71,590,1237
CHHATTISGARH,KABIRDHAM,2012,17,20,0,37,22,0,22,44,14,14,0,28,0,0,11,62,69,12,57,211,25,0,23,0,3,564,669,1,58,2,20,0,81,54,411,1376
CHHATTISGARH,KANKER,2012,32,21,1,54,23,0,23,46,9,6,3,18,5,0,5,30,39,22,17,118,15,2,13,0,10,17,142,2,18,1,19,0,40,85,660,1007
CHHATTISGARH,KONDAGAON,2012,21,8,0,29,11,0,11,22,7,0,7,14,0,0,0,20,23,0,23,66,3,0,3,0,2,126,188,0,4,3,2,0,9,54,250,537
CHHATTISGARH,KORBA,2012,44,9,1,54,43,0,43,86,16,15,1,32,1,0,8,114,180,87,93,483,33,9,41,4,11,692,940,4,59,7,42,0,112,150,749,2217
CHHATTISGARH,KORIYA,2012,38,17,0,55,42,0,42,84,13,12,1,26,0,0,8,104,77,31,46,266,27,1,21,3,13,596,729,5,86,2,65,0,158,68,395,1581
CHHATTISGARH,MAHASAMUND,2012,33,9,0,42,28,0,28,56,38,37,1,76,1,0,15,144,174,64,110,508,51,7,38,3,9,98,334,4,63,4,33,0,104,128,1240,2120
CHHATTISGARH,MUNGELI,2012,18,4,0,22,6,0,6,12,13,13,0,26,0,0,9,83,94,24,70,280,40,5,13,0,12,31,140,2,24,3,26,0,55,39,590,1012
CHHATTISGARH,NARAYANPUR,2012,12,20,0,32,5,0,5,10,6,1,5,12,11,0,1,7,7,2,5,33,0,1,5,0,7,26,54,0,4,2,0,0,6,15,57,186
CHHATTISGARH,RAIGARH,2012,61,41,6,108,69,0,69,138,15,14,1,30,2,0,51,237,430,259,171,1150,63,21,31,4,10,659,989,6,81,8,55,0,150,201,1002,3053
CHHATTISGARH,RAIPUR,2012,56,46,2,104,111,0,111,222,22,14,8,44,3,1,46,536,1238,652,586,3062,102,35,214,8,47,2599,3344,8,148,38,109,0,303,339,2615,8323
CHHATTISGARH,RAJNANDGAON,2012,45,29,1,75,31,0,31,62,9,7,2,18,1,0,17,145,173,74,99,509,19,7,49,9,29,71,346,3,52,7,17,0,79,162,2159,3035
CHHATTISGARH,SARGUJA,2012,56,28,0,84,73,0,73,146,18,18,0,36,2,2,13,73,124,46,78,338,36,7,19,0,15,58,223,0,89,1,25,0,115,88,1015,1742
CHHATTISGARH,SUKMA,2012,24,30,0,54,1,0,1,2,7,5,2,14,6,0,3,8,7,2,5,31,3,0,2,0,10,14,44,0,2,0,2,0,4,15,71,205
CHHATTISGARH,SURAJPUR,2012,59,16,0,75,74,0,74,148,15,15,0,30,0,0,9,62,83,15,68,237,26,6,36,0,4,481,666,5,74,1,63,0,143,113,373,1500
GOA,NORTH GOA,2012,28,20,3,51,26,0,26,52,15,10,5,30,3,0,11,189,563,175,388,1329,72,34,131,11,19,151,550,0,29,14,11,0,54,132,640,2102
GOA,SOUTH GOA,2012,17,15,0,32,29,0,29,58,9,6,3,18,3,0,14,167,352,125,227,888,50,30,74,5,15,115,390,0,20,2,13,0,35,101,475,1506
GUJARAT,AHMEDABAD COMMR.,2012,90,49,7,146,63,0,63,126,229,183,46,458,24,0,603,701,3622,2252,1370,8572,159,298,246,21,16,1320,2302,11,79,7,1448,0,1545,242,12112,21347
GUJARAT,AHMEDABAD RURAL,2012,34,33,8,75,5,0,5,10,67,67,0,134,15,0,30,125,324,123,201,818,73,64,15,8,3,518,1010,0,33,0,163,0,196,329,1826,3673
GUJARAT,AHWA-DANG,2012,7,0,0,7,1,0,1,2,1,1,0,2,1,0,0,9,10,3,7,30,5,0,5,0,2,14,47,0,1,1,8,0,10,21,123,209
GUJARAT,AMRELI,2012,18,19,2,39,10,0,10,20,80,75,5,160,2,0,13,114,149,53,96,427,56,30,6,7,4,277,508,0,20,7,146,0,173,128,1213,2301
GUJARAT,ANAND,2012,25,24,2,51,9,0,9,18,56,53,3,112,3,0,6,110,283,174,109,685,27,45,36,7,6,316,671,0,22,1,188,0,211,234,1591,2991
GUJARAT,BHARUCH,2012,42,12,0,54,12,0,12,24,28,22,6,56,12,0,25,117,302,171,131,758,44,68,10,10,5,270,731,0,19,1,0,0,20,324,1480,2781
GUJARAT,BHAVNAGAR,2012,46,23,1,70,13,0,13,26,105,96,9,210,2,1,30,160,408,216,192,1009,71,18,43,12,19,592,755,0,30,42,221,0,293,0,2538,4375
GUJARAT,CID CRIME,2012,1,0,0,1,1,0,1,2,0,0,0,0,0,0,0,0,0,0,0,0,0,7,5,0,0,0,12,0,0,0,0,0,0,0,1,15
GUJARAT,DAHOD,2012,34,13,0,47,10,0,10,20,72,67,5,144,38,3,51,150,202,124,78,646,55,8,8,0,20,353,624,0,17,0,7,0,24,180,462,1683
GUJARAT,GANDHINAGAR,2012,23,4,1,28,20,0,20,40,29,26,3,58,6,0,26,127,376,189,187,911,52,24,53,4,6,215,565,0,10,1,159,0,170,211,5183,6530
GUJARAT,HIMATNAGAR,2012,30,6,1,37,10,0,10,20,57,55,2,114,5,1,9,103,205,114,91,528,52,20,72,9,4,171,612,0,22,4,249,0,275,284,5097,6411
GUJARAT,JAMNAGAR,2012,43,40,2,85,22,0,22,44,41,37,4,82,10,3,48,220,587,256,331,1455,96,53,41,4,4,482,682,0,40,4,439,0,483,2,2849,5030
GUJARAT,JUNAGADH,2012,40,17,0,57,15,0,15,30,63,53,10,126,7,0,18,120,275,140,135,695,117,28,34,9,19,464,915,1,37,5,411,0,454,244,1991,3915
GUJARAT,KHEDA NORTH,2012,24,8,0,32,18,0,18,36,62,55,7,124,10,0,11,67,206,90,116,500,43,28,26,5,6,280,684,0,22,0,161,0,183,296,3819,5092
GUJARAT,KUTCH (EAST(G)),2012,19,15,0,34,17,0,17,34,25,23,2,50,3,1,18,98,256,121,135,632,24,18,32,1,8,287,375,1,12,0,188,0,201,5,2002,3030
GUJARAT,KUTCH (WEST-BHUJ),2012,24,5,1,30,8,0,8,16,18,17,1,36,2,0,6,73,168,80,88,417,50,16,13,1,2,185,270,0,18,0,127,0,145,3,1086,1806
GUJARAT,MEHSANA,2012,31,28,2,61,10,0,10,20,59,54,5,118,10,1,35,182,545,206,339,1318,86,35,46,11,18,410,847,0,28,1,245,0,274,241,3329,5353
GUJARAT,NARMADA,2012,17,3,0,20,7,0,7,14,6,5,1,12,3,0,0,7,39,17,22,88,15,4,2,3,2,94,207,0,3,0,13,0,16,87,369,674
GUJARAT,NAVSARI,2012,19,9,0,28,4,0,4,8,15,15,0,30,3,0,7,99,224,131,93,557,18,49,10,8,2,65,152,0,4,0,114,0,118,0,892,1542
GUJARAT,PALANPUR,2012,44,32,1,77,49,0,49,98,118,107,11,236,23,0,48,268,433,206,227,1205,79,31,63,8,21,462,929,0,64,1,349,0,414,265,2508,4867
GUJARAT,PANCHMAHAL,2012,54,16,1,71,5,0,5,10,74,73,1,148,25,0,20,114,231,142,89,621,52,21,17,8,20,375,493,0,36,0,294,0,330,0,2314,3677
GUJARAT,PATAN,2012,18,15,1,34,7,0,7,14,31,31,0,62,11,0,21,99,271,101,170,673,51,24,10,11,10,369,623,0,32,1,151,0,184,148,1826,3107
GUJARAT,PORBANDAR,2012,18,8,0,26,10,0,10,20,8,7,1,16,1,1,8,51,67,34,33,195,7,10,12,1,4,68,151,1,8,0,73,0,82,49,491,896
GUJARAT,RAJKOT COMMR.,2012,41,28,3,72,11,0,11,22,66,50,16,132,14,0,43,198,1013,775,238,2281,74,84,43,11,8,336,695,0,10,3,264,0,277,139,1930,4319
GUJARAT,RAJKOT RURAL,2012,48,21,2,71,20,0,20,40,62,58,4,124,4,1,19,160,275,158,117,734,68,54,19,9,12,313,765,3,26,3,292,0,324,290,2596,4297
GUJARAT,SURAT COMMR.,2012,98,26,1,125,40,0,40,80,91,66,25,182,6,4,68,333,1886,1296,590,4183,65,24,177,14,3,441,951,3,28,0,299,0,330,227,5412,9246
GUJARAT,SURAT RURAL,2012,55,16,0,71,13,0,13,26,33,30,3,66,14,2,18,143,495,210,285,1167,50,22,39,4,7,135,665,1,14,2,94,0,111,408,2079,3644
GUJARAT,SURENDRANAGAR,2012,40,26,0,66,19,0,19,38,51,46,5,102,4,0,18,123,209,96,113,563,78,36,5,8,14,428,817,0,51,5,124,0,180,248,1498,2985
GUJARAT,TAPI,2012,11,4,2,17,5,0,5,10,3,3,0,6,1,0,4,26,93,36,57,217,10,18,4,4,9,64,241,0,9,0,17,0,26,132,376,792
GUJARAT,VADODARA COMMR.,2012,29,34,0,63,11,0,11,22,67,57,10,134,9,0,112,333,1333,950,383,3120,92,24,175,5,5,375,832,0,15,4,306,0,325,156,3355,6440
GUJARAT,VADODARA RURAL,2012,74,6,4,84,15,0,15,30,73,72,1,146,11,0,18,96,310,199,111,745,55,17,38,5,17,296,837,0,23,0,90,0,113,409,1922,3479
GUJARAT,VALSAD,2012,21,14,0,35,12,0,12,24,25,19,6,50,4,0,20,159,551,342,209,1285,26,57,31,8,6,189,583,0,9,0,15,0,24,266,1318,2731
GUJARAT,W.RLY AHMEDABAD,2012,3,3,0,6,1,0,1,2,2,2,0,4,0,0,8,8,214,21,193,444,7,2,3,0,0,37,52,0,2,0,2,0,4,3,49,344
GUJARAT,W.RLY VADODARA,2012,5,0,1,6,0,0,0,0,3,2,1,6,4,1,5,2,390,31,359,792,1,3,22,0,0,33,61,0,1,0,1,0,2,2,65,539
HARYANA,AMBALA RURAL,2012,13,15,1,29,11,0,11,22,28,19,9,56,1,2,6,118,209,102,107,545,0,4,45,0,3,66,120,7,12,4,73,0,96,2,462,1082
HARYANA,AMBALA URBAN,2012,15,16,3,34,21,0,21,42,75,39,36,150,0,0,21,362,600,361,239,1583,1,53,99,1,5,109,269,5,23,14,159,0,201,1,759,2342
HARYANA,BHIWANI,2012,81,48,3,132,28,0,28,56,109,69,40,218,8,8,52,295,701,502,199,1765,122,21,129,1,24,267,573,19,45,23,179,0,266,9,1206,3378
HARYANA,FARIDABAD,2012,72,50,6,128,47,0,47,94,103,87,16,206,10,16,34,347,1819,1495,324,4045,188,118,46,2,9,163,771,8,31,84,197,0,320,245,1428,5023
HARYANA,FATEHABAD,2012,17,23,3,43,15,0,15,30,49,33,16,98,2,1,12,145,339,257,82,838,28,10,50,1,7,115,213,4,7,7,125,0,143,2,573,1535
HARYANA,GRP,2012,21,6,0,27,1,0,1,2,10,7,3,20,2,1,16,1,429,94,335,878,13,5,6,0,0,12,50,5,9,83,1,0,98,14,486,1121
HARYANA,GURGAON,2012,82,66,3,151,44,0,44,88,56,47,9,112,34,56,84,495,3529,2998,531,7727,122,71,216,1,4,114,551,15,18,31,150,0,214,23,1924,7138
HARYANA,HISSAR,2012,76,67,4,147,44,0,44,88,114,88,26,228,6,6,42,413,1115,781,334,2697,65,20,197,2,20,286,596,12,39,23,312,0,386,6,1667,4536
HARYANA,JHAJJAR,2012,64,50,3,117,20,0,20,40,38,17,21,76,10,5,35,210,451,298,153,1162,50,28,47,1,12,82,397,10,19,14,135,0,178,177,555,2016
HARYANA,JIND,2012,50,36,5,91,34,0,34,68,58,40,18,116,7,1,39,224,544,349,195,1359,107,84,74,0,13,140,421,17,27,0,114,0,158,3,746,2323
HARYANA,KAITHAL,2012,31,20,7,58,18,0,18,36,38,20,18,76,2,4,11,207,337,216,121,898,0,46,30,1,7,175,265,6,15,0,127,0,148,6,636,1724
HARYANA,KARNAL,2012,59,60,2,121,63,0,63,126,103,41,62,206,8,3,43,368,1045,807,238,2512,46,13,141,3,8,219,643,23,50,28,204,0,305,213,1256,3958
HARYANA,KURUKSHETRA,2012,26,38,3,67,25,0,25,50,37,30,7,74,1,7,6,218,605,450,155,1442,0,14,116,0,6,132,271,11,20,27,110,0,168,3,889,2294
HARYANA,MAHENDRAGARH,2012,39,28,0,67,14,0,14,28,25,18,7,50,12,2,22,144,299,158,141,778,114,36,12,0,9,115,294,10,26,0,78,0,114,8,779,1772
HARYANA,MEWAT,2012,12,52,0,64,50,0,50,100,29,15,14,58,26,10,26,56,483,352,131,1084,150,25,61,1,5,69,316,5,15,7,168,0,195,5,871,2126
HARYANA,PALWAL,2012,43,67,6,116,32,0,32,64,54,47,7,108,10,2,26,82,588,430,158,1296,197,34,18,1,9,158,424,12,27,0,107,0,146,7,977,2457
HARYANA,PANCHKULA,2012,15,10,1,26,18,0,18,36,40,23,17,80,5,2,18,171,392,278,114,980,2,2,41,0,0,66,112,7,13,1,51,0,72,1,516,1372
HARYANA,PANIPAT,2012,47,28,6,81,35,0,35,70,87,67,20,174,8,18,36,228,906,781,125,2102,68,18,107,0,8,155,590,15,23,12,136,0,186,234,828,3003
HARYANA,REWARI,2012,31,40,5,76,24,0,24,48,26,20,6,52,24,2,45,171,703,536,167,1648,41,51,19,0,13,123,252,12,16,1,102,0,131,5,998,2452
HARYANA,ROHTAK,2012,60,63,1,124,37,0,37,74,35,23,12,70,8,11,47,272,759,518,241,1856,61,31,120,0,12,174,599,12,24,40,143,0,219,201,840,2951
HARYANA,SIRSA,2012,27,26,1,54,30,0,30,60,90,55,35,180,6,2,14,159,483,340,143,1147,45,27,32,1,6,242,355,6,25,1,159,0,191,2,884,2268
HARYANA,SONIPAT,2012,86,67,4,157,32,0,32,64,62,49,13,124,12,7,47,270,817,521,296,1970,4,16,119,1,8,183,639,30,26,25,185,0,266,308,1156,3465
HARYANA,YAMUNANAGAR,2012,24,34,1,59,25,0,25,50,83,46,37,166,2,10,29,173,437,355,82,1088,0,13,73,3,3,112,213,7,15,9,122,0,153,9,960,2144
HIMACHAL PRADESH,BADDIPOLICEDIST,2012,7,4,0,11,12,0,12,24,10,8,2,20,1,0,0,38,37,25,12,113,31,23,9,0,3,171,284,1,7,0,16,0,24,47,126,543
HIMACHAL PRADESH,BILASPUR,2012,8,8,0,16,12,0,12,24,7,5,2,14,0,0,1,55,47,20,27,150,28,9,27,0,14,36,148,0,21,12,22,0,55,34,619,960
HIMACHAL PRADESH,CHAMBA,2012,7,0,1,8,10,0,10,20,14,14,0,28,0,0,0,74,22,4,18,118,29,5,4,0,3,75,157,1,9,4,7,0,21,41,251,557
HIMACHAL PRADESH,CID,2012,0,0,0,0,0,0,0,0,0,0,0,0,0,0,0,0,1,0,1,2,0,0,0,0,0,0,0,0,0,0,0,0,0,0,4,5
HIMACHAL PRADESH,G.R.P.,2012,0,1,0,1,0,0,0,0,0,0,0,0,0,0,0,0,3,0,3,6,0,0,0,0,0,0,0,0,0,0,0,0,0,0,9,13
HIMACHAL PRADESH,HAMIRPUR,2012,6,5,2,13,8,0,8,16,6,2,4,12,0,0,0,44,33,10,23,110,18,7,22,0,3,155,235,0,20,5,17,0,42,30,475,856
HIMACHAL PRADESH,KANGRA,2012,24,8,2,34,26,0,26,52,52,47,5,104,0,0,2,224,127,41,86,480,87,25,99,1,17,187,421,0,45,13,43,0,101,5,1823,2810
HIMACHAL PRADESH,KINNAUR,2012,2,1,0,3,6,0,6,12,2,2,0,4,0,0,0,22,10,1,9,42,12,3,2,0,1,8,58,0,1,0,5,0,6,32,85,192
HIMACHAL PRADESH,KULLU,2012,9,3,1,13,22,0,22,44,7,5,2,14,0,0,0,58,26,6,20,110,28,7,21,0,4,33,127,0,22,0,10,0,32,34,434,719
HIMACHAL PRADESH,LAHAUL-SPITI,2012,0,0,0,0,2,0,2,4,0,0,0,0,0,0,0,1,2,0,2,5,2,0,0,0,0,1,15,0,1,0,0,0,1,12,79,100
HIMACHAL PRADESH,MANDI,2012,15,6,1,22,28,0,28,56,19,18,1,38,0,0,0,97,100,18,82,297,61,12,62,0,30,132,357,0,49,17,32,0,98,60,1012,1733
HIMACHAL PRADESH,SHIMLA,2012,18,6,1,25,23,0,23,46,29,25,4,58,0,0,3,149,157,38,119,466,69,20,38,0,39,49,336,0,28,7,23,0,58,121,750,1530
HIMACHAL PRADESH,SIRMAUR,2012,8,4,1,13,17,0,17,34,11,11,0,22,0,0,1,40,54,37,17,149,62,5,17,0,6,34,182,0,24,4,18,0,46,58,502,866
HIMACHAL PRADESH,SOLAN,2012,3,5,0,8,9,0,9,18,8,8,0,16,0,0,1,78,83,39,44,245,30,11,9,0,9,220,311,0,13,1,16,0,30,32,250,778
HIMACHAL PRADESH,UNA,2012,6,2,0,8,8,0,8,16,7,7,0,14,0,0,2,48,67,26,41,184,37,10,63,0,2,72,240,0,10,5,42,0,57,56,458,895
JAMMU & KASHMIR,ANANTNAG,2012,1,22,0,23,14,0,14,28,96,92,4,192,0,0,9,87,86,23,63,268,160,12,43,2,18,7,280,0,130,33,4,0,167,38,669,1431
JAMMU & KASHMIR,AWANTIPORA,2012,1,2,0,3,4,0,4,8,29,29,0,58,0,0,0,13,17,1,16,47,16,2,8,0,2,0,47,0,11,7,1,0,19,19,240,372
JAMMU & KASHMIR,BANDIPORA,2012,7,5,1,13,6,0,6,12,46,45,1,92,0,0,3,21,40,2,38,104,92,0,4,0,8,5,109,0,81,5,0,0,86,0,213,537
JAMMU & KASHMIR,BARAMULLA,2012,6,27,0,33,12,0,12,24,83,79,4,166,0,0,8,65,92,19,73,257,103,6,23,0,10,7,149,0,109,23,13,0,145,0,628,1215
JAMMU & KASHMIR,BUDGAM,2012,3,11,2,16,7,0,7,14,77,73,4,154,1,0,7,90,167,24,143,432,173,3,33,2,15,1,245,0,114,15,5,0,134,18,490,1234
JAMMU & KASHMIR,CRIME JAMMU,2012,0,0,0,0,0,0,0,0,0,0,0,0,0,0,0,0,0,0,0,0,0,0,12,0,0,0,12,0,0,0,0,0,0,0,0,12
JAMMU & KASHMIR,CRIME SRINAGAR,2012,0,0,0,0,0,0,0,0,0,0,0,0,0,0,0,0,1,0,1,2,0,4,26,0,0,0,30,0,0,0,0,0,0,0,0,31
JAMMU & KASHMIR,DODA,2012,5,13,0,18,16,0,16,32,33,31,2,66,0,0,1,47,37,1,36,122,22,9,5,0,6,8,51,0,23,5,26,0,54,1,467,724
JAMMU & KASHMIR,GANDERBAL,2012,2,8,1,11,9,0,9,18,33,32,1,66,1,0,2,27,24,3,21,78,29,3,12,1,10,6,71,0,97,3,2,0,102,10,249,529
JAMMU & KASHMIR,HANDWARA,2012,6,20,0,26,6,0,6,12,35,35,0,70,0,0,2,10,46,3,43,104,53,2,6,0,3,0,74,0,88,3,2,0,93,10,190,482
JAMMU & KASHMIR,JAMMU,2012,13,80,1,94,39,0,39,78,100,92,8,200,2,0,4,266,448,176,272,1168,87,47,135,3,15,30,426,5,44,33,67,0,149,109,2733,4261
JAMMU & KASHMIR,KARGIL,2012,1,2,0,3,1,0,1,2,0,0,0,0,0,0,0,5,6,0,6,17,12,1,0,0,1,0,14,0,1,0,0,0,1,0,77,107
JAMMU & KASHMIR,KATHUA,2012,6,26,0,32,20,0,20,40,40,34,6,80,0,0,2,68,78,26,52,226,26,7,16,0,4,8,65,1,30,12,14,0,57,4,892,1254
JAMMU & KASHMIR,KISHTWAR,2012,3,11,1,15,6,0,6,12,23,23,0,46,0,0,1,16,21,1,20,59,1,1,14,0,4,0,21,0,12,1,11,0,24,1,295,422
JAMMU & KASHMIR,KULGAM,2012,10,6,1,17,15,0,15,30,70,68,2,140,0,0,4,23,43,6,37,113,78,4,26,1,2,61,194,0,96,19,2,0,117,22,292,775
JAMMU & KASHMIR,KUPWARA,2012,3,21,0,24,15,0,15,30,50,49,1,100,0,0,3,48,85,3,82,221,130,5,16,2,11,9,186,0,53,16,9,0,78,13,307,796
JAMMU & KASHMIR,LEH,2012,2,2,0,4,3,0,3,6,1,1,0,2,0,0,0,8,5,0,5,18,1,2,7,0,0,1,11,0,5,0,0,0,5,0,143,180
JAMMU & KASHMIR,POONCH,2012,5,32,2,39,9,0,9,18,41,41,0,82,0,0,0,39,11,0,11,61,86,4,16,4,13,56,181,0,31,6,14,0,51,2,468,839
JAMMU & KASHMIR,PULWAMA,2012,3,6,0,9,3,0,3,6,25,21,4,50,0,0,1,17,35,2,33,88,60,10,6,0,7,64,157,0,8,19,0,0,27,10,161,435
JAMMU & KASHMIR,RAILWAYS JAMMU,2012,0,2,0,2,0,0,0,0,0,0,0,0,0,0,0,0,2,0,2,4,0,0,0,0,0,0,0,0,0,1,0,0,1,0,9,14
JAMMU & KASHMIR,RAILWAYS KASHMIR,2012,0,0,0,0,0,0,0,0,1,1,0,2,0,0,0,1,8,0,8,17,1,0,0,0,0,0,1,0,0,0,0,0,0,0,5,16
JAMMU & KASHMIR,RAILWAYS KATRA,2012,0,0,0,0,0,0,0,0,0,0,0,0,0,0,0,0,2,0,2,4,0,0,0,0,0,0,0,0,0,0,0,0,0,0,0,2
JAMMU & KASHMIR,RAJOURI,2012,9,36,2,47,32,0,32,64,58,54,4,116,0,0,1,70,59,8,51,189,40,9,41,0,28,29,187,1,51,11,44,0,107,40,1333,1894
JAMMU & KASHMIR,RAMBAN,2012,2,10,0,12,7,0,7,14,22,22,0,44,0,0,1,24,31,10,21,87,1,5,8,0,0,0,16,0,9,6,0,0,15,2,633,761
JAMMU & KASHMIR,REASI,2012,5,21,1,27,12,0,12,24,18,18,0,36,0,0,1,27,31,7,24,90,11,4,15,0,2,5,39,0,14,6,2,0,22,2,500,677
JAMMU & KASHMIR,SAMBA,2012,5,20,0,25,8,0,8,16,9,9,0,18,0,0,0,28,42,15,27,112,13,0,11,0,1,5,30,1,10,11,4,0,26,0,573,741
JAMMU & KASHMIR,SHOPIAN,2012,2,22,0,24,3,0,3,6,47,47,0,94,0,0,6,26,93,3,90,218,52,3,11,0,4,2,77,0,29,9,0,0,38,5,211,525
JAMMU & KASHMIR,SOPORE,2012,6,42,1,49,7,0,7,14,34,34,0,68,2,0,7,75,170,14,156,424,25,2,7,0,4,0,38,0,55,9,6,0,70,0,194,646
JAMMU & KASHMIR,SRINAGAR,2012,13,45,2,60,19,0,19,38,100,89,11,200,0,0,18,251,302,203,99,873,107,15,101,2,21,16,322,0,201,82,63,0,346,60,1196,2614
JAMMU & KASHMIR,UDHAMPUR,2012,5,19,1,25,30,0,30,60,22,22,0,44,0,0,0,43,40,7,33,123,21,3,10,0,1,2,42,0,20,12,12,0,44,5,836,1082
JHARKHAND,BOKARO,2012,61,11,1,73,46,0,46,92,63,63,0,126,12,1,24,131,642,191,451,1452,162,169,179,0,0,0,510,21,4,0,212,0,237,0,1825,3564
JHARKHAND,CHAIBASA,2012,144,49,0,193,34,0,34,68,15,15,0,30,11,0,20,25,140,36,104,336,10,6,8,4,3,15,127,6,8,0,20,1,35,81,344,944
JHARKHAND,CHATRA,2012,53,20,2,75,15,0,15,30,24,20,4,48,12,0,17,19,137,25,112,322,92,10,34,0,12,25,280,8,6,0,18,0,32,107,406,1017
JHARKHAND,DEOGHAR,2012,58,101,8,167,38,0,38,76,48,3,45,96,16,2,25,100,238,55,183,619,189,48,65,1,7,536,920,18,35,0,159,0,212,74,234,2000
JHARKHAND,DHANBAD,2012,69,18,14,101,41,0,41,82,121,101,20,242,46,3,44,180,906,435,471,2085,188,85,154,1,3,201,632,49,4,2,89,0,144,0,2388,4606
JHARKHAND,DHANBAD RLY.,2012,5,0,0,5,2,0,2,4,3,2,1,6,5,1,7,4,199,17,182,415,3,0,5,0,0,0,8,1,8,0,2,0,11,0,135,380
JHARKHAND,DUMKA,2012,66,34,7,107,29,0,29,58,34,26,8,68,8,0,4,45,227,71,156,511,69,12,19,0,18,259,467,8,12,0,43,0,63,90,495,1479
JHARKHAND,GARHWA,2012,85,44,6,135,43,0,43,86,24,21,3,48,4,0,38,42,91,36,55,266,168,24,89,0,16,536,877,21,14,0,68,0,103,44,782,2139
JHARKHAND,GIRIDIH,2012,72,92,0,164,37,0,37,74,53,36,17,106,23,9,31,74,453,148,305,1043,259,46,98,0,0,2,554,32,46,0,104,0,182,149,1291,2871
JHARKHAND,GODDA,2012,49,0,0,49,22,0,22,44,63,42,21,126,5,0,7,26,151,38,113,340,31,10,6,0,0,0,47,11,2,0,0,0,13,0,1382,1765
JHARKHAND,GUMLA,2012,192,45,4,241,36,0,36,72,55,44,11,110,5,0,25,20,119,22,97,288,26,8,16,0,6,155,301,2,9,0,6,0,17,90,114,933
JHARKHAND,HAZARIBAGH,2012,68,31,5,104,42,0,42,84,53,49,4,106,11,3,22,65,202,159,43,505,149,22,114,0,7,162,456,24,9,0,54,0,87,2,1382,2427
JHARKHAND,JAMSHEDPUR,2012,85,25,5,115,56,0,56,112,98,91,7,196,9,5,40,155,979,412,567,2167,114,82,240,4,4,679,1129,17,22,3,106,0,148,6,1288,4022
JHARKHAND,JAMSHEDPUR RLY.,2012,7,0,1,8,1,0,1,2,1,1,0,2,2,0,3,4,155,21,134,319,0,2,2,0,0,4,8,0,0,0,0,0,0,0,25,207
JHARKHAND,JAMTARA,2012,21,8,2,31,27,0,27,54,17,10,7,34,1,0,4,31,110,25,85,256,135,5,61,1,5,184,407,5,1,0,72,0,78,16,144,850
JHARKHAND,KHUNTI,2012,106,19,2,127,8,0,8,16,13,10,3,26,0,1,8,1,32,9,23,74,35,2,8,0,0,25,134,1,2,1,0,0,4,64,49,377
JHARKHAND,KODERMA,2012,17,55,2,74,8,0,8,16,30,22,8,60,7,0,12,16,104,32,72,243,74,16,75,0,0,195,432,13,12,0,29,0,54,72,398,1135
JHARKHAND,LATEHAR,2012,46,20,2,68,15,0,15,30,28,16,12,56,5,0,13,4,99,16,83,220,37,6,11,0,4,42,140,4,6,0,10,0,20,40,135,527
JHARKHAND,LOHARDAGGA,2012,36,19,7,62,23,0,23,46,22,18,4,44,1,0,9,13,52,9,43,127,9,2,19,1,6,50,132,1,6,0,23,0,30,45,107,451
JHARKHAND,PAKUR,2012,38,10,5,53,53,0,53,106,23,18,5,46,8,0,3,1,154,27,127,320,107,13,32,0,5,278,470,1,10,0,64,0,75,35,93,933
JHARKHAND,PALAMU,2012,70,61,0,131,26,0,26,52,57,30,27,114,22,0,42,76,245,75,170,630,139,11,78,0,5,479,791,28,10,0,20,0,58,79,659,2107
JHARKHAND,RAMGARH,2012,27,9,1,37,26,0,26,52,28,19,9,56,16,4,12,31,264,76,188,591,89,20,31,0,4,157,395,7,10,2,7,0,26,94,157,996
JHARKHAND,RANCHI,2012,145,77,13,235,52,0,52,104,76,53,23,152,40,1,54,82,566,154,412,1309,155,18,113,0,16,347,885,11,22,1,45,0,79,236,326,2396
JHARKHAND,SAHEBGANJ,2012,57,44,1,102,65,0,65,130,71,45,26,142,3,0,4,19,135,40,95,296,51,11,56,2,7,313,489,6,11,1,74,2,94,49,485,1467
JHARKHAND,SARAIKELA,2012,51,22,2,75,35,0,35,70,16,14,2,32,5,0,16,45,217,69,148,500,36,2,34,0,2,113,358,6,10,0,25,0,41,171,89,897
JHARKHAND,SIMDEGA,2012,66,28,2,96,32,0,32,64,20,17,3,40,7,3,10,7,63,17,46,153,4,9,19,0,6,28,116,1,5,0,11,0,17,50,85,456
KARNATAKA,BAGALKOT,2012,51,43,1,95,11,0,11,22,17,14,3,34,7,0,18,91,130,73,57,376,221,6,72,0,4,235,538,6,63,0,72,2,143,0,1247,2297
KARNATAKA,BANGALORE COMMR.,2012,266,454,6,726,90,0,90,180,532,433,99,1064,37,470,670,1240,9826,5090,4736,22069,551,145,3092,41,0,3095,7094,51,321,51,524,0,947,170,7665,29297
KARNATAKA,BANGALORE RURAL,2012,93,57,0,150,31,0,31,62,53,41,12,106,26,1,113,299,648,226,422,1735,257,15,178,1,0,668,1119,10,70,0,96,0,176,0,2944,5560
KARNATAKA,BELGAUM,2012,142,120,3,265,37,0,37,74,54,34,20,108,7,0,80,214,428,236,192,1157,460,27,339,3,26,888,1772,5,205,9,307,0,526,29,3462,6845
KARNATAKA,BELLARY,2012,54,46,2,102,18,0,18,36,31,24,7,62,6,0,44,151,347,210,137,895,228,10,102,3,11,368,754,9,48,0,104,0,161,32,1498,3112
KARNATAKA,BIDAR,2012,38,39,0,77,11,0,11,22,30,24,6,60,1,2,32,102,173,68,105,483,168,9,72,1,17,759,1035,10,40,2,99,0,151,9,2044,3658
KARNATAKA,BIJAPUR,2012,69,64,1,134,18,0,18,36,30,24,6,60,5,2,33,101,139,80,59,419,245,9,104,0,11,460,829,4,41,0,128,9,182,0,1310,2783
KARNATAKA,CBPURA,2012,51,44,7,102,12,0,12,24,25,20,5,50,3,1,32,140,312,83,229,800,280,4,62,1,0,441,795,12,56,3,36,0,107,7,1025,2554
KARNATAKA,CHAMARAJNAGAR,2012,18,34,0,52,9,0,9,18,10,8,2,20,6,0,8,52,111,32,79,288,120,4,28,1,0,436,589,2,64,0,62,1,129,0,767,1733
KARNATAKA,CHICKMAGALUR,2012,33,28,9,70,11,0,11,22,12,7,5,24,8,0,22,91,145,59,86,411,114,0,49,1,0,568,732,4,70,2,89,4,169,0,1238,2498
KARNATAKA,CHITRADURGA,2012,43,38,7,88,26,0,26,52,34,34,0,68,3,0,25,119,224,90,134,595,323,4,71,0,8,799,1205,6,140,0,75,0,221,0,2114,4059
KARNATAKA,DAKSHIN KANNADA,2012,23,25,0,48,12,0,12,24,10,9,1,20,5,0,15,103,82,28,54,287,115,11,49,1,15,263,461,2,35,8,42,0,87,7,1013,1836
KARNATAKA,DAVANAGERE,2012,42,35,8,85,17,0,17,34,23,20,3,46,3,3,50,139,297,143,154,789,298,17,58,3,0,442,818,8,117,0,119,0,244,0,1592,3271
KARNATAKA,DHARWAD COMMR.,2012,18,20,1,39,6,0,6,12,54,42,12,108,2,5,77,130,290,184,106,794,94,3,117,1,20,177,420,2,16,0,65,0,83,8,831,1937
KARNATAKA,DHARWAD RURAL,2012,27,30,1,58,5,0,5,10,13,3,10,26,0,1,4,33,56,12,44,150,147,10,24,0,6,195,382,0,38,0,24,0,62,0,699,1313
KARNATAKA,GADAG,2012,24,11,1,36,6,0,6,12,12,12,0,24,0,0,5,32,64,31,33,165,110,8,40,2,10,140,426,2,59,0,47,0,108,116,394,1083
KARNATAKA,GULBARGA,2012,82,87,0,169,29,0,29,58,53,39,14,106,12,0,63,209,313,151,162,910,362,7,89,0,54,702,1235,10,132,0,151,0,293,21,1725,4101
KARNATAKA,HASSAN,2012,77,80,5,162,21,0,21,42,26,19,7,52,11,6,72,236,322,149,173,969,244,10,116,4,0,1351,1725,5,120,1,155,0,281,0,2730,5592
KARNATAKA,HAVERI,2012,19,24,0,43,12,0,12,24,18,0,18,36,1,1,10,95,113,52,61,333,251,7,59,1,0,296,825,3,72,0,68,0,143,211,1072,2333
KARNATAKA,K.G.F.,2012,16,22,0,38,10,0,10,20,7,0,7,14,1,2,14,57,85,37,48,244,87,1,23,0,0,259,423,2,10,0,19,0,31,53,339,1007
KARNATAKA,KODAGU,2012,29,36,3,68,12,0,12,24,5,3,2,10,3,0,3,69,97,22,75,269,33,2,50,1,3,521,614,2,25,0,43,0,70,4,609,1550
KARNATAKA,KOLAR,2012,46,58,0,104,18,0,18,36,20,14,6,40,4,1,20,92,186,87,99,489,239,6,44,1,0,361,658,1,37,0,34,0,72,7,1034,2209
KARNATAKA,KOPPAL,2012,24,11,0,35,7,0,7,14,27,0,27,54,2,0,14,76,100,51,49,292,134,13,60,0,0,228,435,0,17,0,87,0,104,0,1099,1899
KARNATAKA,MANDYA,2012,86,95,1,182,35,0,35,70,46,39,7,92,11,5,82,265,518,225,293,1399,342,18,79,1,80,1321,1841,9,149,1,204,1,364,0,2565,5914
KARNATAKA,MANGALORE CITY,2012,28,18,0,46,12,0,12,24,16,4,12,32,1,1,69,136,233,128,105,673,112,0,89,6,16,199,455,1,29,1,48,3,82,33,1634,2685
KARNATAKA,MYSORE COMMR.,2012,31,35,0,66,12,0,12,24,13,10,3,26,3,6,205,146,661,397,264,1682,88,5,101,0,0,232,426,6,22,0,32,12,72,0,1216,2826
KARNATAKA,MYSORE RURAL,2012,78,37,1,116,28,0,28,56,67,47,20,134,4,2,30,211,331,116,215,909,305,3,63,0,0,960,1331,1,163,0,158,0,322,0,1897,4339
KARNATAKA,RAICHUR,2012,42,31,1,74,19,0,19,38,34,25,9,68,2,0,10,72,134,71,63,352,243,10,148,0,0,469,870,1,141,0,190,0,332,0,1492,3039
KARNATAKA,RAILWAYS,2012,19,1,0,20,2,0,2,4,4,1,3,8,1,2,47,2,482,17,465,1016,6,0,1,5,0,10,41,2,2,1,0,0,5,19,43,649
KARNATAKA,RAMANAGAR,2012,77,64,1,142,16,0,16,32,60,53,7,120,16,6,127,298,512,256,256,1471,264,3,76,1,73,644,1061,17,112,0,73,0,202,0,2233,4673
KARNATAKA,SHIMOGA,2012,50,78,2,130,14,0,14,28,32,24,8,64,6,8,57,195,331,188,143,928,276,13,103,2,9,978,1385,6,158,3,222,0,389,4,2487,5034
KARNATAKA,TUMKUR,2012,91,80,5,176,33,0,33,66,38,10,28,76,8,5,94,306,470,190,280,1353,375,11,153,0,0,950,1495,18,171,0,132,0,321,6,2621,5567
KARNATAKA,UDUPI,2012,14,18,3,35,5,0,5,10,12,3,9,24,5,3,36,139,115,48,67,413,119,4,37,1,8,285,467,0,41,1,38,0,80,13,1557,2454
KARNATAKA,UTTAR KANNADA,2012,33,23,2,58,7,0,7,14,11,10,1,22,0,3,21,100,77,21,56,278,112,5,46,2,18,361,544,1,97,8,78,0,184,0,1823,2828
KARNATAKA,YADGIRI,2012,26,37,0,63,9,0,9,18,22,20,2,44,1,0,5,51,66,35,31,189,179,1,28,0,27,289,651,0,97,9,63,0,169,127,449,1486
KERALA,ALAPUZHA,2012,20,18,6,44,44,0,44,88,18,15,3,36,2,0,16,136,231,80,151,616,553,17,188,0,20,1380,2160,1,250,14,294,0,559,2,5345,8555
KERALA,ERNAKULAM COMMR.,2012,9,10,0,19,28,0,28,56,6,5,1,12,5,37,25,90,308,81,227,773,393,8,630,2,3,445,1484,0,108,16,127,0,251,3,15071,17324
KERALA,ERNAKULAM RURAL,2012,21,39,4,64,59,0,59,118,10,9,1,20,5,0,36,144,270,71,199,725,470,16,225,9,10,981,1713,0,162,25,216,0,403,2,7974,10678
KERALA,IDUKKI,2012,22,29,3,54,53,0,53,106,10,10,0,20,5,0,13,110,149,33,116,426,295,37,158,0,11,1230,1731,2,189,10,219,0,420,0,2589,5134
KERALA,KANNUR,2012,32,27,10,69,66,0,66,132,23,18,5,46,7,5,71,230,207,67,140,727,1277,10,221,4,111,1442,3068,0,183,12,391,0,586,3,4068,8400
KERALA,KASARGOD,2012,14,23,2,39,89,0,89,178,17,10,7,34,6,1,36,129,123,71,52,418,590,4,175,7,51,963,1793,3,156,15,205,0,379,3,2562,5174
KERALA,KOLLAM COMMR.,2012,21,41,6,68,46,0,46,92,21,18,3,42,3,27,62,132,212,98,114,648,293,6,90,1,14,1002,1406,4,171,41,336,0,552,0,4545,7074
KERALA,KOLLAM RURAL,2012,30,28,6,64,49,0,49,98,14,14,0,28,2,7,30,103,159,32,127,460,469,9,109,11,28,1409,2038,1,270,20,326,0,617,3,2898,5981
KERALA,KOTTAYAM,2012,20,29,2,51,55,0,55,110,19,17,2,38,2,12,26,188,265,69,196,758,483,35,299,10,17,2090,2937,1,265,55,255,0,576,3,8224,12355
KERALA,KOZHIKODE COMMR.,2012,7,7,0,14,36,0,36,72,5,3,2,10,2,18,65,92,142,67,75,461,353,19,164,0,12,631,1181,0,103,83,144,0,330,2,2271,4156
KERALA,KOZHIKODE RURAL,2012,9,24,5,38,42,0,42,84,16,13,3,32,3,3,31,129,181,90,91,528,1102,8,157,0,101,987,2363,0,153,15,313,0,481,8,2358,5645
KERALA,MALAPPURAM,2012,16,26,4,46,97,0,97,194,10,3,7,20,4,1,33,244,253,85,168,788,792,12,441,2,42,969,2259,2,221,21,668,0,912,1,10526,14385
KERALA,PALAKKAD,2012,32,42,15,89,68,0,68,136,13,9,4,26,6,17,30,159,208,60,148,628,706,49,262,0,32,1534,2585,5,146,11,401,0,563,2,4873,8611
KERALA,PATHANAMTHITTA,2012,28,24,3,55,32,0,32,64,17,16,1,34,1,9,18,110,161,38,123,460,411,7,117,0,16,1090,1641,2,137,8,162,0,309,0,2974,5327
KERALA,RAILWAYS,2012,0,1,0,1,0,0,0,0,4,1,3,8,0,0,3,3,193,1,192,392,5,0,1,0,0,47,54,0,46,12,0,0,58,1,32,348
KERALA,THRISSUR COMMR.,2012,9,14,11,34,35,0,35,70,13,9,4,26,1,4,28,55,164,51,113,416,443,13,366,0,7,359,1191,0,111,32,146,0,289,3,4417,6231
KERALA,THRISSUR RURAL,2012,18,49,9,76,46,0,46,92,12,9,3,24,6,9,40,136,202,56,146,595,588,19,341,7,38,784,1780,2,218,36,361,0,617,3,10479,13403
KERALA,TRIVANDRUM COMMR.,2012,14,12,1,27,41,0,41,82,23,16,7,46,4,106,101,154,285,101,184,935,629,11,304,0,10,1116,2072,0,226,19,159,0,404,2,4036,7253
KERALA,TRIVANDRUM RURAL,2012,42,49,15,106,97,0,97,194,18,10,8,36,8,31,48,287,313,97,216,1000,826,15,294,15,37,1960,3151,8,541,38,398,0,985,4,5021,10065
KERALA,WAYANADU,2012,10,5,5,20,36,0,36,72,12,9,3,24,0,2,13,79,52,14,38,198,260,6,139,0,8,751,1167,1,79,15,95,0,190,3,1319,2890
MADHYA PRADESH,ALIRAJPUR,2012,60,33,0,93,22,0,22,44,13,12,1,26,1,1,16,58,82,50,32,240,9,2,2,0,13,259,375,0,31,1,2,0,34,90,660,1355
MADHYA PRADESH,ANUPPUR,2012,35,15,1,51,62,0,62,124,8,8,0,16,1,0,15,128,108,35,73,360,17,23,28,0,11,126,279,12,80,6,53,0,151,74,991,1794
MADHYA PRADESH,ASHOK NAGAR,2012,34,15,3,52,50,0,50,100,6,5,1,12,2,2,11,72,103,44,59,293,24,3,13,0,2,557,681,10,62,1,21,0,94,82,1401,2474
MADHYA PRADESH,BALAGHAT,2012,43,22,6,71,78,0,78,156,9,7,2,18,0,0,13,128,131,60,71,403,48,10,22,1,14,248,452,6,113,11,63,0,193,109,1717,2792
MADHYA PRADESH,BARWANI,2012,46,15,0,61,50,0,50,100,8,8,0,16,1,0,13,72,160,71,89,406,18,3,13,0,8,204,407,2,72,5,13,0,92,161,1162,2026
MADHYA PRADESH,BETUL,2012,75,26,1,102,118,0,118,236,12,10,2,24,0,0,7,104,226,98,128,563,13,1,26,1,9,245,446,11,151,15,57,0,234,151,1831,3080
MADHYA PRADESH,BHIND,2012,64,80,3,147,49,0,49,98,27,25,2,54,6,7,87,138,292,202,90,822,77,5,35,0,10,1318,1631,40,83,7,50,0,180,186,1356,3920
MADHYA PRADESH,BHOPAL,2012,78,96,0,174,143,0,143,286,63,49,14,126,2,2,200,1004,2605,1692,913,6418,118,25,203,6,15,1361,1998,19,244,52,254,0,569,270,7560,14320
MADHYA PRADESH,BHOPAL RLY.,2012,4,8,1,13,4,0,4,8,1,1,0,2,1,1,25,5,1117,28,1089,2266,1,2,2,0,0,1,8,0,14,1,3,0,18,2,236,1429
MADHYA PRADESH,BURHANPUR,2012,11,12,0,23,23,0,23,46,6,5,1,12,0,0,7,45,90,24,66,232,8,6,24,0,1,493,574,2,42,22,47,0,113,42,555,1436
MADHYA PRADESH,CHHATARPUR,2012,50,60,3,113,62,0,62,124,39,39,0,78,2,6,40,251,240,206,34,779,61,5,34,0,19,403,691,26,172,0,68,0,266,169,2811,4521
MADHYA PRADESH,CHHINDWARA,2012,61,33,2,96,122,0,122,244,21,19,2,42,1,0,31,180,234,116,118,680,66,3,73,0,28,1920,2305,18,202,41,108,0,369,215,1951,5310
MADHYA PRADESH,DAMOH,2012,51,47,0,98,50,0,50,100,32,27,5,64,0,1,18,88,149,55,94,405,15,3,26,0,20,1314,1470,20,165,0,108,0,293,92,1049,3248
MADHYA PRADESH,DATIYA,2012,51,34,0,85,23,0,23,46,28,20,8,56,0,5,40,84,131,55,76,391,35,2,8,0,11,337,493,8,61,0,25,0,94,100,1458,2441
MADHYA PRADESH,DEWAS,2012,62,55,1,118,70,0,70,140,31,29,2,62,3,2,26,162,508,256,252,1209,34,15,35,1,17,370,673,19,146,31,130,0,326,201,3450,5369
MADHYA PRADESH,DHAR,2012,61,53,4,118,81,0,81,162,49,45,4,98,4,6,14,157,499,256,243,1179,24,27,37,1,26,550,1019,39,173,16,69,0,297,354,3314,5558
MADHYA PRADESH,DINDORI,2012,32,8,5,45,40,0,40,80,6,6,0,12,0,0,2,26,38,6,32,104,10,4,17,1,5,114,190,5,80,6,39,0,130,39,791,1268
MADHYA PRADESH,GUNA,2012,44,45,2,91,60,0,60,120,28,25,3,56,4,3,26,124,317,160,157,791,36,6,23,0,26,645,905,8,131,11,34,0,184,169,1850,3592
MADHYA PRADESH,GWALIOR,2012,96,172,24,292,85,0,85,170,83,75,8,166,8,15,199,821,2116,1605,511,5275,112,38,152,1,17,776,1355,35,158,13,202,0,408,259,4931,10313
MADHYA PRADESH,HARDA,2012,14,20,0,34,26,0,26,52,12,10,2,24,1,1,13,55,124,73,51,318,9,3,10,0,8,287,376,7,51,4,16,0,78,59,598,1318
MADHYA PRADESH,HOSHANGABAD,2012,44,32,1,77,69,0,69,138,34,27,7,68,0,0,17,127,227,112,115,598,17,22,45,0,13,423,681,12,129,21,57,0,219,161,1847,3298
MADHYA PRADESH,INDORE,2012,123,172,3,298,173,0,173,346,54,42,12,108,4,5,275,1190,4370,2904,1466,10214,82,39,205,6,64,1064,1912,24,405,114,448,0,991,452,11819,21091
MADHYA PRADESH,INDORE RLY.,2012,3,2,0,5,3,0,3,6,3,3,0,6,2,0,8,3,327,0,327,667,1,0,0,0,0,2,3,0,3,1,0,0,4,0,69,427
MADHYA PRADESH,JABALPUR,2012,98,129,7,234,127,0,127,254,51,45,6,102,0,5,99,478,843,491,352,2268,60,17,137,1,23,3317,3786,33,253,43,219,0,548,231,4404,10575
MADHYA PRADESH,JABALPUR RLY.,2012,6,1,0,7,3,0,3,6,1,0,1,2,0,3,34,5,639,12,627,1320,1,0,1,0,0,6,8,0,13,1,0,0,14,0,261,975
MADHYA PRADESH,JHABUA,2012,20,24,0,44,62,0,62,124,25,17,8,50,5,2,27,92,183,113,70,492,34,1,10,0,17,272,417,0,92,0,24,0,116,83,1458,2431
MADHYA PRADESH,KATNI,2012,36,22,2,60,58,0,58,116,18,14,4,36,1,1,24,156,179,101,78,540,26,3,50,0,4,997,1201,12,146,14,46,0,218,121,1467,3383
MADHYA PRADESH,KHANDWA,2012,27,20,0,47,66,0,66,132,8,5,3,16,0,0,10,181,195,75,120,581,20,6,15,3,15,78,238,6,136,6,34,0,182,101,1914,2841
MADHYA PRADESH,KHARGON,2012,51,38,1,90,67,0,67,134,20,20,0,40,1,2,14,157,370,154,216,914,42,5,17,0,13,101,513,30,133,22,45,0,230,335,2707,4171
MADHYA PRADESH,MANDLA,2012,25,16,3,44,75,0,75,150,8,8,0,16,0,0,6,81,64,28,36,215,7,4,14,0,2,273,381,3,94,12,40,0,149,81,1467,2275
MADHYA PRADESH,MANDSAUR,2012,37,49,0,86,49,0,49,98,34,28,6,68,2,2,20,147,300,132,168,771,25,69,42,1,13,104,401,6,100,6,78,1,191,147,2237,3469
MADHYA PRADESH,MORENA,2012,53,110,4,167,32,0,32,64,35,29,6,70,15,7,54,191,382,242,140,1031,122,1,48,0,7,1886,2257,29,107,3,94,0,233,193,2058,5431
MADHYA PRADESH,NARSINGHPUR,2012,46,47,0,93,71,0,71,142,16,14,2,32,0,2,16,157,159,77,82,493,20,7,38,0,16,1451,1670,16,158,31,79,0,284,138,903,3371
MADHYA PRADESH,NEEMUCH,2012,18,17,0,35,25,0,25,50,12,10,2,24,0,2,22,112,188,98,90,512,35,64,23,0,15,232,456,4,43,13,42,0,102,87,1229,2183
MADHYA PRADESH,PANNA,2012,30,19,2,51,34,0,34,68,8,4,4,16,0,0,11,82,53,20,33,199,1,3,11,0,7,160,264,18,72,10,31,0,131,82,1600,2234
MADHYA PRADESH,RAISEN,2012,54,42,0,96,92,0,92,184,21,16,5,42,1,1,20,115,214,200,14,565,24,0,22,0,5,1921,2145,22,158,0,72,0,252,173,1250,4207
MADHYA PRADESH,RAJGARH,2012,36,40,2,78,90,0,90,180,52,47,5,104,2,4,26,168,342,187,155,884,61,7,28,0,58,327,621,6,181,25,50,0,262,140,3067,4712
MADHYA PRADESH,RATLAM,2012,37,55,1,93,72,0,72,144,28,25,3,56,1,7,26,110,330,157,173,804,27,29,53,0,17,858,1112,13,128,11,85,0,237,128,1404,3420
MADHYA PRADESH,REWA,2012,54,44,7,105,92,0,92,184,44,35,9,88,8,2,44,496,506,242,264,1562,35,7,63,1,30,730,1101,39,115,7,101,0,262,235,2838,5498
MADHYA PRADESH,SAGAR,2012,83,89,3,175,125,0,125,250,63,61,2,126,1,1,64,393,454,200,254,1367,81,10,42,0,34,2607,2988,34,441,22,145,0,642,214,4370,9276
MADHYA PRADESH,SATNA,2012,72,38,0,110,89,0,89,178,29,25,4,58,5,3,40,289,495,275,220,1327,31,12,32,0,19,942,1374,17,138,7,121,0,283,338,2690,5407
MADHYA PRADESH,SEONI,2012,38,12,7,57,65,0,65,130,10,8,2,20,0,0,7,92,104,37,67,307,19,7,37,0,10,160,355,11,100,7,24,0,142,122,1896,2728
MADHYA PRADESH,SHAHDOL,2012,44,13,0,57,81,0,81,162,27,27,0,54,2,3,33,158,176,42,134,548,31,11,28,0,9,176,359,13,133,7,141,0,294,104,2185,3375
MADHYA PRADESH,SHAJAPUR,2012,39,44,2,85,67,0,67,134,18,17,1,36,4,2,18,133,323,155,168,803,42,14,29,1,22,1408,1665,7,102,15,42,0,166,149,869,3350
MADHYA PRADESH,SHEOPUR,2012,8,15,0,23,17,0,17,34,4,4,0,8,0,6,18,51,97,36,61,269,28,2,10,3,0,170,250,5,40,0,29,0,74,37,807,1347
MADHYA PRADESH,SHIVPURI,2012,61,54,1,116,104,0,104,208,29,22,7,58,7,11,39,135,243,100,143,678,83,5,38,1,31,987,1381,9,148,19,67,0,243,236,2660,4968
MADHYA PRADESH,SIDHI,2012,31,9,2,42,48,0,48,96,40,38,2,80,0,0,7,138,148,40,108,441,9,3,27,1,10,312,461,18,84,5,59,0,166,99,1518,2568
MADHYA PRADESH,SIHORE,2012,23,36,0,59,69,0,69,138,14,14,0,28,0,0,21,162,338,180,158,859,27,4,29,0,25,338,604,10,100,13,47,1,171,181,2456,3894
MADHYA PRADESH,SINGRAULI,2012,36,9,1,46,32,0,32,64,36,33,3,72,2,1,9,73,110,33,77,305,28,4,7,0,7,328,524,13,87,6,63,0,169,150,1391,2393
MADHYA PRADESH,TIKAMGARH,2012,43,27,6,76,61,0,61,122,13,8,5,26,0,0,24,91,105,34,71,325,48,2,13,0,5,1251,1422,16,124,7,27,4,178,103,1332,3302
MADHYA PRADESH,UJJAIN,2012,55,193,1,249,73,0,73,146,36,31,5,72,4,1,73,296,1079,560,519,2532,83,22,64,1,35,281,642,11,180,53,202,0,446,156,5387,8286
MADHYA PRADESH,UMARIYA,2012,12,3,0,15,22,0,22,44,4,2,2,8,1,0,7,55,68,19,49,199,10,0,14,0,6,95,125,0,68,7,17,0,92,0,873,1262
MADHYA PRADESH,VIDISHA,2012,58,62,2,122,94,0,94,188,25,23,2,50,2,2,24,203,301,131,170,833,56,10,46,0,22,764,1018,19,213,23,97,0,352,120,2480,4623
MAHARASHTRA,AHMEDNAGAR,2012,111,91,5,207,61,0,61,122,59,49,10,118,48,14,262,481,1374,463,911,3553,572,56,361,2,46,802,2583,23,147,1,576,0,747,744,1410,7246
MAHARASHTRA,AKOLA,2012,42,34,3,79,19,0,19,38,22,19,3,44,3,2,49,191,677,129,548,1599,107,23,103,21,33,720,1179,4,92,40,87,0,223,172,998,3442
MAHARASHTRA,AMRAVATI COMMR.,2012,24,38,1,63,20,0,20,40,20,16,4,40,5,7,54,232,778,195,583,1854,77,35,59,8,13,387,643,1,53,14,74,0,142,64,749,2713
MAHARASHTRA,AMRAVATI RURAL,2012,63,56,4,123,64,0,64,128,17,17,0,34,9,0,39,212,841,111,730,1942,97,9,41,2,70,856,1298,3,154,42,139,0,338,223,1501,4442
MAHARASHTRA,AURANGABAD COMMR.,2012,46,55,5,106,23,0,23,46,25,18,7,50,25,8,178,292,822,419,403,2147,168,19,245,2,24,460,1103,4,79,28,120,0,231,185,846,3659
MAHARASHTRA,AURANGABAD RURAL,2012,74,49,4,127,25,0,25,50,16,10,6,32,16,9,45,206,540,139,401,1356,306,10,75,0,34,833,1539,18,77,25,298,0,418,281,621,3562
MAHARASHTRA,BEED,2012,84,71,9,164,42,0,42,84,50,21,29,100,32,6,70,309,521,162,359,1459,339,35,157,1,44,886,1774,8,81,9,378,0,476,312,655,4099
MAHARASHTRA,BHANDARA,2012,20,11,3,34,26,0,26,52,11,8,3,22,3,1,31,141,430,57,373,1036,34,11,46,0,23,378,649,3,36,33,59,0,131,157,562,2019
MAHARASHTRA,BULDHANA,2012,49,38,5,92,29,0,29,58,31,28,3,62,5,0,23,149,521,137,384,1219,220,10,109,6,46,687,1323,27,107,35,193,0,362,245,962,3497
MAHARASHTRA,CHANDRAPUR,2012,44,33,0,77,44,0,44,88,34,29,5,68,4,2,46,257,723,180,543,1755,95,28,84,1,33,584,1054,4,119,79,125,0,327,229,1195,3763
MAHARASHTRA,DHULE,2012,50,39,1,90,30,0,30,60,18,14,4,36,51,4,54,158,320,107,213,907,173,48,94,0,6,298,932,4,39,2,207,0,252,313,633,2542
MAHARASHTRA,GADCHIROLI,2012,57,69,2,128,18,0,18,36,9,6,3,18,4,0,3,70,146,19,127,369,21,1,12,1,29,174,340,0,30,5,12,0,47,102,216,981
MAHARASHTRA,GONDIA,2012,41,28,2,71,38,0,38,76,10,10,0,20,6,0,19,143,269,76,193,706,40,7,47,2,26,342,611,0,47,18,42,0,107,147,498,1772
MAHARASHTRA,HINGOLI,2012,25,16,1,42,13,0,13,26,10,5,5,20,1,3,7,48,115,23,92,289,99,6,30,0,14,320,584,6,33,3,88,0,130,115,438,1391
MAHARASHTRA,JALGAON,2012,102,77,4,183,45,0,45,90,43,39,4,86,38,3,81,254,882,247,635,2140,241,94,244,5,24,699,1741,1,134,51,409,0,595,434,1089,4954
MAHARASHTRA,JALNA,2012,45,69,6,120,25,0,25,50,25,18,7,50,19,11,71,220,396,155,241,1113,221,23,100,1,26,565,1112,36,89,9,303,0,437,176,615,3051
MAHARASHTRA,KOLHAPUR,2012,63,39,0,102,48,0,48,96,45,22,23,90,11,3,62,357,824,320,504,2081,427,104,330,2,23,536,1818,17,66,32,148,0,263,396,1021,4554
MAHARASHTRA,LATUR,2012,67,63,4,134,21,0,21,42,32,32,0,64,21,1,39,204,403,192,211,1071,240,10,192,7,34,578,1288,4,61,0,212,0,277,227,817,3237
MAHARASHTRA,MUMBAI COMMR.,2012,215,170,9,394,232,0,232,464,212,141,71,424,29,29,1131,2500,10851,4075,6776,25391,374,564,1827,48,86,3939,7459,11,614,235,388,0,1248,621,6423,30508
MAHARASHTRA,MUMBAI RLY.,2012,8,3,2,13,1,0,1,2,7,5,2,14,1,2,423,4,1635,1,1634,3700,11,11,32,2,0,60,120,1,21,3,0,0,25,4,94,2325
MAHARASHTRA,NAGPUR COMMR.,2012,88,85,15,188,57,0,57,114,53,39,14,106,13,29,491,883,2339,1334,1005,6094,169,50,264,7,32,974,1793,6,84,53,166,0,309,297,2122,8277
MAHARASHTRA,NAGPUR RLY.,2012,5,5,0,10,1,0,1,2,2,2,0,4,4,2,67,1,1073,18,1055,2220,12,2,3,16,1,18,54,0,4,4,3,0,11,2,67,1292
MAHARASHTRA,NAGPUR RURAL,2012,55,30,7,92,29,0,29,58,15,15,0,30,8,9,42,210,862,160,702,1993,66,32,54,3,46,561,1166,7,82,20,76,0,185,404,1004,3622
MAHARASHTRA,NANDED,2012,81,57,1,139,48,0,48,96,37,32,5,74,18,3,47,317,476,172,304,1337,276,24,170,4,52,963,1771,25,71,5,421,0,522,282,1290,4668
MAHARASHTRA,NANDURBAR,2012,35,17,0,52,19,0,19,38,10,8,2,20,14,1,17,68,165,60,105,430,93,6,52,1,3,249,554,0,22,4,78,0,104,150,354,1358
MAHARASHTRA,NASIK COMMR.,2012,32,26,0,58,20,0,20,40,18,13,5,36,14,13,163,356,1070,615,455,2686,94,28,139,17,16,229,707,3,36,16,147,0,202,184,1769,4390
MAHARASHTRA,NASIK RURAL,2012,87,63,7,157,46,0,46,92,29,20,9,58,33,9,91,219,611,207,404,1574,403,57,183,10,24,734,2129,17,98,26,319,0,460,718,1432,5216
MAHARASHTRA,NAVI MUMBAI,2012,57,20,2,79,36,0,36,72,19,11,8,38,6,7,417,596,1513,772,741,4052,124,80,455,15,4,404,1447,3,64,25,91,0,183,365,854,5157
MAHARASHTRA,OSMANABAD,2012,54,31,4,89,38,0,38,76,31,21,10,62,16,3,23,170,319,102,217,850,233,17,116,0,33,603,1321,2,86,12,175,0,275,319,770,3055
MAHARASHTRA,PARBHANI,2012,34,63,0,97,28,0,28,56,31,13,18,62,25,1,65,287,377,127,250,1132,160,13,106,1,31,863,1317,3,68,9,242,0,322,143,286,2836
MAHARASHTRA,PUNE COMMR.,2012,110,124,3,237,85,0,85,170,109,77,32,218,35,50,731,1019,4181,2604,1577,10197,532,92,756,18,48,1071,3040,9,120,85,215,0,429,523,2392,12308
MAHARASHTRA,PUNE RLY.,2012,4,0,2,6,2,0,2,4,1,1,0,2,7,2,23,0,362,10,352,756,5,1,1,0,0,10,18,0,3,0,0,0,3,1,21,445
MAHARASHTRA,PUNE RURAL,2012,163,97,12,272,92,0,92,184,71,51,20,142,46,30,258,753,1819,947,872,4725,512,63,293,4,43,886,2951,12,128,59,221,0,420,1150,1721,8433
MAHARASHTRA,RAIGAD,2012,40,13,0,53,21,0,21,42,8,3,5,16,17,2,42,150,321,71,250,853,143,19,164,4,8,257,910,19,37,9,40,0,105,315,530,2159
MAHARASHTRA,RATNAGIRI,2012,10,12,1,23,11,0,11,22,4,3,1,8,9,1,35,167,171,36,135,554,89,24,63,7,9,172,514,2,31,17,38,0,88,150,375,1398
MAHARASHTRA,SANGLI,2012,47,41,5,93,33,0,33,66,35,23,12,70,12,2,34,190,500,187,313,1238,202,19,219,5,23,373,1159,8,57,15,64,0,144,318,581,2783
MAHARASHTRA,SATARA,2012,65,48,5,118,43,0,43,86,36,25,11,72,51,13,208,505,1111,396,715,2999,294,38,210,7,35,527,1606,0,78,29,166,0,273,495,1078,5042
MAHARASHTRA,SINDHUDURG,2012,8,7,1,16,9,0,9,18,8,5,3,16,4,0,12,86,91,18,73,284,49,12,79,2,11,110,340,0,20,17,11,0,48,77,189,803
MAHARASHTRA,SOLAPUR COMMR.,2012,18,27,0,45,25,0,25,50,24,21,3,48,23,1,98,187,557,335,222,1423,132,6,106,2,5,177,508,1,31,10,53,0,95,80,429,1992
MAHARASHTRA,SOLAPUR RURAL,2012,92,52,7,151,67,0,67,134,38,24,14,76,15,4,60,261,846,241,605,2032,365,27,151,4,40,655,1800,3,58,40,151,0,252,558,982,4476
MAHARASHTRA,THANE COMMR.,2012,110,93,6,209,107,0,107,214,124,77,47,248,23,15,757,1199,2435,1239,1196,6864,280,82,867,35,29,1378,3025,4,203,28,330,0,565,354,1685,10144
MAHARASHTRA,THANE RURAL,2012,146,74,8,228,63,0,63,126,64,37,27,128,48,13,389,897,1291,609,682,3929,394,48,528,11,26,913,2635,6,155,32,111,0,304,715,987,6919
MAHARASHTRA,WARDHA,2012,30,32,4,66,40,0,40,80,26,25,1,52,7,3,63,233,656,108,548,1618,82,23,81,1,22,704,1093,0,93,30,59,0,182,180,1195,3564
MAHARASHTRA,WASHIM,2012,40,31,4,75,31,0,31,62,29,27,2,58,4,3,35,124,303,78,225,772,124,6,49,1,21,393,705,6,84,19,133,0,242,111,690,2241
MAHARASHTRA,YAVATMAL,2012,71,71,7,149,64,0,64,128,65,60,5,130,10,1,94,342,959,202,757,2365,165,27,101,5,50,1064,1685,18,143,66,247,0,474,273,2522,6365
MANIPUR,BISHNUPUR,2012,10,36,0,46,11,0,11,22,12,7,5,24,0,7,0,6,42,28,14,97,3,3,4,0,5,20,36,0,3,0,4,0,7,1,147,314
MANIPUR,CHANDEL,2012,7,12,0,19,0,0,0,0,5,1,4,10,0,6,0,0,4,1,3,14,2,0,2,0,4,3,11,0,1,0,0,0,1,0,22,68
MANIPUR,CHURACHANDPUR,2012,8,6,0,14,1,0,1,2,6,1,5,12,0,29,0,4,19,7,12,71,2,2,6,0,0,7,17,0,1,0,1,0,2,0,28,120
MANIPUR,CID,2012,0,0,0,0,0,0,0,0,0,0,0,0,0,0,0,0,0,0,0,0,0,0,2,0,0,0,2,0,0,0,0,0,0,0,0,2
MANIPUR,IMPHAL EAST,2012,10,91,1,102,10,0,10,20,46,36,10,92,0,40,1,8,199,176,23,447,16,12,28,0,14,44,114,0,10,0,11,0,21,0,168,709
MANIPUR,IMPHAL WEST,2012,14,149,3,166,18,0,18,36,72,47,25,144,0,25,1,17,520,456,64,1083,19,21,49,2,14,122,228,0,21,0,9,0,30,1,408,1485
MANIPUR,SENAPATI,2012,2,19,0,21,2,0,2,4,22,3,19,44,8,32,1,3,13,0,13,70,3,3,5,0,7,4,22,0,1,0,0,0,1,0,51,176
MANIPUR,TAMENGLONG,2012,11,5,0,16,1,0,1,2,7,1,6,14,0,16,0,0,3,1,2,22,4,0,2,0,3,3,12,0,0,0,0,0,0,0,18,73
MANIPUR,THOUBAL,2012,16,73,0,89,20,0,20,40,44,37,7,88,0,13,0,8,94,66,28,209,21,15,30,0,22,80,168,0,12,1,17,0,30,0,225,691
MANIPUR,UKHRUL,2012,5,18,0,23,0,0,0,0,9,0,9,18,0,3,0,7,9,1,8,28,2,11,8,0,5,2,28,0,0,0,1,0,1,0,19,99
MEGHALAYA,GARO HILLS EAST,2012,9,11,0,20,2,0,2,4,9,1,8,18,16,0,2,7,37,19,18,99,0,1,4,0,0,0,5,0,3,0,0,0,3,0,46,147
MEGHALAYA,GARO HILLS SOUTH,2012,7,11,0,18,6,0,6,12,15,2,13,30,2,1,1,5,40,27,13,89,0,2,10,2,3,4,27,0,2,0,1,0,3,6,28,146
MEGHALAYA,GARO HILLS WEST,2012,19,6,0,25,6,0,6,12,19,7,12,38,9,0,5,22,90,20,70,216,0,0,0,0,0,45,64,0,2,0,0,0,2,19,229,471
MEGHALAYA,JAINTIA HILLS,2012,44,11,0,55,32,0,32,64,18,5,13,36,8,0,7,13,66,25,41,160,0,9,14,2,14,25,77,0,3,0,0,0,3,13,116,395
MEGHALAYA,KHASI HILLS EAST,2012,31,8,6,45,58,0,58,116,18,5,13,36,7,0,25,84,208,37,171,532,0,26,61,5,32,62,225,1,21,0,13,0,35,39,212,917
MEGHALAYA,KHASI HILLS WEST,2012,16,13,1,30,28,0,28,56,6,0,6,12,7,0,5,11,32,3,29,87,0,5,11,3,2,12,33,0,8,0,0,0,8,0,64,224
MEGHALAYA,RI-BHOI,2012,11,3,1,15,32,0,32,64,7,4,3,14,3,0,1,3,70,21,49,147,0,1,8,1,10,9,54,0,4,0,2,0,6,25,66,257
MIZORAM,AIZAWL,2012,12,13,0,25,42,0,42,84,2,0,2,4,1,0,2,195,288,0,288,774,0,8,28,4,2,51,111,0,44,0,8,0,52,18,187,905
MIZORAM,CHAMPHAI,2012,5,1,5,11,12,0,12,24,1,1,0,2,0,0,0,44,104,6,98,252,0,0,5,0,0,11,21,0,15,0,0,0,15,5,22,230
MIZORAM,KOLASIB,2012,4,1,0,5,9,0,9,18,1,0,1,2,1,0,0,18,61,9,52,141,0,4,5,0,5,10,24,0,9,0,0,0,9,0,45,173
MIZORAM,LAWNGTLAI,2012,3,0,1,4,7,0,7,14,1,1,0,2,0,0,1,14,31,4,27,77,1,0,0,2,0,9,16,0,0,0,0,0,0,4,15,89
MIZORAM,LUNGLEI,2012,0,6,0,6,16,0,16,32,1,0,1,2,0,0,0,43,41,3,38,125,0,0,3,0,0,5,9,0,4,0,0,0,4,1,22,142
MIZORAM,MAMIT,2012,3,0,0,3,10,0,10,20,1,0,1,2,0,0,1,16,23,1,22,63,0,0,1,0,0,8,10,0,3,0,0,0,3,1,13,80
MIZORAM,SAIHA,2012,0,0,1,1,0,0,0,0,1,1,0,2,0,0,0,12,25,1,24,62,0,0,0,0,4,3,12,0,1,0,0,0,1,5,13,65
MIZORAM,SERCHHIP,2012,3,0,0,3,7,0,7,14,0,0,0,0,0,0,0,5,32,0,32,69,0,0,0,0,1,6,7,0,9,0,0,0,9,0,19,82
NAGALAND,DIMAPUR,2012,26,8,0,34,9,0,9,18,16,5,11,32,1,0,36,19,202,3,199,460,3,11,20,3,2,9,66,0,9,0,0,0,9,18,132,524
NAGALAND,KIPHIRE,2012,4,2,1,7,0,0,0,0,0,0,0,0,0,0,0,0,2,1,1,4,0,0,1,0,0,0,1,0,0,0,0,0,0,0,1,11
NAGALAND,KOHIMA,2012,11,10,1,22,1,0,1,2,3,0,3,6,0,0,9,15,72,44,28,168,0,5,10,0,0,2,17,0,2,0,0,0,2,0,37,178
NAGALAND,LONGLENG,2012,1,1,0,2,0,0,0,0,0,0,0,0,0,0,0,0,1,0,1,2,0,0,0,0,0,1,1,0,0,0,0,0,0,0,9,13
NAGALAND,MOKOKCHUNG,2012,5,6,0,11,3,0,3,6,0,0,0,0,0,0,0,7,11,4,7,29,0,1,2,0,1,2,14,0,3,0,0,0,3,8,12,61
NAGALAND,MON,2012,6,3,0,9,3,0,3,6,4,2,2,8,0,0,4,0,19,1,18,42,0,2,1,0,2,3,8,0,0,0,0,0,0,0,15,62
NAGALAND,PEREN,2012,5,1,0,6,0,0,0,0,1,0,1,2,0,0,1,4,9,3,6,23,0,1,1,0,0,2,4,0,0,0,0,0,0,0,4,29
NAGALAND,PHEK,2012,2,2,3,7,1,0,1,2,0,0,0,0,0,0,1,5,11,1,10,28,0,0,0,1,2,2,5,0,2,0,0,0,2,0,11,43
NAGALAND,TUENSANG,2012,4,2,1,7,1,0,1,2,0,0,0,0,0,0,0,4,12,0,12,28,0,2,3,0,0,0,10,0,0,0,0,0,0,5,10,44
NAGALAND,WOKHA,2012,1,4,0,5,2,0,2,4,0,0,0,0,0,0,1,0,28,7,21,57,0,0,0,0,0,6,6,0,0,0,0,0,0,0,17,59
NAGALAND,ZUNHEBOTO,2012,10,3,0,13,1,0,1,2,3,3,0,6,0,0,2,11,14,1,13,41,0,0,1,0,0,3,4,0,0,0,0,0,0,0,18,66
ODISHA,ANGUL,2012,65,63,0,128,63,0,63,126,59,55,4,118,16,0,104,161,535,151,384,1351,187,5,61,0,15,27,481,20,321,8,76,0,425,186,1863,3835
ODISHA,BALASORE,2012,75,51,4,130,87,0,87,174,140,130,10,280,26,0,62,234,434,130,304,1190,65,8,122,1,19,1720,1935,43,242,20,307,0,612,0,597,4257
ODISHA,BARAGARH,2012,33,90,0,123,35,0,35,70,36,30,6,72,14,1,68,93,176,33,143,528,149,15,34,1,23,72,411,3,154,14,96,0,267,117,525,1749
ODISHA,BERHAMPUR,2012,30,119,4,153,18,0,18,36,24,17,7,48,15,17,62,94,291,160,131,770,33,11,98,0,7,90,344,10,158,12,119,0,299,105,641,1958
ODISHA,BHADRAK,2012,39,55,0,94,54,0,54,108,72,66,6,144,10,0,17,81,174,51,123,456,20,18,87,0,15,38,257,20,93,12,155,0,280,79,1585,2624
ODISHA,BOLANGIR,2012,44,71,0,115,51,0,51,102,42,36,6,84,20,0,45,125,202,50,152,594,109,1,59,1,32,0,314,7,238,15,40,0,300,112,937,2151
ODISHA,BOUDH,2012,18,17,0,35,10,0,10,20,10,8,2,20,0,0,3,36,53,8,45,145,39,1,12,0,8,229,306,0,79,6,24,0,109,17,98,660
ODISHA,CUTTACK,2012,48,22,0,70,43,0,43,86,63,57,6,126,3,0,69,136,222,59,163,652,78,5,33,0,18,0,479,27,38,7,147,0,219,345,1578,2882
ODISHA,DCP BBSR,2012,46,72,0,118,56,0,56,112,91,76,15,182,19,9,81,292,1376,768,608,3153,64,13,172,5,12,726,1176,24,75,22,91,0,212,184,1530,4960
ODISHA,DCP CTC,2012,36,22,0,58,28,0,28,56,44,43,1,88,15,0,57,140,577,297,280,1366,32,8,80,0,3,0,242,14,30,2,134,0,180,119,1279,2620
ODISHA,DEOGARH,2012,23,16,0,39,17,0,17,34,7,5,2,14,23,1,14,18,23,5,18,102,10,0,4,0,2,224,266,2,41,0,9,0,52,26,13,473
ODISHA,DHENKANAL,2012,47,109,0,156,29,0,29,58,41,35,6,82,11,2,76,66,269,64,205,693,119,13,40,1,24,35,343,23,267,18,33,0,341,111,613,1947
ODISHA,GAJAPATI,2012,12,19,1,32,18,0,18,36,14,9,5,28,0,0,2,9,21,4,17,53,62,4,7,0,18,82,197,2,61,3,8,0,74,24,30,397
ODISHA,GANJAM,2012,86,259,0,345,53,0,53,106,67,55,12,134,18,21,75,128,205,86,119,652,177,23,37,0,40,315,646,32,356,27,39,0,454,54,283,2295
ODISHA,JAGATSINGHPUR,2012,37,27,0,64,43,0,43,86,57,52,5,114,28,2,83,116,368,99,269,965,32,4,37,0,21,201,521,20,43,2,123,0,188,226,669,2139
ODISHA,JAJPUR,2012,78,27,0,105,49,0,49,98,63,56,7,126,24,0,51,137,424,153,271,1060,74,21,43,2,18,872,1421,51,83,4,162,0,300,391,185,2759
ODISHA,JHARSUGUDA,2012,16,18,0,34,21,0,21,42,13,6,7,26,9,3,38,78,291,80,211,710,26,15,34,0,6,303,482,2,41,11,50,0,104,98,174,1247
ODISHA,KALAHANDI,2012,37,44,2,83,65,0,65,130,47,41,6,94,10,0,34,73,105,23,82,327,72,18,43,2,10,437,679,8,120,14,96,0,238,97,351,1685
ODISHA,KANDHAMAL,2012,29,0,0,29,32,0,32,64,30,27,3,60,4,0,13,48,77,16,61,219,16,7,30,0,5,302,360,1,101,4,34,0,140,0,108,841
ODISHA,KENDRAPARA,2012,49,21,1,71,38,0,38,76,69,65,4,138,5,5,38,108,188,63,125,532,22,9,33,0,28,140,232,48,7,4,43,0,102,0,1240,2096
ODISHA,KEONJHAR,2012,97,83,23,203,102,0,102,204,74,70,4,148,8,1,38,125,307,94,213,786,80,34,48,1,19,581,969,28,231,24,181,0,464,206,216,2507
ODISHA,KHURDA,2012,37,54,16,107,27,0,27,54,53,46,7,106,6,1,47,87,146,56,90,433,56,4,37,0,6,27,146,16,338,2,178,0,534,16,694,1848
ODISHA,KORAPUT,2012,55,50,0,105,73,0,73,146,36,31,5,72,18,0,48,85,143,25,118,437,92,1,28,0,15,0,197,21,114,9,0,0,144,61,581,1430
ODISHA,MALKANGIR,2012,40,44,0,84,17,0,17,34,22,19,3,44,12,0,4,21,48,7,41,133,48,10,27,0,3,0,107,5,51,4,14,0,74,19,113,502
ODISHA,MAYURBHANJ,2012,80,60,0,140,86,0,86,172,67,67,0,134,25,2,37,114,236,74,162,650,43,16,56,1,23,107,348,34,295,12,129,0,470,102,1040,2565
ODISHA,NAYAGARH,2012,38,99,0,137,25,0,25,50,43,35,8,86,12,0,40,63,148,42,106,411,36,2,31,0,16,417,557,16,11,1,17,0,45,55,172,1242
ODISHA,NOWRANGPUR,2012,39,20,2,61,42,0,42,84,45,45,0,90,4,0,20,38,64,11,53,190,49,2,20,0,5,86,231,2,83,14,43,0,142,69,375,1022
ODISHA,NUAPADA,2012,19,31,0,50,18,0,18,36,19,17,2,38,4,0,16,23,61,19,42,165,36,9,29,0,10,28,136,1,62,6,13,0,82,24,512,921
ODISHA,PURI,2012,61,67,0,128,42,0,42,84,55,51,4,110,12,10,114,219,460,155,305,1275,170,2,77,0,7,177,582,26,33,3,161,0,223,149,2038,3883
ODISHA,RAYAGADA,2012,24,51,0,75,41,0,41,82,43,40,3,86,9,1,18,73,90,13,77,281,36,12,16,0,13,41,197,4,111,9,29,0,153,79,344,1044
ODISHA,ROURKELA,2012,80,48,0,128,65,0,65,130,23,22,1,46,13,6,30,101,444,146,298,1038,19,9,66,1,6,171,426,2,102,4,29,0,137,154,488,1861
ODISHA,SAMBALPUR,2012,54,54,0,108,57,0,57,114,34,26,8,68,0,4,113,183,426,137,289,1152,74,7,54,2,9,248,593,0,62,4,32,0,98,199,858,2474
ODISHA,SONEPUR,2012,17,25,0,42,12,0,12,24,9,8,1,18,4,0,12,29,56,11,45,157,30,0,31,0,6,62,157,4,53,1,10,0,68,28,170,559
ODISHA,SRP(CUTTACK),2012,5,6,0,11,0,0,0,0,2,0,2,4,0,5,17,9,541,58,483,1113,0,0,7,0,0,14,21,0,11,1,0,0,12,0,82,700
ODISHA,SRP(ROURKELA),2012,6,6,0,12,1,0,1,2,3,3,0,6,1,7,19,25,275,31,244,602,0,0,4,0,0,0,4,1,9,0,2,0,12,0,95,454
ODISHA,SUNDARGARH,2012,48,59,1,108,40,0,40,80,25,15,10,50,4,1,48,62,174,31,143,463,50,10,10,1,7,451,682,8,73,5,14,0,100,153,126,1370
PUNJAB,AMRITSAR RURAL,2012,46,61,1,108,18,0,18,36,45,30,15,90,3,10,5,76,181,40,141,456,0,12,107,5,3,160,448,8,12,0,49,0,69,161,235,1198
PUNJAB,BARNALA,2012,18,21,2,41,25,0,25,50,9,8,1,18,0,5,1,37,90,31,59,223,0,5,78,0,0,75,246,2,4,0,14,0,20,88,214,688
PUNJAB,BATALA,2012,19,43,8,70,25,0,25,50,23,20,3,46,6,5,5,64,146,79,67,372,0,11,49,1,4,175,296,4,10,0,19,0,33,56,350,1023
PUNJAB,BHATINDA,2012,53,59,4,116,44,0,44,88,46,31,15,92,1,1,4,167,311,157,154,795,0,12,153,3,4,229,505,6,19,0,55,0,80,104,535,1810
PUNJAB,CP AMRITSAR,2012,42,80,2,124,27,0,27,54,52,45,7,104,2,14,25,158,416,149,267,1031,0,13,266,1,6,134,502,5,14,0,105,0,124,82,520,1964
PUNJAB,CP JALANDHAR,2012,14,46,5,65,33,0,33,66,39,29,10,78,1,3,18,195,443,192,251,1103,0,8,171,2,5,132,404,6,17,3,107,0,133,86,364,1698
PUNJAB,CP LUDHIANA,2012,79,78,11,168,69,0,69,138,123,99,24,246,2,21,19,196,504,225,279,1246,0,45,281,2,5,194,752,10,30,14,135,0,189,225,1022,3065
PUNJAB,FARIDKOT,2012,22,26,0,48,17,0,17,34,24,18,6,48,1,4,2,85,106,14,92,304,0,10,53,0,0,121,184,2,11,1,20,0,34,0,266,771
PUNJAB,FATEHGARH SAHIB,2012,17,11,2,30,15,0,15,30,10,7,3,20,0,5,1,63,81,32,49,231,0,7,85,0,0,137,358,2,3,1,21,0,27,129,177,767
PUNJAB,FAZILKA,2012,37,30,3,70,32,0,32,64,40,26,14,80,0,7,2,60,133,48,85,335,0,6,92,3,0,156,317,2,1,0,36,0,39,60,262,962
PUNJAB,FEROZPUR,2012,37,43,2,82,15,0,15,30,20,16,4,40,1,4,3,113,189,69,120,499,0,11,128,7,8,231,476,4,4,0,43,0,51,91,274,1228
PUNJAB,G.R.P,2012,5,5,1,11,0,0,0,0,0,0,0,0,0,0,0,1,55,9,46,111,0,0,3,1,0,8,12,2,0,0,0,0,2,0,278,359
PUNJAB,GURDASPUR,2012,19,27,5,51,14,0,14,28,37,34,3,74,1,3,1,68,94,25,69,261,0,10,77,0,0,101,258,10,11,0,45,0,66,70,247,840
PUNJAB,HOSHIARPUR,2012,45,31,4,80,33,0,33,66,41,28,13,82,0,15,38,174,229,63,166,685,0,10,104,1,3,250,532,8,14,0,70,0,92,164,392,1626
PUNJAB,JALANDHAR RURAL,2012,49,49,4,102,29,0,29,58,38,33,5,76,13,10,25,140,174,53,121,536,0,5,181,1,13,255,627,3,34,3,53,0,93,172,383,1634
PUNJAB,KAPURTHALA,2012,24,45,4,73,16,0,16,32,43,34,9,86,6,6,16,149,213,52,161,603,0,5,110,1,1,204,462,3,8,0,46,0,57,141,367,1408
PUNJAB,KHANNA,2012,20,23,2,45,14,0,14,28,15,10,5,30,0,1,1,58,146,89,57,352,0,4,65,0,0,98,286,0,3,0,18,0,21,119,247,834
PUNJAB,LUDHIANA RURAL,2012,25,31,5,61,11,0,11,22,32,21,11,64,0,11,3,80,94,27,67,282,0,13,75,0,0,78,247,4,5,1,23,0,33,81,257,829
PUNJAB,MANSA,2012,15,25,6,46,22,0,22,44,17,10,7,34,0,1,0,54,65,18,47,185,0,5,51,1,5,101,248,3,9,0,23,0,35,85,162,650
PUNJAB,MOGA,2012,37,44,2,83,23,0,23,46,20,10,10,40,2,3,6,107,154,82,72,426,1,9,114,2,5,161,408,3,14,0,25,0,42,116,304,1152
PUNJAB,MUKTSAR,2012,25,30,3,58,18,0,18,36,35,28,7,70,0,3,4,67,112,46,66,298,0,11,45,3,1,159,275,3,10,2,30,0,45,56,204,821
PUNJAB,PATHANKOT,2012,11,6,0,17,13,0,13,26,13,11,2,26,1,0,3,25,48,21,27,125,0,4,41,0,0,28,143,7,2,0,25,0,34,70,175,472
PUNJAB,PATIALA,2012,53,53,13,119,44,0,44,88,45,32,13,90,1,21,1,181,307,144,163,818,0,9,269,8,4,276,825,4,24,0,86,0,114,259,887,2545
PUNJAB,ROPAR,2012,20,8,1,29,22,0,22,44,21,18,3,42,0,4,0,78,220,72,148,522,0,4,78,0,4,90,327,0,13,3,15,0,31,151,376,1108
PUNJAB,SANGRUR,2012,41,45,6,92,34,0,34,68,39,31,8,78,1,10,5,112,181,66,115,490,0,18,134,1,3,220,554,7,24,3,40,0,74,178,1001,2103
PUNJAB,SAS NGR,2012,22,51,2,75,23,0,23,46,52,33,19,104,2,2,7,171,364,172,192,910,0,28,435,0,0,149,1104,7,31,0,127,0,165,492,449,2414
PUNJAB,SBS NAGAR,2012,19,15,1,35,21,0,21,42,17,13,4,34,2,4,12,70,88,20,68,264,0,6,72,0,0,117,280,0,3,0,25,0,28,85,147,704
PUNJAB,TARN TARAN,2012,41,59,5,105,23,1,22,46,23,14,9,46,2,11,6,79,128,16,112,354,0,8,134,6,0,147,379,3,10,0,38,0,51,84,310,1117
RAJASTHAN,AJMER,2012,38,36,7,81,70,0,70,140,107,76,31,214,1,4,17,151,630,381,249,1433,6,23,1174,3,13,236,1955,13,72,0,668,0,753,500,2781,6550
RAJASTHAN,ALWAR,2012,100,88,7,195,129,0,129,258,243,154,89,486,8,5,63,231,3220,2443,777,6747,8,23,1213,9,22,2612,4390,47,135,0,655,0,837,503,2620,11941
RAJASTHAN,BANSWARA,2012,34,16,3,53,56,0,56,112,96,87,9,192,0,1,13,74,129,47,82,346,50,13,137,0,21,632,993,4,49,3,237,0,293,140,1069,2777
RAJASTHAN,BARAN,2012,45,43,0,88,69,0,69,138,84,84,0,168,0,0,4,81,322,164,158,729,0,18,312,0,16,366,844,7,185,2,313,0,507,132,1597,3596
RAJASTHAN,BARMER,2012,29,30,3,62,21,0,21,42,35,35,0,70,0,0,3,115,387,228,159,892,0,17,346,0,19,442,1031,20,59,0,237,0,316,207,1774,3744
RAJASTHAN,BHARATPUR,2012,91,77,2,170,108,0,108,216,212,168,44,424,1,19,41,73,1466,975,491,3066,0,8,798,2,18,92,1165,32,79,0,567,0,678,247,4916,8849
RAJASTHAN,BHILWARA,2012,29,42,1,72,59,0,59,118,78,70,8,156,0,1,21,166,617,336,281,1422,18,5,590,2,13,63,1022,10,98,0,609,0,717,331,2140,4893
RAJASTHAN,BIKANER,2012,45,73,9,127,67,0,67,134,41,35,6,82,0,0,12,116,274,113,161,676,0,11,755,0,15,229,1277,16,31,0,546,0,593,267,2028,4535
RAJASTHAN,BUNDI,2012,18,32,5,55,43,0,43,86,81,77,4,162,0,0,3,57,242,123,119,544,5,8,292,1,10,654,1103,5,90,1,304,0,400,133,1140,3124
RAJASTHAN,CHITTORGARH,2012,38,25,2,65,59,0,59,118,96,81,15,192,0,5,18,130,431,208,223,1015,17,48,349,1,18,845,1490,6,64,1,608,0,679,212,1417,4390
RAJASTHAN,CHURU,2012,42,38,2,82,59,0,59,118,37,26,11,74,0,2,4,81,194,84,110,475,0,7,522,0,13,431,1193,8,5,0,405,0,418,220,1293,3363
RAJASTHAN,DAUSA,2012,30,17,6,53,14,0,14,28,101,75,26,202,0,1,18,33,942,567,375,1936,14,8,479,2,7,36,785,19,9,0,181,0,209,239,2945,5101
RAJASTHAN,DHOLPUR,2012,50,68,6,124,32,0,32,64,79,60,19,158,1,10,13,37,346,145,201,753,0,1,223,0,5,1290,1657,30,19,0,195,0,244,138,1196,3739
RAJASTHAN,DUNGARPUR,2012,26,12,1,39,32,0,32,64,67,65,2,134,0,0,16,41,57,30,27,171,9,32,65,1,13,159,415,5,48,0,119,0,172,136,1005,1844
RAJASTHAN,G.R.P.AJMER,2012,4,2,0,6,4,0,4,8,8,5,3,16,0,0,2,1,611,19,592,1225,5,4,7,0,0,5,21,1,13,0,0,0,14,0,121,788
RAJASTHAN,G.R.P.JODHPUR,2012,2,0,0,2,1,0,1,2,1,0,1,2,0,0,0,1,83,8,75,167,0,0,0,0,1,1,6,1,2,0,0,0,3,4,34,131
RAJASTHAN,GANGANAGAR,2012,51,66,0,117,77,0,77,154,79,73,6,158,0,0,3,174,311,130,181,799,0,32,958,2,5,691,1863,21,58,2,803,0,884,175,1919,5427
RAJASTHAN,HANUMANGARH,2012,49,58,0,107,92,0,92,184,63,57,6,126,1,2,5,77,230,106,124,545,0,5,607,0,9,276,1026,19,43,0,515,0,577,129,1897,4077
RAJASTHAN,JAIPUR EAST,2012,21,24,3,48,41,0,41,82,61,55,6,122,2,1,126,352,2510,2113,397,5501,48,19,626,3,8,57,987,10,24,0,201,0,235,226,2008,6371
RAJASTHAN,JAIPUR NORTH,2012,12,20,0,32,37,0,37,74,64,54,10,128,1,0,37,79,589,443,146,1295,12,23,519,1,2,263,880,13,29,0,265,0,307,60,910,2936
RAJASTHAN,JAIPUR RURAL,2012,38,37,2,77,39,0,39,78,96,86,10,192,8,2,21,139,596,250,346,1362,12,17,679,1,14,410,1553,11,46,0,281,0,338,420,2615,5484
RAJASTHAN,JAIPUR SOUTH,2012,17,17,1,35,17,0,17,34,26,21,5,52,1,1,53,218,1107,777,330,2487,4,79,527,3,2,103,871,7,20,0,217,0,244,153,1443,4016
RAJASTHAN,JAIPUR WEST,2012,26,20,2,48,38,0,38,76,69,60,9,138,1,1,40,319,1093,788,305,2547,3,107,1012,0,8,226,1627,0,18,0,257,0,275,271,1777,5288
RAJASTHAN,JAISALMER,2012,9,8,0,17,12,0,12,24,9,5,4,18,0,0,3,58,107,31,76,275,8,0,146,0,7,253,479,11,20,0,22,0,53,65,439,1177
RAJASTHAN,JALORE,2012,23,18,0,41,13,0,13,26,47,39,8,94,1,0,5,90,183,91,92,462,11,23,187,3,14,15,376,15,40,0,138,0,193,123,1531,2480
RAJASTHAN,JHALAWAR,2012,47,44,4,95,81,0,81,162,91,76,15,182,0,3,10,59,337,156,181,746,29,5,210,1,22,766,1170,5,205,2,434,0,646,137,1303,3795
RAJASTHAN,JHUNJHUNU,2012,36,15,3,54,45,0,45,90,63,55,8,126,0,0,9,127,291,118,173,718,11,16,510,0,12,560,1320,17,44,0,347,0,408,211,2041,4358
RAJASTHAN,JODHPUR EAST,2012,12,27,3,42,20,0,20,40,15,13,2,30,0,0,16,50,397,274,123,860,0,1,447,1,1,417,981,11,16,0,296,0,323,114,459,2303
RAJASTHAN,JODHPUR RURAL,2012,34,38,3,75,27,0,27,54,33,28,5,66,1,0,12,66,224,62,162,527,3,8,226,1,18,771,1278,16,26,0,121,0,163,251,909,2788
RAJASTHAN,JODHPUR WEST,2012,15,42,3,60,20,0,20,40,29,23,6,58,0,0,23,124,646,443,203,1439,0,6,275,2,12,286,751,5,27,0,5,0,37,170,538,2228
RAJASTHAN,KARAULI,2012,41,40,0,81,44,0,44,88,104,77,27,208,0,0,19,32,685,397,288,1421,8,6,213,2,17,2,356,15,7,0,196,0,218,108,3022,4561
RAJASTHAN,KOTA CITY,2012,28,68,1,97,45,0,45,90,82,62,20,164,0,7,27,86,596,408,188,1312,0,21,756,0,3,115,1005,5,73,0,428,0,506,110,1521,3972
RAJASTHAN,KOTA RURAL,2012,20,56,1,77,42,0,42,84,49,44,5,98,0,1,8,48,133,56,77,323,3,9,199,1,9,185,501,6,105,2,200,0,313,95,1159,2331
RAJASTHAN,NAGAUR,2012,49,58,2,109,53,0,53,106,129,106,23,258,1,0,7,155,343,145,198,849,0,8,568,0,7,84,954,11,66,0,416,0,493,287,2254,4498
RAJASTHAN,PALI,2012,56,56,8,120,61,0,61,122,107,104,3,214,2,1,28,178,328,148,180,865,0,11,453,0,11,68,855,9,75,1,464,0,549,312,3240,5469
RAJASTHAN,PRATAPGARH,2012,29,27,3,59,137,0,137,274,80,78,2,160,0,0,7,59,129,41,88,324,25,3,160,1,8,536,801,2,79,0,276,0,357,68,956,2585
RAJASTHAN,RAJSAMAND,2012,26,19,1,46,14,0,14,28,62,53,9,124,0,1,19,116,168,74,94,472,20,6,302,1,4,484,1003,5,40,1,263,0,309,186,701,2439
RAJASTHAN,SAWAI MADHOPUR,2012,24,27,2,53,19,0,19,38,95,75,20,190,0,1,5,40,605,405,200,1256,0,9,355,0,7,0,464,6,39,0,213,0,258,93,2514,4054
RAJASTHAN,SIKAR,2012,51,34,0,85,55,0,55,110,96,62,34,192,0,2,4,143,619,243,376,1387,11,10,912,1,23,234,1544,18,22,0,322,0,362,353,2914,5824
RAJASTHAN,SIROHI,2012,29,16,1,46,29,0,29,58,69,64,5,138,0,0,10,60,116,33,83,302,26,9,220,0,14,341,768,4,74,1,180,0,259,158,549,1906
RAJASTHAN,TONK,2012,21,24,0,45,19,0,19,38,69,66,3,138,0,0,3,74,233,106,127,543,36,6,310,0,4,860,1383,3,24,2,309,0,338,167,1068,3232
RAJASTHAN,UDAIPUR,2012,76,80,1,157,149,0,149,298,190,163,27,380,1,3,59,299,787,398,389,1936,171,17,1007,4,30,1518,3180,9,174,0,499,0,682,433,2477,7984
SIKKIM,EAST,2012,3,4,0,7,13,0,13,26,6,6,0,12,0,0,2,22,42,7,35,108,12,3,22,1,7,31,87,1,7,0,2,0,10,11,20,209
SIKKIM,NORTH,2012,1,1,0,2,0,0,0,0,0,0,0,0,0,0,0,5,7,0,7,19,0,0,0,0,0,5,10,0,0,0,0,0,0,5,7,31
SIKKIM,SOUTH,2012,1,2,0,3,12,0,12,24,3,3,0,6,0,0,2,21,39,7,32,101,5,0,6,0,7,33,59,0,6,0,1,0,7,8,19,165
SIKKIM,WEST,2012,2,0,0,2,9,0,9,18,1,1,0,2,0,0,2,17,29,3,26,77,5,0,3,0,6,22,44,0,6,0,1,0,7,8,12,123
TAMIL NADU,ARIYALUR,2012,19,32,3,54,11,0,11,22,47,39,8,94,1,0,8,41,131,51,80,312,41,0,11,0,13,433,624,1,53,0,13,0,67,126,1496,2480
TAMIL NADU,CHENNAI,2012,180,219,4,403,94,0,94,188,87,65,22,174,2,0,85,546,2169,263,1906,4971,95,50,769,137,10,1412,3884,12,90,141,237,0,480,1411,12131,19881
TAMIL NADU,CHENNAI RLY.,2012,1,5,0,6,0,0,0,0,2,2,0,4,2,0,18,1,214,3,211,449,2,0,0,0,0,29,37,0,5,0,2,0,7,6,271,558
TAMIL NADU,COIMBATORE RURAL,2012,51,28,0,79,9,0,9,18,41,32,9,82,4,0,72,125,354,102,252,909,130,4,89,0,10,442,1419,1,38,0,48,0,87,744,2903,5093
TAMIL NADU,COIMBATORE URBAN,2012,29,37,0,66,20,0,20,40,20,12,8,40,2,0,101,125,544,205,339,1316,16,9,132,59,21,272,802,0,17,2,112,0,131,293,8546,10357
TAMIL NADU,CUDDALORE,2012,70,120,3,193,40,0,40,80,152,124,28,304,7,2,44,192,518,254,264,1281,332,0,38,6,47,1384,2331,8,64,0,63,0,135,524,7704,11318
TAMIL NADU,DHARMAPURI,2012,50,32,10,92,25,0,25,50,98,93,5,196,1,0,21,73,155,58,97,405,92,3,36,11,42,994,1487,1,48,2,66,0,117,309,1673,3742
TAMIL NADU,DINDIGUL,2012,74,89,0,163,16,0,16,32,97,97,0,194,1,0,60,106,203,59,144,573,81,2,118,2,13,606,1384,4,34,0,111,0,149,562,3806,5985
TAMIL NADU,ERODE,2012,40,31,0,71,8,0,8,16,30,23,7,60,1,0,44,94,344,153,191,827,32,3,118,4,12,399,1162,1,42,0,26,0,69,594,2966,4789
TAMIL NADU,KANCHIPURAM,2012,76,113,0,189,19,0,19,38,17,17,0,34,1,0,22,167,548,205,343,1286,154,0,152,5,11,641,1829,3,17,1,17,0,38,866,5210,8040
TAMIL NADU,KANYAKUMARI,2012,53,110,2,165,12,0,12,24,33,33,0,66,6,0,86,203,240,70,170,775,0,3,132,5,50,740,1212,4,11,0,100,0,115,282,2738,4810
TAMIL NADU,KARUR,2012,26,18,0,44,4,0,4,8,49,48,1,98,1,0,30,39,135,44,91,340,28,4,18,0,2,198,570,1,25,2,11,0,39,320,1490,2401
TAMIL NADU,KRISHNAGIRI,2012,63,41,0,104,14,0,14,28,45,41,4,90,2,1,57,116,166,82,84,508,160,3,71,53,15,663,1443,1,51,1,33,0,86,478,2162,4196
TAMIL NADU,MADURAI RURAL,2012,76,142,2,220,30,0,30,60,83,75,8,166,7,7,121,191,370,105,265,1066,196,40,348,0,24,632,1711,11,75,4,71,0,161,471,3457,6358
TAMIL NADU,MADURAI URBAN,2012,31,74,0,105,11,0,11,22,65,51,14,130,2,0,79,68,459,201,258,1067,26,7,294,21,8,245,732,3,28,8,62,0,101,131,1639,3261
TAMIL NADU,NAGAPATTINAM,2012,56,44,0,100,10,0,10,20,42,40,2,84,2,0,18,68,200,68,132,488,59,0,18,0,28,518,877,1,34,36,10,0,81,254,2847,4245
TAMIL NADU,NAMAKKAL,2012,30,33,0,63,12,0,12,24,48,44,4,96,4,0,44,62,106,39,67,322,35,4,82,3,5,458,1081,1,39,15,8,0,63,494,2587,4070
TAMIL NADU,NILGIRIS,2012,14,17,0,31,9,0,9,18,8,7,1,16,0,0,5,65,42,10,32,154,8,1,26,1,2,195,282,1,15,2,8,0,26,49,748,1216
TAMIL NADU,PERAMBALUR,2012,11,15,0,26,3,0,3,6,31,31,0,62,1,0,13,37,83,34,49,217,34,0,21,0,2,168,371,0,22,0,6,0,28,146,862,1455
TAMIL NADU,PUDUKOTTAI,2012,31,36,1,68,6,0,6,12,33,28,5,66,1,0,18,34,141,50,91,335,55,13,42,0,12,282,751,0,26,1,35,0,62,347,2028,3142
TAMIL NADU,RAMNATHAPURAM,2012,54,81,1,136,9,0,9,18,40,35,5,80,4,0,45,81,178,43,135,486,99,3,55,1,24,487,942,3,15,3,18,0,39,273,2075,3549
TAMIL NADU,SALEM RURAL,2012,60,40,0,100,36,0,36,72,79,75,4,158,0,0,26,66,204,80,124,500,133,0,92,3,18,1418,2272,1,87,0,35,0,123,608,3033,5939
TAMIL NADU,SALEM URBAN,2012,16,22,0,38,15,0,15,30,23,18,5,46,4,0,39,31,162,102,60,398,32,2,35,1,1,315,530,3,12,14,21,0,50,144,1437,2329
TAMIL NADU,SIVAGANGAI,2012,47,58,0,105,11,0,11,22,43,39,4,86,4,1,34,95,194,50,144,522,75,9,83,1,13,319,785,3,37,0,57,0,97,285,2229,3598
TAMIL NADU,THANJAVUR,2012,62,97,0,159,14,0,14,28,57,43,14,114,4,4,100,167,420,249,171,1115,176,7,99,0,36,894,1678,1,76,0,28,0,105,466,4077,6785
TAMIL NADU,THENI,2012,39,69,1,109,22,0,22,44,45,40,5,90,3,0,48,113,215,68,147,594,83,0,129,0,20,622,1086,5,50,0,63,0,118,232,2553,4312
TAMIL NADU,THIRUNELVELI RURAL,2012,88,288,0,376,44,0,44,88,52,43,9,104,1,1,103,185,230,52,178,750,4,9,227,5,81,1061,1824,3,58,0,266,0,327,437,5881,9024
TAMIL NADU,THIRUNELVELI URBAN,2012,19,163,0,182,3,0,3,6,7,3,4,14,0,0,38,18,58,8,50,172,0,2,64,21,7,119,300,2,6,0,25,0,33,87,713,1352
TAMIL NADU,THIRUVALLUR,2012,40,49,2,91,18,0,18,36,14,12,2,28,1,0,24,117,203,58,145,548,105,3,40,0,5,447,911,5,8,1,19,0,33,311,2167,3579
TAMIL NADU,THIRUVANNAMALAI,2012,52,56,0,108,21,0,21,42,62,52,10,124,2,0,19,76,241,72,169,579,148,0,78,2,20,635,1316,1,8,0,37,0,46,433,2983,4874
TAMIL NADU,THIRUVARUR,2012,33,45,0,78,11,0,11,22,34,33,1,68,1,2,20,68,175,54,121,441,20,1,19,0,25,536,786,1,6,0,16,0,23,185,2841,4039
TAMIL NADU,THOOTHUGUDI,2012,85,208,0,293,26,0,26,52,41,35,6,82,3,0,78,184,248,57,191,761,0,5,92,0,32,686,1198,1,1,0,50,0,52,383,3201,5324
TAMIL NADU,TIRUPPUR,2012,63,83,0,146,8,0,8,16,51,38,13,102,6,0,131,283,554,257,297,1528,67,21,155,4,8,645,1592,7,52,0,76,0,135,692,4140,7046
TAMIL NADU,TRICHY RLY.,2012,2,3,0,5,0,0,0,0,1,1,0,2,0,0,3,1,82,0,82,168,2,0,2,0,0,15,26,0,2,0,1,0,3,7,95,216
TAMIL NADU,TRICHY RURAL,2012,44,44,0,88,14,0,14,28,29,23,6,58,0,0,46,73,103,39,64,325,34,0,22,1,6,377,939,3,33,0,24,0,60,499,3133,4485
TAMIL NADU,TRICHY URBAN,2012,26,22,0,48,7,0,7,14,22,13,9,44,0,0,56,42,253,52,201,604,7,0,103,5,3,146,411,3,9,39,24,0,75,147,2012,2926
TAMIL NADU,VELLORE,2012,76,82,11,169,24,0,24,48,76,68,8,152,6,0,40,188,489,251,238,1212,9,18,71,23,17,789,1662,8,38,0,61,0,107,735,4949,7710
TAMIL NADU,VILLUPURAM,2012,100,211,4,315,78,0,78,156,202,188,14,404,7,1,51,189,601,335,266,1450,486,1,99,1,59,1326,2851,4,239,0,58,0,301,879,5890,10486
TAMIL NADU,VIRUDHUNAGAR,2012,62,97,0,159,23,0,23,46,39,32,7,78,3,0,51,127,264,32,232,709,80,35,171,2,24,552,1153,2,23,110,47,0,182,289,3503,5504
TRIPURA,DHALAI,2012,20,8,1,29,35,0,35,70,11,8,3,22,2,0,13,17,29,2,27,90,8,9,7,1,1,70,96,5,30,0,56,0,91,0,120,443
TRIPURA,GOMATI,2012,18,8,0,26,26,0,26,52,16,14,2,32,2,0,5,28,132,38,94,299,29,5,12,1,7,321,375,4,34,0,157,0,195,0,342,1147
TRIPURA,GRP,2012,1,0,0,1,0,0,0,0,0,0,0,0,0,0,0,0,5,0,5,10,0,0,1,0,0,1,2,0,0,0,0,0,0,0,2,10
TRIPURA,KHOWAI,2012,12,4,0,16,10,0,10,20,5,3,2,10,0,0,1,18,33,7,26,85,13,3,9,0,7,131,163,3,22,0,36,0,61,0,116,423
TRIPURA,NORTH,2012,11,10,0,21,29,0,29,58,16,10,6,32,2,0,4,19,45,9,36,115,8,7,11,0,6,105,137,3,48,2,101,0,154,0,126,553
TRIPURA,SIPAHIJALA,2012,12,9,0,21,23,0,23,46,29,24,5,58,0,0,10,37,84,17,67,215,16,1,14,0,17,250,303,3,42,1,155,0,201,5,279,987
TRIPURA,SOUTH,2012,15,20,0,35,30,0,30,60,17,16,1,34,1,0,8,37,46,2,44,138,23,6,12,2,2,190,235,5,46,0,89,0,140,0,225,774
TRIPURA,UNAKOTI,2012,9,8,1,18,26,0,26,52,10,9,1,20,0,0,9,5,45,2,43,104,6,4,20,2,3,159,195,2,26,2,92,0,122,1,103,533
TRIPURA,WEST,2012,26,12,0,38,50,0,50,100,35,30,5,70,0,0,10,78,146,63,83,380,25,12,19,3,16,277,356,12,66,2,172,0,252,4,429,1394
UTTAR PRADESH,AGRA,2012,152,171,40,363,58,0,58,116,321,255,66,642,14,5,233,392,3472,2744,728,7588,476,163,350,13,7,377,1783,88,134,0,320,0,542,397,2177,9360
UTTAR PRADESH,ALIGARH,2012,177,150,30,357,64,0,64,128,298,263,35,596,22,4,121,192,1350,824,526,3039,252,115,377,6,18,254,1422,71,101,0,268,0,440,400,1536,5806
UTTAR PRADESH,ALLAHABAD,2012,115,114,35,264,52,0,52,104,223,202,21,446,4,5,55,272,1307,956,351,2950,113,100,308,8,18,411,1345,63,79,0,247,0,389,387,2478,6394
UTTAR PRADESH,AMBEDKAR NAGAR,2012,35,32,9,76,12,0,12,24,69,61,8,138,0,0,24,31,123,53,70,301,66,25,69,0,0,147,420,9,10,0,75,0,94,113,362,1211
UTTAR PRADESH,AURAIYA,2012,24,29,9,62,13,0,13,26,102,87,15,204,1,0,19,31,150,89,61,351,9,30,60,0,0,87,327,18,27,0,40,0,85,141,529,1319
UTTAR PRADESH,AZAMGARH,2012,73,88,34,195,19,0,19,38,121,101,20,242,1,0,59,72,240,128,112,612,182,20,131,4,1,328,881,25,28,0,101,0,154,215,542,2284
UTTAR PRADESH,BADAUN,2012,108,136,31,275,24,0,24,48,107,101,6,214,3,0,40,63,218,97,121,542,6,0,49,2,1,315,553,47,48,0,65,0,160,180,1094,2537
UTTAR PRADESH,BAGHPAT,2012,80,93,16,189,18,0,18,36,80,74,6,160,3,3,46,46,260,126,134,618,63,42,63,4,0,134,400,19,26,0,76,0,121,94,394,1560
UTTAR PRADESH,BAHRAICH,2012,41,42,23,106,27,0,27,54,116,111,5,232,1,1,15,74,215,106,109,521,69,35,141,3,3,173,526,38,28,0,4,0,70,102,1218,2369
UTTAR PRADESH,BALLIA,2012,45,27,15,87,12,0,12,24,84,79,5,168,8,0,38,97,235,134,101,613,102,13,70,3,3,239,591,28,22,0,51,0,101,161,354,1607
UTTAR PRADESH,BALRAMPUR,2012,23,10,2,35,12,0,12,24,53,53,0,106,2,0,6,33,62,33,29,165,21,11,66,2,2,74,206,5,17,0,4,0,26,30,151,586
UTTAR PRADESH,BANDA,2012,40,24,20,84,22,0,22,44,48,48,0,96,0,0,9,42,134,49,85,319,34,21,32,0,15,24,232,36,58,0,51,0,145,106,508,1224
UTTAR PRADESH,BARABANKI,2012,73,51,29,153,31,0,31,62,130,120,10,260,0,0,16,53,197,90,107,463,12,43,141,1,4,256,717,31,39,0,114,0,184,260,615,2096
UTTAR PRADESH,BAREILLY,2012,114,151,36,301,86,0,86,172,265,249,16,530,3,0,68,146,762,379,383,1741,134,107,388,3,15,795,1735,61,112,0,88,0,261,293,1601,5228
UTTAR PRADESH,BASTI,2012,33,19,14,66,7,0,7,14,61,55,6,122,0,0,12,36,161,90,71,370,13,20,68,3,1,134,380,21,17,0,69,0,107,141,407,1237
UTTAR PRADESH,BHIM NAGAR,2012,77,96,23,196,23,0,23,46,93,91,2,186,7,0,43,91,279,118,161,699,99,24,79,1,0,121,401,27,30,0,64,0,121,77,660,1914
UTTAR PRADESH,BIJNOR,2012,89,67,16,172,43,0,43,86,160,148,12,320,4,0,56,74,357,133,224,848,67,52,229,0,0,5,795,19,43,0,257,0,319,442,1128,3108
UTTAR PRADESH,BULANDSHAHAR,2012,140,144,44,328,46,0,46,92,188,164,24,376,6,1,61,78,526,255,271,1198,97,48,213,3,5,14,709,48,63,2,304,0,417,329,1194,3554
UTTAR PRADESH,CHANDOLI,2012,25,14,10,49,11,0,11,22,34,32,2,68,2,0,13,25,124,55,69,288,9,24,38,1,4,188,363,14,23,0,37,0,74,99,348,1043
UTTAR PRADESH,CHITRAKOOT DHAM,2012,34,10,9,53,31,0,31,62,43,27,16,86,2,0,7,68,97,27,70,271,16,14,29,1,7,13,160,22,35,0,23,0,80,80,239,780
UTTAR PRADESH,CSM NAGAR,2012,35,55,15,105,26,0,26,52,105,92,13,210,1,3,17,59,137,71,66,354,51,22,37,2,2,237,498,12,52,0,56,0,120,147,451,1522
UTTAR PRADESH,DEORIA,2012,35,25,18,78,18,0,18,36,67,67,0,134,2,1,12,47,177,117,60,416,48,23,120,3,0,147,444,29,16,0,34,0,79,103,521,1446
UTTAR PRADESH,ETAH,2012,73,115,21,209,22,0,22,44,110,99,11,220,9,0,37,41,389,219,170,865,108,47,120,0,14,235,720,38,62,0,82,0,182,196,749,2468
UTTAR PRADESH,ETAWAH,2012,59,55,9,123,9,0,9,18,71,64,7,142,3,0,33,52,273,190,83,634,14,34,80,1,7,78,361,26,26,0,42,0,94,147,977,1996
UTTAR PRADESH,FAIZABAD,2012,45,41,11,97,29,0,29,58,143,133,10,286,0,0,33,91,263,127,136,650,66,45,96,4,0,213,629,18,32,0,7,0,57,205,939,2281
UTTAR PRADESH,FATEHGARH,2012,68,66,10,144,14,0,14,28,106,94,12,212,4,0,15,75,267,154,113,628,30,36,80,2,0,56,324,34,39,0,71,0,144,120,515,1608
UTTAR PRADESH,FATEHPUR,2012,79,33,20,132,35,0,35,70,118,106,12,236,6,0,17,63,131,73,58,348,48,48,98,0,3,295,760,41,65,0,56,0,162,268,728,2152
UTTAR PRADESH,FIROZABAD,2012,100,108,30,238,32,0,32,64,193,149,44,386,3,0,85,64,635,421,214,1422,138,59,146,1,1,289,902,50,49,0,98,0,197,268,747,3096
UTTAR PRADESH,G.R.P.,2012,22,11,7,40,3,0,3,6,14,7,7,28,8,0,40,1,1836,87,1749,3721,23,14,32,3,0,4,77,2,36,0,0,0,38,1,725,2782
UTTAR PRADESH,GAUTAMBUDH NAGAR,2012,89,103,16,208,19,0,19,38,158,115,43,316,7,1,202,189,2912,2008,904,6223,150,101,322,4,1,91,1023,17,50,0,142,0,209,354,1759,6687
UTTAR PRADESH,GHAZIABAD,2012,146,111,39,296,31,0,31,62,255,220,35,510,6,11,106,207,2707,2103,604,5744,76,111,324,6,0,14,889,41,60,0,277,0,378,358,2591,7477
UTTAR PRADESH,GHAZIPUR,2012,47,56,23,126,9,0,9,18,61,53,8,122,3,0,28,78,173,105,68,455,64,17,102,1,3,216,512,32,16,0,60,0,108,109,332,1430
UTTAR PRADESH,GONDA,2012,39,38,22,99,23,0,23,46,125,103,22,250,0,0,31,106,238,96,142,613,111,58,254,3,0,340,895,37,40,0,5,0,82,129,859,2458
UTTAR PRADESH,GORAKHPUR,2012,98,136,45,279,52,0,52,104,232,207,25,464,14,0,69,197,971,685,286,2222,236,102,413,8,6,410,1464,53,56,0,180,0,289,289,1010,4577
UTTAR PRADESH,HAMIRPUR,2012,36,27,21,84,25,0,25,50,46,40,6,92,5,0,17,28,72,17,55,194,19,22,19,0,4,58,196,17,37,0,28,0,82,74,293,848
UTTAR PRADESH,HARDOI,2012,77,57,30,164,30,0,30,60,135,133,2,270,0,0,12,52,246,101,145,556,43,31,93,0,3,243,695,48,54,0,87,0,189,282,1482,3005
UTTAR PRADESH,HATHRAS,2012,53,52,13,118,17,0,17,34,84,71,13,168,14,0,43,77,283,160,123,700,71,26,77,2,3,145,469,18,39,0,91,0,148,145,517,1770
UTTAR PRADESH,J.P.NAGAR,2012,60,36,15,111,34,0,34,68,69,58,11,138,4,2,52,36,234,134,100,562,57,22,120,0,0,106,458,19,31,0,82,0,132,153,517,1649
UTTAR PRADESH,JALAUN,2012,46,32,10,88,15,0,15,30,68,57,11,136,3,0,16,37,153,94,59,362,33,22,60,3,0,10,253,40,32,0,47,0,119,125,540,1292
UTTAR PRADESH,JAUNPUR,2012,50,64,27,141,15,0,15,30,115,111,4,230,1,3,53,51,186,91,95,480,49,26,75,0,9,324,680,51,18,0,55,0,124,197,453,1822
UTTAR PRADESH,JHANSI,2012,65,50,14,129,19,0,19,38,74,63,11,148,2,0,29,81,346,229,117,804,73,28,67,8,7,153,534,33,34,0,53,0,120,198,682,2016
UTTAR PRADESH,KANNAUJ,2012,48,36,13,97,12,0,12,24,86,75,11,172,0,0,8,40,128,57,71,304,26,30,71,0,5,5,325,27,36,0,106,0,169,188,824,1689
UTTAR PRADESH,KANPUR NAGAR,2012,151,126,28,305,55,0,55,110,318,281,37,636,13,2,142,225,1514,1178,336,3410,137,182,506,11,2,289,1596,56,110,0,317,0,483,469,2365,7018
UTTAR PRADESH,KANSHIRAM NAGAR,2012,50,54,6,110,18,0,18,36,65,56,9,130,0,0,12,21,133,76,57,299,42,21,54,0,2,134,336,26,36,0,26,0,88,83,340,1123
UTTAR PRADESH,KAUSHAMBI,2012,44,12,14,70,11,0,11,22,54,49,5,108,1,0,13,49,88,28,60,239,22,13,66,1,2,80,300,20,31,0,46,0,97,116,619,1302
UTTAR PRADESH,KHIRI,2012,89,98,21,208,34,0,34,68,182,169,13,364,2,1,23,50,417,233,184,910,42,19,69,1,1,432,821,51,59,0,57,0,167,257,1012,2917
UTTAR PRADESH,KUSHI NAGAR,2012,36,28,22,86,30,0,30,60,98,94,4,196,1,0,10,39,146,100,46,342,101,32,83,1,10,166,601,28,22,0,28,0,78,208,609,1698
UTTAR PRADESH,LALITPUR,2012,23,10,11,44,14,0,14,28,25,22,3,50,0,0,11,23,57,25,32,148,16,26,39,0,0,15,153,7,27,0,13,0,47,57,323,697
UTTAR PRADESH,LUCKNOW,2012,141,99,27,267,48,0,48,96,315,304,11,630,8,1,63,479,2462,1663,799,5475,195,411,952,6,3,91,2139,32,110,2,538,0,682,481,4619,11083
UTTAR PRADESH,MAHARAJGANJ,2012,30,21,16,67,34,0,34,68,95,95,0,190,9,0,10,52,88,41,47,247,85,26,157,1,8,171,631,20,14,0,23,0,57,183,481,1524
UTTAR PRADESH,MAHOBA,2012,29,16,7,52,16,0,16,32,48,43,5,96,0,0,12,49,81,19,62,223,24,19,34,0,1,5,145,20,48,0,24,0,92,62,296,791
UTTAR PRADESH,MAINPURI,2012,81,84,18,183,15,0,15,30,139,117,22,278,7,0,56,70,404,293,111,941,78,28,72,0,10,196,592,39,51,0,81,0,171,208,763,2400
UTTAR PRADESH,MATHURA,2012,101,121,19,241,41,0,41,82,155,124,31,310,12,0,73,66,840,598,242,1831,143,78,224,7,8,188,1046,34,75,0,235,0,344,398,1620,4438
UTTAR PRADESH,MAU,2012,23,61,15,99,9,0,9,18,82,81,1,164,1,1,27,73,198,134,64,498,105,35,142,2,11,237,620,11,31,0,92,0,134,88,291,1535
UTTAR PRADESH,MEERUT,2012,202,246,28,476,54,0,54,108,287,231,56,574,16,5,264,277,2394,1668,726,5350,284,108,443,8,1,22,1250,39,129,0,435,0,603,384,2358,7984
UTTAR PRADESH,MIRZAPUR,2012,27,3,8,38,4,0,4,8,7,6,1,14,1,0,3,21,41,20,21,107,0,13,57,1,3,85,235,24,3,0,29,0,56,76,369,775
UTTAR PRADESH,MORADABAD,2012,90,84,14,188,36,0,36,72,162,140,22,324,14,2,95,109,842,499,343,1904,97,42,153,1,0,88,599,28,72,3,255,0,358,218,1247,3652
UTTAR PRADESH,MUZAFFARNAGAR,2012,126,134,21,281,27,0,27,54,217,177,40,434,5,2,62,74,594,325,269,1331,94,63,183,3,1,28,573,16,38,0,225,0,279,201,1601,3715
UTTAR PRADESH,PANCHSHIL NAGAR,2012,56,68,14,138,15,0,15,30,65,51,14,130,1,1,38,30,366,213,153,802,49,31,86,1,0,35,380,17,22,0,56,0,95,178,636,1765
UTTAR PRADESH,PILIBHIT,2012,47,21,6,74,10,0,10,20,65,62,3,130,7,0,7,11,83,37,46,191,6,38,135,3,0,1,275,25,15,0,79,0,119,92,1645,2296
UTTAR PRADESH,PRABUDDH NAGAR,2012,55,58,12,125,7,0,7,14,64,62,2,128,1,1,41,24,169,89,80,405,56,11,46,3,0,4,176,12,14,0,55,0,81,56,579,1268
UTTAR PRADESH,PRATAPGARH,2012,57,81,21,159,36,0,36,72,116,109,7,232,2,1,43,101,238,143,95,623,151,63,104,2,20,361,880,24,53,0,72,0,149,179,629,2354
UTTAR PRADESH,RAIBAREILLY,2012,37,39,9,85,36,0,36,72,96,91,5,192,1,0,14,67,179,79,100,440,45,50,60,1,1,137,486,23,46,0,50,0,119,192,691,1774
UTTAR PRADESH,RAMABAI NAGAR,2012,44,14,8,66,18,0,18,36,83,74,9,166,1,0,11,18,85,39,46,200,25,48,86,1,6,194,614,28,32,0,77,0,137,254,980,2013
UTTAR PRADESH,RAMPUR,2012,51,66,13,130,26,0,26,52,100,95,5,200,5,7,48,62,338,151,187,798,60,65,146,4,0,1,401,12,32,0,138,0,182,125,806,2105
UTTAR PRADESH,SAHARANPUR,2012,70,78,37,185,18,0,18,36,101,91,10,202,1,3,34,30,448,230,218,964,68,27,245,5,1,113,627,27,17,1,113,0,158,168,1649,3254
UTTAR PRADESH,SANT KABIRNAGAR,2012,16,17,8,41,18,0,18,36,50,49,1,100,0,0,9,33,55,28,27,152,17,19,37,0,6,134,281,12,5,0,10,0,27,68,222,736
UTTAR PRADESH,SHAHJAHANPUR,2012,77,80,21,178,27,0,27,54,130,120,10,260,3,0,17,43,227,95,132,517,29,41,111,5,20,250,769,51,48,0,73,0,172,313,1066,2632
UTTAR PRADESH,SHRAWASTI,2012,24,10,7,41,22,0,22,44,42,40,2,84,18,1,5,17,57,8,49,155,7,5,21,0,0,137,200,18,20,0,1,0,39,30,111,553
UTTAR PRADESH,SIDHARTHNAGAR,2012,27,5,4,36,22,0,22,44,48,47,1,96,2,0,3,27,79,36,43,190,15,12,23,1,0,38,191,8,13,0,35,0,56,102,243,707
UTTAR PRADESH,SITAPUR,2012,96,81,23,200,49,0,49,98,241,224,17,482,3,0,32,114,405,159,246,959,69,51,96,0,22,219,681,45,94,0,125,0,264,224,1371,3360
UTTAR PRADESH,SONBHADRA,2012,25,13,19,57,21,0,21,42,31,28,3,62,1,0,8,35,95,39,56,234,2,19,40,1,0,131,315,17,18,0,21,0,56,122,282,901
UTTAR PRADESH,ST.RAVIDASNAGAR,2012,10,20,7,37,4,0,4,8,18,18,0,36,0,0,2,18,47,20,27,114,6,15,36,1,0,56,166,7,6,0,13,0,26,52,148,466
UTTAR PRADESH,SULTANPUR,2012,44,80,13,137,26,0,26,52,67,63,4,134,7,0,33,108,279,150,129,706,90,17,48,0,13,243,540,15,29,0,84,0,128,129,496,1821
UTTAR PRADESH,UNNAO,2012,60,46,26,132,41,0,41,82,182,174,8,364,1,0,14,90,201,88,113,507,46,47,111,1,2,35,549,44,81,0,141,0,266,307,1207,2683
UTTAR PRADESH,VARANASI,2012,59,62,13,134,21,0,21,42,99,85,14,198,0,0,28,94,700,444,256,1522,96,132,341,24,1,216,1033,35,26,0,177,0,238,223,1118,3465
UTTARAKHAND,ALMORA,2012,4,6,1,11,5,0,5,10,0,0,0,0,0,0,4,10,21,3,18,56,3,3,6,0,3,0,23,2,5,5,5,0,17,8,59,150
UTTARAKHAND,BAGESHWAR,2012,3,2,0,5,8,0,8,16,1,1,0,2,0,0,0,6,4,1,3,14,3,0,5,0,2,11,23,4,5,0,2,0,11,2,16,74
UTTARAKHAND,CHAMOLI,2012,1,3,1,5,2,0,2,4,2,2,0,4,0,0,0,8,9,0,9,26,3,3,5,0,0,14,30,1,4,0,0,0,5,5,13,74
UTTARAKHAND,CHAMPAWAT,2012,2,1,0,3,3,0,3,6,0,0,0,0,0,0,1,10,5,0,5,21,2,0,6,0,0,25,45,1,4,0,0,0,5,12,13,85
UTTARAKHAND,DEHRADUN,2012,37,29,7,73,30,0,30,60,43,41,2,86,4,0,19,118,575,277,298,1291,86,32,185,8,4,467,916,13,24,34,111,0,182,134,229,2189
UTTARAKHAND,HARIDWAR,2012,74,54,9,137,47,0,47,94,106,73,33,212,11,1,67,71,619,309,310,1388,115,48,142,5,3,390,879,10,38,17,89,0,154,176,521,2613
UTTARAKHAND,NAINITAL,2012,17,12,10,39,16,0,16,32,29,29,0,58,2,0,12,30,107,53,54,258,33,8,26,1,0,20,158,10,11,9,22,0,52,70,295,740
UTTARAKHAND,PAURI GARHWAL,2012,9,2,3,14,2,0,2,4,10,10,0,20,0,0,3,19,58,22,36,138,19,9,18,2,0,28,86,2,1,3,2,0,8,10,56,256
UTTARAKHAND,PITHORAGARH,2012,9,0,2,11,1,0,1,2,1,1,0,2,0,0,0,18,7,1,6,32,4,2,4,0,3,15,32,2,2,1,2,0,7,4,26,103
UTTARAKHAND,RUDRA PRAYAG,2012,3,0,3,6,2,0,2,4,3,3,0,6,0,0,4,13,6,0,6,29,5,1,14,0,0,6,30,1,5,4,4,0,14,4,33,111
UTTARAKHAND,TEHRI GARHWAL,2012,5,2,0,7,1,0,1,2,3,3,0,6,0,0,3,5,17,7,10,42,5,1,7,4,1,0,26,3,1,0,0,0,4,8,35,101
UTTARAKHAND,UDHAMSINGH NAGAR,2012,52,50,8,110,30,0,30,60,95,91,4,190,12,2,31,80,474,273,201,1073,87,30,109,2,0,43,507,22,38,0,128,0,188,236,785,2314
UTTARAKHAND,UTTARKASHI,2012,1,0,0,1,1,0,1,2,4,2,2,8,0,0,0,3,11,3,8,25,4,0,2,0,1,3,11,0,1,0,3,0,4,1,37,72
WEST BENGAL,24 PARGANAS NORTH,2012,140,108,80,328,118,0,118,236,497,338,159,994,34,40,61,6,1453,381,1072,3047,680,94,141,9,19,79,1032,74,196,1,1860,3,2134,10,6062,11765
WEST BENGAL,24 PARGANAS SOUTH,2012,224,8,28,260,244,0,244,488,419,419,0,838,34,58,35,51,1279,194,1085,2736,1976,4,250,6,15,234,2555,45,83,0,1666,0,1794,70,7641,14370
WEST BENGAL,ASANSOL,2012,60,25,9,94,36,0,36,72,77,49,28,154,15,44,75,21,947,254,693,2049,212,20,15,3,1,93,539,15,31,4,240,0,290,195,1759,3897
WEST BENGAL,BANKURA,2012,61,37,6,104,35,0,35,70,84,80,4,168,11,11,26,14,224,47,177,510,219,31,66,0,22,187,721,26,90,3,221,0,340,196,1188,2758
WEST BENGAL,BDN CP,2012,15,35,4,54,13,0,13,26,53,0,53,106,3,53,17,10,847,216,631,1777,32,15,186,3,0,0,236,9,58,8,320,0,395,0,1765,3446
WEST BENGAL,BIRBHUM,2012,113,186,63,362,49,0,49,98,76,62,14,152,10,49,42,26,374,112,262,875,248,17,74,4,20,521,1061,23,87,0,245,0,355,177,679,3083
WEST BENGAL,BKP CP,2012,89,49,18,156,36,0,36,72,214,201,13,428,16,44,48,9,1357,508,849,2831,125,49,224,3,0,143,668,20,88,2,989,0,1099,124,2961,6608
WEST BENGAL,BURDWAN,2012,91,167,23,281,58,0,58,116,99,65,34,198,6,71,41,6,470,194,276,1064,349,32,202,1,23,578,1629,55,145,0,224,0,424,444,1589,4674
WEST BENGAL,COOCHBEHAR,2012,48,94,25,167,92,0,92,184,179,169,10,358,3,5,9,12,284,90,194,597,69,23,86,3,26,163,489,25,117,8,539,0,689,119,1562,3491
WEST BENGAL,DAKSHIN DINAJPUR,2012,53,238,8,299,66,0,66,132,142,107,35,284,1,1,3,4,252,27,225,513,15,36,63,3,10,221,465,18,83,3,342,0,446,117,1046,2725
WEST BENGAL,DARJEELING,2012,27,17,15,59,10,0,10,20,47,39,8,94,6,1,6,2,318,55,263,651,2,20,15,3,8,632,803,2,52,4,106,0,164,123,158,1574
WEST BENGAL,HOOGHLY,2012,132,37,16,185,68,0,68,136,177,145,32,354,10,93,26,6,807,205,602,1749,531,34,284,12,31,47,949,32,86,5,1195,0,1318,10,2795,6434
WEST BENGAL,HOWRAH,2012,67,32,13,112,56,0,56,112,132,120,12,264,14,28,36,67,439,117,322,1023,203,67,125,0,4,194,845,16,99,31,883,0,1029,252,2301,5059
WEST BENGAL,HOWRAH CITY,2012,39,3,9,51,28,0,28,56,191,135,56,382,3,37,35,19,1166,274,892,2426,85,65,214,6,4,36,431,15,199,71,550,0,835,21,2879,5675
WEST BENGAL,HOWRAH G.R.P.,2012,16,9,6,31,2,0,2,4,4,2,2,8,2,8,3,0,323,0,323,659,3,2,15,3,0,3,26,1,4,0,1,0,6,0,94,499
WEST BENGAL,JALPAIGURI,2012,117,156,27,300,163,0,163,326,334,279,55,668,5,4,36,25,1461,292,1169,2992,42,54,104,5,21,220,760,17,179,0,1625,0,1821,314,2952,7861
WEST BENGAL,JHARGRAM,2012,30,23,5,58,21,0,21,42,21,21,0,42,10,1,19,3,97,11,86,227,52,3,17,1,1,11,136,6,28,0,47,0,81,51,264,711
WEST BENGAL,KHARAGPUR G.R.P.,2012,6,0,0,6,2,0,2,4,4,4,0,8,0,4,3,1,149,0,149,306,0,0,0,0,0,3,3,0,3,1,2,0,6,0,21,199
WEST BENGAL,KOLKATA,2012,85,154,29,268,68,0,68,136,271,210,61,542,8,20,44,96,4960,659,4301,10088,397,428,2100,26,0,3518,6976,19,486,377,865,9,1756,507,10903,25370
WEST BENGAL,MALDA,2012,118,322,21,461,158,0,158,316,290,189,101,580,2,37,15,21,413,161,252,901,59,10,112,110,25,787,1103,7,177,0,660,0,844,0,2290,5634
WEST BENGAL,MURSHIDABAD,2012,174,395,30,599,257,0,257,514,579,464,115,1158,9,88,42,4,961,309,652,2065,190,92,157,110,50,3254,4200,39,609,6,2831,0,3485,347,2489,12713
WEST BENGAL,NADIA,2012,146,357,21,524,174,0,174,348,433,374,59,866,29,51,34,21,1251,244,1007,2637,128,132,338,21,22,2632,3558,46,56,11,1860,0,1973,285,3871,11919
WEST BENGAL,PASCHIM MIDNAPUR,2012,88,86,27,201,64,0,64,128,115,115,0,230,13,25,37,13,582,141,441,1252,416,59,64,8,41,210,800,26,99,1,823,0,949,2,2201,5000
WEST BENGAL,PURAB MIDNAPUR,2012,82,5,15,102,65,0,65,130,196,170,26,392,10,28,28,15,450,127,323,981,403,23,135,4,15,16,1339,31,19,0,572,0,622,743,2126,4981
WEST BENGAL,PURULIA,2012,66,12,6,84,50,0,50,100,44,34,10,88,8,7,26,2,255,44,211,553,100,8,40,0,2,162,518,12,64,0,206,0,282,206,565,1841
WEST BENGAL,SEALDAH G.R.P.,2012,19,9,2,30,0,0,0,0,7,5,2,14,0,41,10,0,421,2,419,893,13,2,14,1,0,62,92,1,14,2,0,0,17,0,39,657
WEST BENGAL,SILIGURI G.R.P.,2012,4,1,0,5,0,0,0,0,3,3,0,6,1,0,1,0,167,0,167,336,2,0,0,1,0,0,3,1,8,1,0,0,10,0,58,248
WEST BENGAL,SILIGURI_PC,2012,32,6,6,44,21,0,21,42,123,111,12,246,3,5,29,3,849,365,484,1738,9,53,195,0,3,812,1141,3,35,12,370,0,420,69,385,3023
WEST BENGAL,UTTAR DINAJPUR,2012,110,283,10,403,92,0,92,184,306,258,48,612,13,21,29,7,435,129,306,940,51,18,64,6,33,1105,1280,9,150,5,623,0,787,3,1839,5212
A & N ISLANDS,CAR,2012,2,0,0,2,0,0,0,0,1,1,0,2,1,0,0,0,4,0,4,9,0,0,2,0,0,4,7,0,1,0,0,0,1,1,8,24
A & N ISLANDS,NORTH,2012,5,0,0,5,4,0,4,8,0,0,0,0,0,0,1,6,13,0,13,33,0,0,3,0,0,8,11,0,2,1,2,0,5,0,70,115
A & N ISLANDS,SOUTH,2012,8,3,0,11,8,0,8,16,7,6,1,14,4,0,1,65,54,0,54,178,8,5,26,1,4,50,99,2,14,3,3,0,22,5,273,544
CHANDIGARH,CHANDIGARH,2012,21,44,5,70,27,0,27,54,87,66,21,174,3,9,63,235,1549,894,655,3408,49,34,234,2,9,42,373,5,45,25,73,0,148,3,1042,3606
D & N HAVELI,D and N HAVELI,2012,7,2,0,9,3,0,3,6,13,9,4,26,2,0,2,22,68,36,32,162,11,10,4,0,12,25,85,0,2,0,0,0,2,23,112,318
DAMAN & DIU,DAMAN,2012,3,4,0,7,5,0,5,10,2,0,2,4,1,0,3,24,52,39,13,132,6,6,7,0,10,15,73,0,0,0,1,0,1,29,34,202
DAMAN & DIU,DIU,2012,0,1,0,1,0,0,0,0,1,0,1,2,0,0,0,2,3,3,0,8,3,0,1,0,1,2,16,0,0,0,2,0,2,9,12,37
DELHI UT,CAW,2012,0,0,0,0,0,0,0,0,0,0,0,0,0,0,0,0,0,0,0,0,0,0,0,0,0,0,0,0,0,0,178,0,178,0,0,178
DELHI UT,CENTRAL,2012,35,25,10,70,31,0,31,62,180,95,85,360,2,3,47,101,1403,846,557,2959,6,39,189,4,7,133,385,4,47,12,57,0,120,7,631,2973
DELHI UT,CRIME BRANCH,2012,1,2,0,3,1,0,1,2,3,1,2,6,0,0,0,0,1,0,1,2,0,0,61,6,0,0,67,0,0,0,0,0,0,0,15,90
DELHI UT,EAST,2012,48,53,9,110,90,0,90,180,503,251,252,1006,4,0,57,172,3258,2137,1121,6749,14,33,211,1,17,161,472,7,96,26,202,0,331,35,2426,7423
DELHI UT,EOW,2012,0,0,0,0,0,0,0,0,0,0,0,0,0,0,0,0,0,0,0,0,0,2,120,0,0,0,122,0,0,0,0,0,0,0,2,124
DELHI UT,GRP(RLY),2012,13,0,1,14,4,0,4,8,27,12,15,54,0,0,12,1,630,32,598,1273,4,9,11,1,1,1,27,1,12,6,0,0,19,0,103,837
DELHI UT,IGI AIRPORT,2012,1,0,0,1,0,0,0,0,1,0,1,2,0,0,1,1,68,16,52,138,0,1,247,3,0,1,260,0,6,0,0,0,6,8,44,382
DELHI UT,NEW DELHI,2012,9,6,1,16,5,0,5,10,28,13,15,56,0,0,9,25,374,138,236,782,12,14,132,16,1,16,258,0,29,7,4,0,40,67,302,1057
DELHI UT,NORTH,2012,25,17,2,44,14,0,14,28,153,84,69,306,0,0,45,97,1025,612,413,2192,5,37,127,3,3,92,280,6,29,10,70,0,115,13,927,2700
DELHI UT,NORTH-EAST,2012,49,65,11,125,78,0,78,156,510,263,247,1020,4,1,58,57,2616,1944,672,5352,5,12,136,4,2,242,546,25,69,9,293,0,396,145,1512,5903
DELHI UT,NORTH-WEST,2012,60,37,8,105,64,0,64,128,357,184,173,714,6,0,65,166,1901,1329,572,4039,0,19,168,3,3,166,368,12,19,14,212,0,257,9,1253,4542
DELHI UT,OUTER,2012,96,60,15,171,67,0,67,134,572,317,255,1144,6,2,91,262,2215,1405,810,4791,7,34,233,2,6,224,596,15,79,18,244,0,356,90,2006,6344
DELHI UT,SOUTH,2012,39,19,3,61,70,0,70,140,245,134,111,490,2,0,52,235,2126,1354,772,4541,3,33,256,1,4,101,423,17,59,36,68,0,180,25,1651,5045
DELHI UT,SOUTH-EAST,2012,46,69,6,121,116,0,116,232,538,306,232,1076,2,2,72,201,2892,2045,847,6061,12,45,207,10,11,252,755,11,160,43,123,0,337,218,2004,7040
DELHI UT,SOUTH-WEST,2012,47,48,6,101,87,0,87,174,399,244,155,798,0,1,47,211,1171,800,371,2601,6,27,189,3,6,131,366,18,69,21,207,0,315,4,1387,4085
DELHI UT,STF,2012,0,1,0,1,0,0,0,0,0,0,0,0,0,0,0,0,0,0,0,0,0,0,2,2,0,0,4,0,0,0,0,0,0,0,1,6
DELHI UT,WEST,2012,52,37,10,99,79,0,79,158,454,256,198,908,2,4,52,186,2352,1733,619,4948,5,36,202,2,18,227,782,18,53,6,327,0,404,292,1144,5558
LAKSHADWEEP,LAKSHADWEEP,2012,0,0,0,0,0,0,0,0,0,0,0,0,0,0,0,3,7,1,6,17,10,0,0,0,3,3,16,0,1,0,1,0,2,0,32,60
PUDUCHERRY,KARAIKAL,2012,5,6,2,13,6,0,6,12,2,2,0,4,0,1,3,21,81,53,28,187,17,1,15,1,1,186,265,0,2,0,1,0,3,44,392,787
PUDUCHERRY,PUDUCHERRY,2012,24,21,10,55,7,0,7,14,17,14,3,34,5,14,13,56,577,409,168,1242,109,8,75,5,20,632,1068,0,7,2,5,0,14,219,1668,3494
